,Team/NOC,Year,Gold,Silver,Bronze,Total
0,United States of America,,39,41,33,113
1,People's Republic of China,,38,32,18,88
2,Japan,,27,14,17,58
3,Great Britain,,22,21,22,65
4,ROC,,20,28,23,71
5,Australia,,17,7,22,46
6,Netherlands,,10,12,14,36
7,France,,10,12,11,33
8,Germany,,10,11,16,37
9,Italy,,10,10,20,40
10,Canada,,7,6,11,24
11,Brazil,,7,6,8,21
12,New Zealand,,7,6,7,20
13,Cuba,,7,3,5,15
14,Hungary,,6,7,7,20
15,Republic of Korea,,6,4,10,20
16,Poland,,4,5,5,14
17,Czech Republic,,4,4,3,11
18,Kenya,,4,4,2,10
19,Norway,,4,2,2,8
20,Jamaica,,4,1,4,9
21,Spain,,3,8,6,17
22,Sweden,,3,6,0,9
23,Switzerland,,3,4,6,13
24,Denmark,,3,4,4,11
25,Croatia,,3,3,2,8
26,Islamic Republic of Iran,,3,2,2,7
27,Serbia,,3,1,5,9
28,Belgium,,3,1,3,7
29,Bulgaria,,3,1,2,6
30,Slovenia,,3,1,1,5
31,Uzbekistan,,3,0,2,5
32,Georgia,,2,5,1,8
33,Chinese Taipei,,2,4,6,12
34,Turkey,,2,2,9,13
35,Greece,,2,1,1,4
36,Uganda,,2,1,1,4
37,Ecuador,,2,1,0,3
38,Ireland,,2,0,2,4
39,Israel,,2,0,2,4
40,Qatar,,2,0,1,3
41,Bahamas,,2,0,0,2
42,Kosovo,,2,0,0,2
43,Ukraine,,1,6,12,19
44,Belarus,,1,3,3,7
45,Romania,,1,3,0,4
46,Venezuela,,1,3,0,4
47,India,,1,2,4,7
48,"Hong Kong, China",,1,2,3,6
49,Philippines,,1,2,1,4
50,Slovakia,,1,2,1,4
51,South Africa,,1,2,0,3
52,Austria,,1,1,5,7
53,Egypt,,1,1,4,6
54,Indonesia,,1,1,3,5
55,Ethiopia,,1,1,2,4
56,Portugal,,1,1,2,4
57,Tunisia,,1,1,0,2
58,Estonia,,1,0,1,2
59,Fiji,,1,0,1,2
60,Latvia,,1,0,1,2
61,Thailand,,1,0,1,2
62,Bermuda,,1,0,0,1
63,Morocco,,1,0,0,1
64,Puerto Rico,,1,0,0,1
65,Colombia,,0,4,1,5
66,Azerbaijan,,0,3,4,7
67,Dominican Republic,,0,3,2,5
68,Armenia,,0,2,2,4
69,Kyrgyzstan,,0,2,1,3
70,Mongolia,,0,1,3,4
71,Argentina,,0,1,2,3
72,San Marino,,0,1,2,3
73,Jordan,,0,1,1,2
74,Malaysia,,0,1,1,2
75,Nigeria,,0,1,1,2
76,Bahrain,,0,1,0,1
77,Saudi Arabia,,0,1,0,1
78,Lithuania,,0,1,0,1
79,North Macedonia,,0,1,0,1
80,Namibia,,0,1,0,1
81,Turkmenistan,,0,1,0,1
82,Kazakhstan,,0,0,8,8
83,Mexico,,0,0,4,4
84,Finland,,0,0,2,2
85,Botswana,,0,0,1,1
86,Burkina Faso,,0,0,1,1
87,CÃ´te d'Ivoire,,0,0,1,1
88,Ghana,,0,0,1,1
89,Grenada,,0,0,1,1
90,Kuwait,,0,0,1,1
91,Republic of Moldova,,0,0,1,1
92,Syrian Arab Republic,,0,0,1,1
93,Denmark,1920.0,26,44,1,71
94,Denmark,1908.0,0,14,3,17
95,Denmark,1980.0,4,2,2,8
96,Denmark,1920.0,26,44,1,71
97,Denmark,1996.0,21,1,1,23
98,Denmark,2000.0,18,3,4,25
99,Denmark,2004.0,19,1,9,29
100,Denmark,2008.0,6,7,6,19
101,Denmark,2012.0,3,5,8,16
102,Denmark,2000.0,18,3,4,25
103,Denmark,2004.0,19,1,9,29
104,Denmark,2008.0,6,7,6,19
105,Denmark,1920.0,26,44,1,71
106,Denmark,1948.0,7,17,27,51
107,Denmark,1952.0,3,1,5,9
108,Denmark,1956.0,1,4,1,6
109,Denmark,1960.0,2,17,4,23
110,Denmark,1960.0,2,17,4,23
111,Denmark,2012.0,3,5,8,16
112,Denmark,1984.0,0,3,10,13
113,Denmark,1912.0,5,49,33,87
114,Denmark-2,2004.0,19,1,9,29
115,Denmark,1920.0,26,44,1,71
116,Denmark,1920.0,26,44,1,71
117,Denmark,1912.0,5,49,33,87
118,Denmark,1996.0,21,1,1,23
119,Denmark,2000.0,18,3,4,25
120,Denmark,1906.0,14,19,1,34
121,Denmark,1996.0,21,1,1,23
122,Skum,1960.0,2,17,4,23
123,Denmark,2016.0,15,10,16,41
124,Denmark,1920.0,26,44,1,71
125,Polyteknisk Roklub-1,1912.0,5,49,33,87
126,Denmark,1976.0,3,0,5,8
127,Denmark,1952.0,3,1,5,9
128,Denmark,1968.0,5,6,6,17
129,Denmark,1972.0,1,0,0,1
130,Denmark,1976.0,3,0,5,8
131,Denmark,1992.0,3,2,9,14
132,Denmark,1906.0,14,19,1,34
133,Denmark,2008.0,6,7,6,19
134,Denmark,1960.0,2,17,4,23
135,Denmark,1988.0,3,1,3,7
136,Denmark,1992.0,3,2,9,14
137,Denmark,2000.0,18,3,4,25
138,Denmark,2004.0,19,1,9,29
139,Denmark,2016.0,15,10,16,41
140,Denmark,1908.0,0,14,3,17
141,Denmark,1912.0,5,49,33,87
142,Denmark,1924.0,2,9,3,14
143,Denmark,1932.0,0,7,4,11
144,Denmark,1906.0,14,19,1,34
145,Denmark,2012.0,3,5,8,16
146,Denmark,2000.0,18,3,4,25
147,Denmark,1912.0,5,49,33,87
148,Denmark,2000.0,18,3,4,25
149,Denmark,1988.0,3,1,3,7
150,Denmark,1912.0,5,49,33,87
151,Denmark,1948.0,7,17,27,51
152,Denmark,1996.0,21,1,1,23
153,Web II,1960.0,2,17,4,23
154,Denmark,1984.0,0,3,10,13
155,Denmark,1912.0,5,49,33,87
156,Denmark,1960.0,2,17,4,23
157,Denmark,1912.0,5,49,33,87
158,Nykjbings paa Falster,1912.0,5,49,33,87
159,Denmark,1924.0,2,9,3,14
160,Denmark,1948.0,7,17,27,51
161,Denmark,1960.0,2,17,4,23
162,Denmark,1960.0,2,17,4,23
163,Denmark,1968.0,5,6,6,17
164,Denmark,1976.0,3,0,5,8
165,Denmark,1980.0,4,2,2,8
166,Denmark,1920.0,26,44,1,71
167,Denmark,1920.0,26,44,1,71
168,Denmark,1920.0,26,44,1,71
169,Denmark,1912.0,5,49,33,87
170,Denmark,1908.0,0,14,3,17
171,Denmark,1912.0,5,49,33,87
172,Denmark,1948.0,7,17,27,51
173,Denmark,2016.0,15,10,16,41
174,Denmark,1928.0,6,5,4,15
175,Denmark,1928.0,6,5,4,15
176,Denmark,1932.0,0,7,4,11
177,Denmark,2016.0,15,10,16,41
178,Denmark,1912.0,5,49,33,87
179,Denmark,1948.0,7,17,27,51
180,Denmark,1964.0,7,1,4,12
181,Denmark,1976.0,3,0,5,8
182,Denmark,1948.0,7,17,27,51
183,Denmark,1920.0,26,44,1,71
184,Denmark,2012.0,3,5,8,16
185,Denmark,2016.0,15,10,16,41
186,Denmark,2016.0,15,10,16,41
187,Denmark,1912.0,5,49,33,87
188,Denmark,2016.0,15,10,16,41
189,Denmark,1920.0,26,44,1,71
190,Denmark,1912.0,5,49,33,87
191,Denmark,2016.0,15,10,16,41
192,Denmark,1912.0,5,49,33,87
193,Denmark,1996.0,21,1,1,23
194,Denmark,1924.0,2,9,3,14
195,Denmark,1928.0,6,5,4,15
196,Denmark,1928.0,6,5,4,15
197,Denmark,1952.0,3,1,5,9
198,Denmark,1956.0,1,4,1,6
199,Nykjbings paa Falster,1912.0,5,49,33,87
200,Denmark,1948.0,7,17,27,51
201,Denmark,1948.0,7,17,27,51
202,Denmark,1948.0,7,17,27,51
203,Denmark,1964.0,7,1,4,12
204,Denmark,1952.0,3,1,5,9
205,Denmark,1924.0,2,9,3,14
206,Don Schufro,2008.0,6,7,6,19
207,Denmark,1964.0,7,1,4,12
208,Denmark,1920.0,26,44,1,71
209,Denmark,1996.0,21,1,1,23
210,Denmark,1948.0,7,17,27,51
211,Denmark,1920.0,26,44,1,71
212,Nurdug II,1912.0,5,49,33,87
213,Denmark,1906.0,14,19,1,34
214,Denmark,1948.0,7,17,27,51
215,Denmark,1996.0,21,1,1,23
216,Denmark,2000.0,18,3,4,25
217,Denmark,1998.0,0,5,0,5
218,Denmark,1920.0,26,44,1,71
219,Denmark,1906.0,14,19,1,34
220,Denmark,1920.0,26,44,1,71
221,Denmark,2012.0,3,5,8,16
222,Denmark,2004.0,19,1,9,29
223,Denmark,1960.0,2,17,4,23
224,Denmark,1996.0,21,1,1,23
225,Denmark,1920.0,26,44,1,71
226,Denmark,1936.0,0,3,3,6
227,Denmark,1964.0,7,1,4,12
228,Denmark,1932.0,0,7,4,11
229,Denmark,2000.0,18,3,4,25
230,Denmark,1920.0,26,44,1,71
231,Denmark,1984.0,0,3,10,13
232,Denmark,1984.0,0,3,10,13
233,Denmark,1920.0,26,44,1,71
234,Denmark,1912.0,5,49,33,87
235,Denmark,1948.0,7,17,27,51
236,Denmark,1908.0,0,14,3,17
237,Denmark,1912.0,5,49,33,87
238,Denmark,2004.0,19,1,9,29
239,Denmark,2016.0,15,10,16,41
240,Denmark,1948.0,7,17,27,51
241,Denmark,1912.0,5,49,33,87
242,Denmark,1968.0,5,6,6,17
243,Denmark,1968.0,5,6,6,17
244,Denmark,1960.0,2,17,4,23
245,Denmark,1976.0,3,0,5,8
246,Denmark,1980.0,4,2,2,8
247,Denmark,1906.0,14,19,1,34
248,Denmark,1906.0,14,19,1,34
249,Denmark,1908.0,0,14,3,17
250,Denmark,1912.0,5,49,33,87
251,Denmark,2004.0,19,1,9,29
252,Denmark,1948.0,7,17,27,51
253,Denmark,1896.0,1,2,3,6
254,Denmark,1896.0,1,2,3,6
255,Denmark,1896.0,1,2,3,6
256,Denmark,1984.0,0,3,10,13
257,Clearwater,2008.0,6,7,6,19
258,Denmark,2004.0,19,1,9,29
259,Denmark,1960.0,2,17,4,23
260,Denmark,1984.0,0,3,10,13
261,Denmark,1920.0,26,44,1,71
262,Denmark,1912.0,5,49,33,87
263,Denmark,1920.0,26,44,1,71
264,Denmark,1920.0,26,44,1,71
265,Denmark,1920.0,26,44,1,71
266,Denmark,1920.0,26,44,1,71
267,Denmark,2008.0,6,7,6,19
268,Denmark,1912.0,5,49,33,87
269,Denmark,2016.0,15,10,16,41
270,Denmark,1968.0,5,6,6,17
271,Denmark,2008.0,6,7,6,19
272,Denmark,2012.0,3,5,8,16
273,Denmark,2016.0,15,10,16,41
274,Denmark,1928.0,6,5,4,15
275,Denmark,1968.0,5,6,6,17
276,Denmark,1932.0,0,7,4,11
277,Denmark,1912.0,5,49,33,87
278,Denmark,1952.0,3,1,5,9
279,Denmark,1920.0,26,44,1,71
280,Denmark,2016.0,15,10,16,41
281,Denmark,2000.0,18,3,4,25
282,Denmark,2004.0,19,1,9,29
283,Denmark,1912.0,5,49,33,87
284,Denmark,1924.0,2,9,3,14
285,Denmark,1912.0,5,49,33,87
286,Denmark,1920.0,26,44,1,71
287,Denmark,2008.0,6,7,6,19
288,Denmark,2000.0,18,3,4,25
289,Denmark,2004.0,19,1,9,29
290,Denmark,1912.0,5,49,33,87
291,Denmark,1996.0,21,1,1,23
292,Denmark,2000.0,18,3,4,25
293,Denmark,1980.0,4,2,2,8
294,Denmark,1906.0,14,19,1,34
295,Denmark,1906.0,14,19,1,34
296,Denmark,1932.0,0,7,4,11
297,Denmark,1948.0,7,17,27,51
298,Denmark,2008.0,6,7,6,19
299,Denmark,1984.0,0,3,10,13
300,Denmark,1996.0,21,1,1,23
301,Denmark,2000.0,18,3,4,25
302,Denmark,1968.0,5,6,6,17
303,Denmark,1968.0,5,6,6,17
304,Denmark,1912.0,5,49,33,87
305,Denmark,2016.0,15,10,16,41
306,Denmark,2004.0,19,1,9,29
307,Denmark,1932.0,0,7,4,11
308,Denmark,1948.0,7,17,27,51
309,Denmark,1952.0,3,1,5,9
310,Denmark,1920.0,26,44,1,71
311,Denmark,2016.0,15,10,16,41
312,Denmark,2012.0,3,5,8,16
313,Denmark,1920.0,26,44,1,71
314,Denmark,1948.0,7,17,27,51
315,Denmark,1912.0,5,49,33,87
316,Denmark,1948.0,7,17,27,51
317,Denmark,1936.0,0,3,3,6
318,Denmark,1948.0,7,17,27,51
319,Denmark,1968.0,5,6,6,17
320,Denmark,1948.0,7,17,27,51
321,Denmark,2016.0,15,10,16,41
322,Denmark,1920.0,26,44,1,71
323,Denmark,1912.0,5,49,33,87
324,Denmark,1906.0,14,19,1,34
325,Denmark,2016.0,15,10,16,41
326,Denmark,1912.0,5,49,33,87
327,Denmark,1912.0,5,49,33,87
328,Denmark,1920.0,26,44,1,71
329,Denmark,1920.0,26,44,1,71
330,Denmark,1924.0,2,9,3,14
331,Denmark,2016.0,15,10,16,41
332,Denmark,1996.0,21,1,1,23
333,Denmark,1912.0,5,49,33,87
334,Denmark,1998.0,0,5,0,5
335,Denmark,1912.0,5,49,33,87
336,Denmark,1906.0,14,19,1,34
337,Denmark,1908.0,0,14,3,17
338,Denmark,2004.0,19,1,9,29
339,Denmark,1906.0,14,19,1,34
340,Denmark,1976.0,3,0,5,8
341,Denmark,1948.0,7,17,27,51
342,Denmark,1936.0,0,3,3,6
343,Denmark,1912.0,5,49,33,87
344,Denmark,1900.0,4,3,2,9
345,Denmark,1968.0,5,6,6,17
346,Denmark,2016.0,15,10,16,41
347,Denmark,1996.0,21,1,1,23
348,Nurdug II,1912.0,5,49,33,87
349,Denmark,2008.0,6,7,6,19
350,Denmark,1992.0,3,2,9,14
351,Denmark,1920.0,26,44,1,71
352,Denmark,1900.0,4,3,2,9
353,Denmark,1912.0,5,49,33,87
354,Denmark,1912.0,5,49,33,87
355,Denmark,1920.0,26,44,1,71
356,Denmark,1920.0,26,44,1,71
357,Denmark,2016.0,15,10,16,41
358,Denmark,1906.0,14,19,1,34
359,Denmark,1920.0,26,44,1,71
360,Denmark,2000.0,18,3,4,25
361,Denmark,1912.0,5,49,33,87
362,Denmark,1906.0,14,19,1,34
363,Denmark,1920.0,26,44,1,71
364,Denmark,1912.0,5,49,33,87
365,Denmark,1968.0,5,6,6,17
366,Denmark,2000.0,18,3,4,25
367,Denmark,1988.0,3,1,3,7
368,Denmark,2004.0,19,1,9,29
369,Denmark,1920.0,26,44,1,71
370,Denmark,1928.0,6,5,4,15
371,Denmark,1908.0,0,14,3,17
372,Denmark,1908.0,0,14,3,17
373,Denmark,1912.0,5,49,33,87
374,Denmark,2004.0,19,1,9,29
375,Denmark,2012.0,3,5,8,16
376,Denmark,2016.0,15,10,16,41
377,Denmark,2000.0,18,3,4,25
378,Denmark,2004.0,19,1,9,29
379,Denmark,1968.0,5,6,6,17
380,Nykjbings paa Falster,1912.0,5,49,33,87
381,Hi-Hi,1928.0,6,5,4,15
382,Denmark,1920.0,26,44,1,71
383,Denmark,2004.0,19,1,9,29
384,Denmark,2008.0,6,7,6,19
385,Denmark,1900.0,4,3,2,9
386,Denmark,1900.0,4,3,2,9
387,Denmark,1900.0,4,3,2,9
388,Denmark,1920.0,26,44,1,71
389,Denmark,2000.0,18,3,4,25
390,Denmark,1988.0,3,1,3,7
391,Denmark,1992.0,3,2,9,14
392,Denmark,1948.0,7,17,27,51
393,Bonzo,1924.0,2,9,3,14
394,Denmark,1948.0,7,17,27,51
395,Denmark,1960.0,2,17,4,23
396,Denmark,1924.0,2,9,3,14
397,Denmark,1960.0,2,17,4,23
398,Denmark,1960.0,2,17,4,23
399,Denmark,1896.0,1,2,3,6
400,Denmark,1896.0,1,2,3,6
401,Denmark,1896.0,1,2,3,6
402,Denmark-1,2012.0,3,5,8,16
403,Denmark,1992.0,3,2,9,14
404,Denmark,1984.0,0,3,10,13
405,Denmark,1928.0,6,5,4,15
406,Denmark,1932.0,0,7,4,11
407,Denmark,1912.0,5,49,33,87
408,Denmark,2016.0,15,10,16,41
409,Denmark,2016.0,15,10,16,41
410,Denmark,1920.0,26,44,1,71
411,Denmark,1920.0,26,44,1,71
412,Denmark,1906.0,14,19,1,34
413,Denmark,1908.0,0,14,3,17
414,Denmark,1912.0,5,49,33,87
415,Denmark,1912.0,5,49,33,87
416,Denmark,1908.0,0,14,3,17
417,Denmark,1912.0,5,49,33,87
418,Denmark,1992.0,3,2,9,14
419,Denmark,1980.0,4,2,2,8
420,Denmark,1912.0,5,49,33,87
421,Denmark,1964.0,7,1,4,12
422,Denmark,2016.0,15,10,16,41
423,Denmark,2004.0,19,1,9,29
424,Denmark,2012.0,3,5,8,16
425,Denmark,1920.0,26,44,1,71
426,Denmark,1912.0,5,49,33,87
427,Denmark,1912.0,5,49,33,87
428,Denmark,1948.0,7,17,27,51
429,Denmark,2004.0,19,1,9,29
430,Denmark,2016.0,15,10,16,41
431,Denmark,1912.0,5,49,33,87
432,Denmark,1968.0,5,6,6,17
433,Denmark,1936.0,0,3,3,6
434,Denmark,1912.0,5,49,33,87
435,Denmark,1920.0,26,44,1,71
436,Denmark,1932.0,0,7,4,11
437,Denmark,1906.0,14,19,1,34
438,Denmark,1912.0,5,49,33,87
439,Denmark,1948.0,7,17,27,51
440,Denmark,1980.0,4,2,2,8
441,Denmark,1924.0,2,9,3,14
442,Denmark,1912.0,5,49,33,87
443,Denmark,2016.0,15,10,16,41
444,Denmark,2004.0,19,1,9,29
445,Denmark,1948.0,7,17,27,51
446,Denmark,1948.0,7,17,27,51
447,Hi-Hi,1928.0,6,5,4,15
448,Denmark,1920.0,26,44,1,71
449,Denmark,1912.0,5,49,33,87
450,Nykjbings paa Falster,1912.0,5,49,33,87
451,Denmark,1906.0,14,19,1,34
452,Denmark,1920.0,26,44,1,71
453,Denmark-1,2012.0,3,5,8,16
454,Denmark,2016.0,15,10,16,41
455,Denmark,1920.0,26,44,1,71
456,Denmark,1948.0,7,17,27,51
457,Denmark,1936.0,0,3,3,6
458,Denmark,1912.0,5,49,33,87
459,Denmark,1920.0,26,44,1,71
460,Denmark,1906.0,14,19,1,34
461,Denmark,1912.0,5,49,33,87
462,Denmark,1920.0,26,44,1,71
463,Denmark,1906.0,14,19,1,34
464,Denmark,1912.0,5,49,33,87
465,Denmark,1912.0,5,49,33,87
466,Denmark,1906.0,14,19,1,34
467,Denmark,1968.0,5,6,6,17
468,Denmark,1912.0,5,49,33,87
469,Denmark,1920.0,26,44,1,71
470,Denmark,1960.0,2,17,4,23
471,Denmark,2016.0,15,10,16,41
472,Denmark,1952.0,3,1,5,9
473,Denmark,1920.0,26,44,1,71
474,Denmark,1912.0,5,49,33,87
475,Denmark,1964.0,7,1,4,12
476,Denmark,1920.0,26,44,1,71
477,Denmark,1992.0,3,2,9,14
478,Denmark,1924.0,2,9,3,14
479,Denmark,1932.0,0,7,4,11
480,Denmark,1948.0,7,17,27,51
481,Denmark,1906.0,14,19,1,34
482,Denmark,1912.0,5,49,33,87
483,Skum,1960.0,2,17,4,23
484,Denmark,1920.0,26,44,1,71
485,Denmark,1924.0,2,9,3,14
486,Denmark,1924.0,2,9,3,14
487,Denmark,2000.0,18,3,4,25
488,Denmark,2004.0,19,1,9,29
489,Denmark,1948.0,7,17,27,51
490,Denmark,1948.0,7,17,27,51
491,Denmark,1998.0,0,5,0,5
492,White Lady,1964.0,7,1,4,12
493,Denmark,2008.0,6,7,6,19
494,Denmark,1996.0,21,1,1,23
495,Denmark,1948.0,7,17,27,51
496,Denmark,2016.0,15,10,16,41
497,Denmark,2008.0,6,7,6,19
498,Denmark,2012.0,3,5,8,16
499,Denmark,1998.0,0,5,0,5
500,Denmark,1906.0,14,19,1,34
501,Denmark,1996.0,21,1,1,23
502,Denmark,2000.0,18,3,4,25
503,Denmark,1952.0,3,1,5,9
504,Denmark,2008.0,6,7,6,19
505,Denmark,1920.0,26,44,1,71
506,Denmark,1908.0,0,14,3,17
507,Denmark,1984.0,0,3,10,13
508,Denmark,1928.0,6,5,4,15
509,Denmark,1980.0,4,2,2,8
510,Denmark,2016.0,15,10,16,41
511,Denmark,2008.0,6,7,6,19
512,Denmark,2012.0,3,5,8,16
513,Denmark,1984.0,0,3,10,13
514,Denmark,1984.0,0,3,10,13
515,Denmark,1920.0,26,44,1,71
516,Denmark,1906.0,14,19,1,34
517,Denmark,1906.0,14,19,1,34
518,Denmark,1912.0,5,49,33,87
519,Denmark,2016.0,15,10,16,41
520,Denmark,1964.0,7,1,4,12
521,Denmark,2000.0,18,3,4,25
522,Denmark,1996.0,21,1,1,23
523,Denmark,1920.0,26,44,1,71
524,Denmark,2016.0,15,10,16,41
525,Denmark,1992.0,3,2,9,14
526,Denmark,1920.0,26,44,1,71
527,Denmark,1948.0,7,17,27,51
528,Denmark-2,2004.0,19,1,9,29
529,Hi-Hi,1928.0,6,5,4,15
530,Denmark/Sweden,1900.0,4,3,2,9
531,Denmark,1948.0,7,17,27,51
532,Denmark,1900.0,4,3,2,9
533,Denmark,1988.0,3,1,3,7
534,Denmark,1992.0,3,2,9,14
535,Denmark,1948.0,7,17,27,51
536,Denmark,1992.0,3,2,9,14
537,Polyteknisk Roklub-1,1912.0,5,49,33,87
538,Denmark,1928.0,6,5,4,15
539,Denmark,2004.0,19,1,9,29
540,Denmark,1906.0,14,19,1,34
541,Denmark,2016.0,15,10,16,41
542,Denmark,1956.0,1,4,1,6
543,Denmark,2016.0,15,10,16,41
544,Denmark,1912.0,5,49,33,87
545,Denmark,1932.0,0,7,4,11
546,Denmark,1920.0,26,44,1,71
547,Denmark,1920.0,26,44,1,71
548,Denmark,1920.0,26,44,1,71
549,Denmark,1960.0,2,17,4,23
550,Denmark,1936.0,0,3,3,6
551,Denmark,1984.0,0,3,10,13
552,Denmark,1964.0,7,1,4,12
553,Denmark,1948.0,7,17,27,51
554,Denmark,1960.0,2,17,4,23
555,Denmark,1928.0,6,5,4,15
556,Denmark,1996.0,21,1,1,23
557,Denmark,1920.0,26,44,1,71
558,Denmark,1992.0,3,2,9,14
559,Denmark,1996.0,21,1,1,23
560,Denmark,2016.0,15,10,16,41
561,Denmark,1912.0,5,49,33,87
562,Denmark,1948.0,7,17,27,51
563,Denmark,1952.0,3,1,5,9
564,Denmark,1996.0,21,1,1,23
565,Denmark,1920.0,26,44,1,71
566,Denmark,2004.0,19,1,9,29
567,Nurdug II,1912.0,5,49,33,87
568,Denmark,1912.0,5,49,33,87
569,Denmark,1906.0,14,19,1,34
570,Polyteknisk Roklub-1,1912.0,5,49,33,87
571,Denmark,2004.0,19,1,9,29
572,Denmark,1960.0,2,17,4,23
573,Denmark,1912.0,5,49,33,87
574,Denmark,2004.0,19,1,9,29
575,Denmark,1920.0,26,44,1,71
576,Denmark,1948.0,7,17,27,51
577,Denmark,1912.0,5,49,33,87
578,Denmark,1920.0,26,44,1,71
579,Denmark,1920.0,26,44,1,71
580,Denmark,2000.0,18,3,4,25
581,Denmark,2004.0,19,1,9,29
582,Bonzo,1924.0,2,9,3,14
583,Hi-Hi,1928.0,6,5,4,15
584,Denmark,1912.0,5,49,33,87
585,Tip,1956.0,1,4,1,6
586,White Lady,1964.0,7,1,4,12
587,Denmark,1920.0,26,44,1,71
588,Denmark,2008.0,6,7,6,19
589,Denmark,1928.0,6,5,4,15
590,Denmark/Sweden,1900.0,4,3,2,9
591,Denmark,1964.0,7,1,4,12
592,Denmark,2012.0,3,5,8,16
593,Denmark,2016.0,15,10,16,41
594,Denmark,1908.0,0,14,3,17
595,Denmark,1912.0,5,49,33,87
596,Digby,2008.0,6,7,6,19
597,Finland,1920.0,21,14,17,52
598,Finland,1920.0,21,14,17,52
599,Finland,2014.0,2,7,24,33
600,Finland,1948.0,18,14,10,42
601,Finland,1948.0,18,14,10,42
602,Finland,1948.0,18,14,10,42
603,Finland,1948.0,18,14,10,42
604,Finland,1952.0,14,7,31,52
605,Finland,1932.0,6,9,17,32
606,Finland,1924.0,28,21,18,67
607,Lucky Girl-1,1912.0,9,40,22,71
608,Finland,2002.0,7,5,1,13
609,Finland,2006.0,0,34,7,41
610,Finland,1994.0,0,1,29,30
611,Finland,1960.0,6,4,9,19
612,Heatherbell,1912.0,9,40,22,71
613,Finland,1928.0,10,9,10,29
614,Finland,1920.0,21,14,17,52
615,Finland,1924.0,28,21,18,67
616,Finland,1996.0,1,2,1,4
617,Finland,1912.0,9,40,22,71
618,Finland,1936.0,12,8,16,36
619,Finland,1948.0,18,14,10,42
620,Finland,1948.0,18,14,10,42
621,Finland,2010.0,0,1,46,47
622,Finland,2014.0,2,7,24,33
623,Finland,1936.0,12,8,16,36
624,Finland,1998.0,2,7,49,58
625,Finland,2006.0,0,34,7,41
626,Finland,1924.0,28,21,18,67
627,Finland,1924.0,28,21,18,67
628,Finland,1984.0,8,5,18,31
629,Finland,1948.0,18,14,10,42
630,Finland,1948.0,18,14,10,42
631,Nina,1912.0,9,40,22,71
632,Finland,1972.0,3,10,7,20
633,Nina,1912.0,9,40,22,71
634,Finland,1988.0,8,23,7,38
635,Finland,1912.0,9,40,22,71
636,Finland,1924.0,28,21,18,67
637,Nina,1912.0,9,40,22,71
638,Finland,1928.0,10,9,10,29
639,Finland,1984.0,8,5,18,31
640,Finland,1924.0,28,21,18,67
641,Finland,1912.0,9,40,22,71
642,Finland,1960.0,6,4,9,19
643,Finland,1924.0,28,21,18,67
644,Finland,1992.0,7,5,8,20
645,Finland,1988.0,8,23,7,38
646,Finland,1924.0,28,21,18,67
647,Finland,1912.0,9,40,22,71
648,Finland,1992.0,7,5,8,20
649,Finland,2010.0,0,1,46,47
650,Finland,1998.0,2,7,49,58
651,Finland,1976.0,9,12,1,22
652,Finland,1908.0,1,1,28,30
653,Finland,1912.0,9,40,22,71
654,Nina,1912.0,9,40,22,71
655,Finland,1928.0,10,9,10,29
656,Finland,1920.0,21,14,17,52
657,Finland,1924.0,28,21,18,67
658,Finland,2014.0,2,7,24,33
659,Finland,1908.0,1,1,28,30
660,Finland,1948.0,18,14,10,42
661,Finland,1952.0,14,7,31,52
662,Finland,1984.0,8,5,18,31
663,Finland,1998.0,2,7,49,58
664,Finland,1924.0,28,21,18,67
665,Finland,1928.0,10,9,10,29
666,Finland,2006.0,0,34,7,41
667,Finland,2010.0,0,1,46,47
668,Finland,2008.0,1,2,2,5
669,Finland,1952.0,14,7,31,52
670,Finland,1956.0,8,7,23,38
671,Finland,1956.0,8,7,23,38
672,Finland,1956.0,8,7,23,38
673,Finland,1960.0,6,4,9,19
674,Finland,1960.0,6,4,9,19
675,Finland,1960.0,6,4,9,19
676,Finland,1960.0,6,4,9,19
677,Finland,1994.0,0,1,29,30
678,Finland,1960.0,6,4,9,19
679,Finland,1952.0,14,7,31,52
680,Finland,1956.0,8,7,23,38
681,Finland,1924.0,28,21,18,67
682,Finland,1956.0,8,7,23,38
683,Finland,1998.0,2,7,49,58
684,Finland,2006.0,0,34,7,41
685,Finland,2000.0,3,1,1,5
686,Finland,1912.0,9,40,22,71
687,Finland,1984.0,8,5,18,31
688,Heatherbell,1912.0,9,40,22,71
689,Finland,1948.0,18,14,10,42
690,Finland,1952.0,14,7,31,52
691,Finland,1952.0,14,7,31,52
692,Finland,2002.0,7,5,1,13
693,Finland,2002.0,7,5,1,13
694,Finland,2006.0,0,34,7,41
695,Finland,2006.0,0,34,7,41
696,Finland,1912.0,9,40,22,71
697,Finland,1956.0,8,7,23,38
698,Finland,2010.0,0,1,46,47
699,Finland,1956.0,8,7,23,38
700,Finland,1988.0,8,23,7,38
701,Finland,1994.0,0,1,29,30
702,Finland,1998.0,2,7,49,58
703,Finland,2006.0,0,34,7,41
704,Finland,1952.0,14,7,31,52
705,Finland,1956.0,8,7,23,38
706,Finland,2014.0,2,7,24,33
707,Finland,1952.0,14,7,31,52
708,Finland,1952.0,14,7,31,52
709,Finland,2010.0,0,1,46,47
710,Finland,2000.0,3,1,1,5
711,Finland,1924.0,28,21,18,67
712,Finland,1936.0,12,8,16,36
713,Finland,1952.0,14,7,31,52
714,Finland,2010.0,0,1,46,47
715,Finland,1924.0,28,21,18,67
716,Finland,1924.0,28,21,18,67
717,Finland,1924.0,28,21,18,67
718,Finland,1948.0,18,14,10,42
719,Finland,1980.0,4,6,11,21
720,Finland,1960.0,6,4,9,19
721,Finland,1964.0,6,7,7,20
722,Finland,1948.0,18,14,10,42
723,Finland,1948.0,18,14,10,42
724,Finland,1948.0,18,14,10,42
725,Finland,1948.0,18,14,10,42
726,Finland,1948.0,18,14,10,42
727,Heatherbell,1912.0,9,40,22,71
728,Finland,1998.0,2,7,49,58
729,Finland,1972.0,3,10,7,20
730,Finland,1960.0,6,4,9,19
731,Finland,1956.0,8,7,23,38
732,Finland,1912.0,9,40,22,71
733,Finland,1912.0,9,40,22,71
734,Finland,1984.0,8,5,18,31
735,Finland,1952.0,14,7,31,52
736,Finland,1998.0,2,7,49,58
737,Finland,1972.0,3,10,7,20
738,Finland,1976.0,9,12,1,22
739,Finland,1976.0,9,12,1,22
740,Finland,1998.0,2,7,49,58
741,Finland,1924.0,28,21,18,67
742,Finland,1912.0,9,40,22,71
743,Finland,2010.0,0,1,46,47
744,Finland,2014.0,2,7,24,33
745,Finland,1932.0,6,9,17,32
746,Finland,1932.0,6,9,17,32
747,Finland,1936.0,12,8,16,36
748,Finland,1936.0,12,8,16,36
749,Finland,1992.0,7,5,8,20
750,Finland,1994.0,0,1,29,30
751,Finland,1998.0,2,7,49,58
752,Finland,1920.0,21,14,17,52
753,Finland,1924.0,28,21,18,67
754,Finland,1920.0,21,14,17,52
755,Finland,1924.0,28,21,18,67
756,Finland,1936.0,12,8,16,36
757,Finland,1948.0,18,14,10,42
758,Ralia,1952.0,14,7,31,52
759,Finland,1988.0,8,23,7,38
760,Finland,2000.0,3,1,1,5
761,Finland,1928.0,10,9,10,29
762,Finland,1932.0,6,9,17,32
763,Finland,1932.0,6,9,17,32
764,Finland,1906.0,2,1,1,4
765,Finland,1906.0,2,1,1,4
766,Finland,1908.0,1,1,28,30
767,Finland,1932.0,6,9,17,32
768,Finland,2014.0,2,7,24,33
769,Finland,2000.0,3,1,1,5
770,Finland,1920.0,21,14,17,52
771,Finland,1912.0,9,40,22,71
772,Finland,2006.0,0,34,7,41
773,Finland,2014.0,2,7,24,33
774,Finland,2006.0,0,34,7,41
775,Finland,2010.0,0,1,46,47
776,Finland,2014.0,2,7,24,33
777,Heatherbell,1912.0,9,40,22,71
778,Finland,2002.0,7,5,1,13
779,Finland,1994.0,0,1,29,30
780,Finland,1920.0,21,14,17,52
781,Finland,1932.0,6,9,17,32
782,Finland,1972.0,3,10,7,20
783,Finland,1972.0,3,10,7,20
784,Finland,1972.0,3,10,7,20
785,Finland,1976.0,9,12,1,22
786,Finland,1956.0,8,7,23,38
787,Finland,1976.0,9,12,1,22
788,Finland,2012.0,0,1,4,5
789,Finland,1948.0,18,14,10,42
790,Finland,1968.0,2,4,6,12
791,Finland,1956.0,8,7,23,38
792,Finland,1964.0,6,7,7,20
793,Finland,1964.0,6,7,7,20
794,Finland,1972.0,3,10,7,20
795,Finland,2006.0,0,34,7,41
796,Finland,2010.0,0,1,46,47
797,Finland,1994.0,0,1,29,30
798,Finland,1998.0,2,7,49,58
799,Finland,1936.0,12,8,16,36
800,Finland,1980.0,4,6,11,21
801,Finland,1984.0,8,5,18,31
802,Finland,1936.0,12,8,16,36
803,Finland,1976.0,9,12,1,22
804,Finland,1980.0,4,6,11,21
805,Finland,1984.0,8,5,18,31
806,Finland,2010.0,0,1,46,47
807,Finland,1984.0,8,5,18,31
808,Finland,1984.0,8,5,18,31
809,Finland,1984.0,8,5,18,31
810,Finland,1956.0,8,7,23,38
811,Finland,1992.0,7,5,8,20
812,Finland,1948.0,18,14,10,42
813,Finland,1956.0,8,7,23,38
814,Finland,1924.0,28,21,18,67
815,Finland,1924.0,28,21,18,67
816,Finland,1912.0,9,40,22,71
817,Finland,1908.0,1,1,28,30
818,Finland,2004.0,0,2,0,2
819,Finland,1988.0,8,23,7,38
820,Finland,1994.0,0,1,29,30
821,Finland,1972.0,3,10,7,20
822,Finland,2006.0,0,34,7,41
823,Finland,1968.0,2,4,6,12
824,Finland,1994.0,0,1,29,30
825,Finland,2010.0,0,1,46,47
826,Finland,1980.0,4,6,11,21
827,Finland,1984.0,8,5,18,31
828,Finland,1984.0,8,5,18,31
829,Finland,1992.0,7,5,8,20
830,Finland,1994.0,0,1,29,30
831,Finland,1998.0,2,7,49,58
832,Finland,1984.0,8,5,18,31
833,Finland,1984.0,8,5,18,31
834,Finland,1984.0,8,5,18,31
835,Finland,1984.0,8,5,18,31
836,Finland,1988.0,8,23,7,38
837,Finland,1994.0,0,1,29,30
838,Finland,1994.0,0,1,29,30
839,Finland,1948.0,18,14,10,42
840,Finland,1956.0,8,7,23,38
841,Finland,2006.0,0,34,7,41
842,Finland,1912.0,9,40,22,71
843,Finland,1928.0,10,9,10,29
844,Finland,1972.0,3,10,7,20
845,Finland,1976.0,9,12,1,22
846,Finland,1976.0,9,12,1,22
847,Finland,1976.0,9,12,1,22
848,Finland,1980.0,4,6,11,21
849,Finland,1992.0,7,5,8,20
850,Finland,1976.0,9,12,1,22
851,Finland,1976.0,9,12,1,22
852,Finland,2006.0,0,34,7,41
853,Finland,2010.0,0,1,46,47
854,Finland,1994.0,0,1,29,30
855,Finland,1998.0,2,7,49,58
856,Finland,2006.0,0,34,7,41
857,Finland,2010.0,0,1,46,47
858,Finland,2006.0,0,34,7,41
859,Finland,1928.0,10,9,10,29
860,Finland,1932.0,6,9,17,32
861,Finland,1952.0,14,7,31,52
862,Finland,1912.0,9,40,22,71
863,Finland,1912.0,9,40,22,71
864,Finland,1912.0,9,40,22,71
865,Finland,1912.0,9,40,22,71
866,Finland,1920.0,21,14,17,52
867,Finland,1992.0,7,5,8,20
868,Finland,1920.0,21,14,17,52
869,Finland,1920.0,21,14,17,52
870,Finland,1920.0,21,14,17,52
871,Finland,2014.0,2,7,24,33
872,Finland,2014.0,2,7,24,33
873,Ralia,1952.0,14,7,31,52
874,Finland,1952.0,14,7,31,52
875,Finland,1956.0,8,7,23,38
876,Finland,1956.0,8,7,23,38
877,Finland,1988.0,8,23,7,38
878,Finland,2014.0,2,7,24,33
879,Finland,1956.0,8,7,23,38
880,Finland,1988.0,8,23,7,38
881,Finland,1932.0,6,9,17,32
882,Finland,1936.0,12,8,16,36
883,Finland,1912.0,9,40,22,71
884,Finland,1920.0,21,14,17,52
885,Finland,1952.0,14,7,31,52
886,Finland,2006.0,0,34,7,41
887,Finland,1952.0,14,7,31,52
888,Heatherbell,1912.0,9,40,22,71
889,Finland,1998.0,2,7,49,58
890,Finland,2006.0,0,34,7,41
891,Finland,2006.0,0,34,7,41
892,Finland,2010.0,0,1,46,47
893,Finland,2006.0,0,34,7,41
894,Finland,2010.0,0,1,46,47
895,Finland,2014.0,2,7,24,33
896,Finland,1998.0,2,7,49,58
897,Finland,1992.0,7,5,8,20
898,Finland,2014.0,2,7,24,33
899,Finland,1912.0,9,40,22,71
900,Finland,1908.0,1,1,28,30
901,Finland,1992.0,7,5,8,20
902,Finland,2006.0,0,34,7,41
903,Finland,1998.0,2,7,49,58
904,Finland,2010.0,0,1,46,47
905,Finland,1972.0,3,10,7,20
906,Finland,1936.0,12,8,16,36
907,Finland,2014.0,2,7,24,33
908,Finland,1998.0,2,7,49,58
909,Finland,2002.0,7,5,1,13
910,Finland,1920.0,21,14,17,52
911,Finland,1968.0,2,4,6,12
912,Finland,1988.0,8,23,7,38
913,Finland,1948.0,18,14,10,42
914,Finland,1952.0,14,7,31,52
915,Finland,1988.0,8,23,7,38
916,Finland,1992.0,7,5,8,20
917,Finland,1998.0,2,7,49,58
918,Finland,1998.0,2,7,49,58
919,Finland,2002.0,7,5,1,13
920,Finland,2002.0,7,5,1,13
921,Finland,2002.0,7,5,1,13
922,Finland,1948.0,18,14,10,42
923,Finland,1960.0,6,4,9,19
924,Finland,1998.0,2,7,49,58
925,Finland,1920.0,21,14,17,52
926,Finland,1920.0,21,14,17,52
927,Finland,1952.0,14,7,31,52
928,Finland,1956.0,8,7,23,38
929,Finland,1928.0,10,9,10,29
930,Finland,1912.0,9,40,22,71
931,Finland,2010.0,0,1,46,47
932,Finland,1994.0,0,1,29,30
933,Finland,1998.0,2,7,49,58
934,Finland,1948.0,18,14,10,42
935,Finland,1964.0,6,7,7,20
936,Finland,1968.0,2,4,6,12
937,Finland,1908.0,1,1,28,30
938,Finland,1956.0,8,7,23,38
939,Finland,1960.0,6,4,9,19
940,Finland,2014.0,2,7,24,33
941,Finland,1994.0,0,1,29,30
942,Finland,1998.0,2,7,49,58
943,Finland,1994.0,0,1,29,30
944,Finland,1998.0,2,7,49,58
945,Finland,2006.0,0,34,7,41
946,Finland,2010.0,0,1,46,47
947,Finland,1932.0,6,9,17,32
948,Finland,1936.0,12,8,16,36
949,Finland,2012.0,0,1,4,5
950,Finland,1998.0,2,7,49,58
951,Finland,1920.0,21,14,17,52
952,Finland,1924.0,28,21,18,67
953,Finland,1988.0,8,23,7,38
954,Finland,2014.0,2,7,24,33
955,Finland,1956.0,8,7,23,38
956,Finland,1964.0,6,7,7,20
957,Finland,1964.0,6,7,7,20
958,Finland,1956.0,8,7,23,38
959,Finland,1920.0,21,14,17,52
960,Finland,1924.0,28,21,18,67
961,Finland,1928.0,10,9,10,29
962,Finland,1932.0,6,9,17,32
963,Finland,1952.0,14,7,31,52
964,Finland,2010.0,0,1,46,47
965,Finland,2014.0,2,7,24,33
966,Finland,1924.0,28,21,18,67
967,Finland,1932.0,6,9,17,32
968,Finland,1920.0,21,14,17,52
969,Finland,1920.0,21,14,17,52
970,Finland,1924.0,28,21,18,67
971,Finland,1984.0,8,5,18,31
972,Finland,1960.0,6,4,9,19
973,Finland,1998.0,2,7,49,58
974,Finland,1948.0,18,14,10,42
975,Finland,1908.0,1,1,28,30
976,Finland,1920.0,21,14,17,52
977,Finland,1920.0,21,14,17,52
978,Finland,1924.0,28,21,18,67
979,Finland,1952.0,14,7,31,52
980,Finland,1956.0,8,7,23,38
981,Finland,1980.0,4,6,11,21
982,Lucky Girl-1,1912.0,9,40,22,71
983,Nina,1912.0,9,40,22,71
984,Finland,1912.0,9,40,22,71
985,Finland,1908.0,1,1,28,30
986,Finland,2010.0,0,1,46,47
987,Finland,2002.0,7,5,1,13
988,Finland,1908.0,1,1,28,30
989,Finland,1908.0,1,1,28,30
990,Finland,1956.0,8,7,23,38
991,Finland,1960.0,6,4,9,19
992,Finland,1964.0,6,7,7,20
993,Finland,1992.0,7,5,8,20
994,Finland,1952.0,14,7,31,52
995,Finland,1952.0,14,7,31,52
996,Finland,1912.0,9,40,22,71
997,Finland,1952.0,14,7,31,52
998,Finland,1952.0,14,7,31,52
999,Finland,1928.0,10,9,10,29
1000,Finland,1988.0,8,23,7,38
1001,Finland,1998.0,2,7,49,58
1002,Finland,1912.0,9,40,22,71
1003,Finland,1932.0,6,9,17,32
1004,Finland,2006.0,0,34,7,41
1005,Finland,2010.0,0,1,46,47
1006,Finland,1980.0,4,6,11,21
1007,Finland,1980.0,4,6,11,21
1008,Finland,2014.0,2,7,24,33
1009,Finland,1984.0,8,5,18,31
1010,Finland,1988.0,8,23,7,38
1011,Finland,1994.0,0,1,29,30
1012,Finland,1952.0,14,7,31,52
1013,Finland,1952.0,14,7,31,52
1014,Finland,2006.0,0,34,7,41
1015,Finland,2008.0,1,2,2,5
1016,Finland,1952.0,14,7,31,52
1017,Finland,1924.0,28,21,18,67
1018,Finland,1928.0,10,9,10,29
1019,Finland,1956.0,8,7,23,38
1020,Finland,1952.0,14,7,31,52
1021,Finland,1998.0,2,7,49,58
1022,Finland,2002.0,7,5,1,13
1023,Finland,2006.0,0,34,7,41
1024,Finland,1952.0,14,7,31,52
1025,Finland,1956.0,8,7,23,38
1026,Finland,1956.0,8,7,23,38
1027,Finland,1956.0,8,7,23,38
1028,Finland,1998.0,2,7,49,58
1029,Finland,2002.0,7,5,1,13
1030,Finland,1960.0,6,4,9,19
1031,Finland,1964.0,6,7,7,20
1032,Finland,1964.0,6,7,7,20
1033,Finland,1964.0,6,7,7,20
1034,Finland,1968.0,2,4,6,12
1035,Finland,1968.0,2,4,6,12
1036,Finland,1968.0,2,4,6,12
1037,Finland,1908.0,1,1,28,30
1038,Finland,1964.0,6,7,7,20
1039,Finland,1928.0,10,9,10,29
1040,Finland,1984.0,8,5,18,31
1041,Finland,1988.0,8,23,7,38
1042,Finland,1988.0,8,23,7,38
1043,Finland,1988.0,8,23,7,38
1044,Finland,1924.0,28,21,18,67
1045,Finland,1980.0,4,6,11,21
1046,Finland,2010.0,0,1,46,47
1047,Finland,1976.0,9,12,1,22
1048,Finland,1980.0,4,6,11,21
1049,Finland,1980.0,4,6,11,21
1050,Finland,1980.0,4,6,11,21
1051,Finland,1984.0,8,5,18,31
1052,Finland,2010.0,0,1,46,47
1053,Finland,1920.0,21,14,17,52
1054,Finland,1972.0,3,10,7,20
1055,Finland,1908.0,1,1,28,30
1056,Finland,1988.0,8,23,7,38
1057,Finland,2010.0,0,1,46,47
1058,Finland,1964.0,6,7,7,20
1059,Finland,1964.0,6,7,7,20
1060,Finland,1968.0,2,4,6,12
1061,Finland,1968.0,2,4,6,12
1062,Finland,1998.0,2,7,49,58
1063,Finland,1994.0,0,1,29,30
1064,Finland,1994.0,0,1,29,30
1065,Finland,1994.0,0,1,29,30
1066,Finland,1998.0,2,7,49,58
1067,Finland,1998.0,2,7,49,58
1068,Finland,1998.0,2,7,49,58
1069,Finland,1988.0,8,23,7,38
1070,Finland,1994.0,0,1,29,30
1071,Finland,1998.0,2,7,49,58
1072,Finland,1920.0,21,14,17,52
1073,Finland,1924.0,28,21,18,67
1074,Finland,1964.0,6,7,7,20
1075,Finland,1952.0,14,7,31,52
1076,Finland,1948.0,18,14,10,42
1077,Finland,2006.0,0,34,7,41
1078,Finland,1956.0,8,7,23,38
1079,Finland,1984.0,8,5,18,31
1080,Finland,1936.0,12,8,16,36
1081,Finland,1920.0,21,14,17,52
1082,Finland,1994.0,0,1,29,30
1083,Finland,1998.0,2,7,49,58
1084,Finland,2008.0,1,2,2,5
1085,Finland,1992.0,7,5,8,20
1086,Finland,1992.0,7,5,8,20
1087,Finland,1992.0,7,5,8,20
1088,Finland,1908.0,1,1,28,30
1089,Finland,1920.0,21,14,17,52
1090,Finland,2006.0,0,34,7,41
1091,Finland,1998.0,2,7,49,58
1092,Finland,1998.0,2,7,49,58
1093,Finland,1924.0,28,21,18,67
1094,Finland,2006.0,0,34,7,41
1095,Finland,1936.0,12,8,16,36
1096,Finland,1988.0,8,23,7,38
1097,Finland,1992.0,7,5,8,20
1098,Finland,1912.0,9,40,22,71
1099,Finland,1912.0,9,40,22,71
1100,Finland,1920.0,21,14,17,52
1101,Finland,1920.0,21,14,17,52
1102,Finland,1924.0,28,21,18,67
1103,Finland,1968.0,2,4,6,12
1104,Finland,2010.0,0,1,46,47
1105,Finland,2014.0,2,7,24,33
1106,Finland,2014.0,2,7,24,33
1107,Finland,2014.0,2,7,24,33
1108,Finland,1924.0,28,21,18,67
1109,Finland,2006.0,0,34,7,41
1110,Finland,2006.0,0,34,7,41
1111,Finland,1988.0,8,23,7,38
1112,Finland,1998.0,2,7,49,58
1113,Finland,2006.0,0,34,7,41
1114,Finland,1936.0,12,8,16,36
1115,Finland,1998.0,2,7,49,58
1116,Finland,1920.0,21,14,17,52
1117,Finland,1920.0,21,14,17,52
1118,Finland,1920.0,21,14,17,52
1119,Finland,1920.0,21,14,17,52
1120,Finland,1924.0,28,21,18,67
1121,Finland,1924.0,28,21,18,67
1122,Finland,1924.0,28,21,18,67
1123,Finland,1924.0,28,21,18,67
1124,Finland,1924.0,28,21,18,67
1125,Finland,1928.0,10,9,10,29
1126,Finland,1928.0,10,9,10,29
1127,Finland,1928.0,10,9,10,29
1128,Finland,1932.0,6,9,17,32
1129,Finland,1936.0,12,8,16,36
1130,Finland,1984.0,8,5,18,31
1131,Finland,1984.0,8,5,18,31
1132,Finland,1988.0,8,23,7,38
1133,Finland,1988.0,8,23,7,38
1134,Finland,1988.0,8,23,7,38
1135,Finland,1984.0,8,5,18,31
1136,Finland,1928.0,10,9,10,29
1137,Finland,1936.0,12,8,16,36
1138,Finland,1968.0,2,4,6,12
1139,Finland,1936.0,12,8,16,36
1140,Finland,1988.0,8,23,7,38
1141,Finland,1994.0,0,1,29,30
1142,Finland,1952.0,14,7,31,52
1143,Finland,1912.0,9,40,22,71
1144,Finland,1908.0,1,1,28,30
1145,Finland,1932.0,6,9,17,32
1146,Finland,1936.0,12,8,16,36
1147,Finland,1952.0,14,7,31,52
1148,Finland,1994.0,0,1,29,30
1149,Finland,1998.0,2,7,49,58
1150,Finland,1948.0,18,14,10,42
1151,Finland,1948.0,18,14,10,42
1152,Finland,1924.0,28,21,18,67
1153,Nina,1912.0,9,40,22,71
1154,Finland,1912.0,9,40,22,71
1155,Finland,1924.0,28,21,18,67
1156,Finland,1928.0,10,9,10,29
1157,Finland,1932.0,6,9,17,32
1158,Finland,1912.0,9,40,22,71
1159,Finland,1920.0,21,14,17,52
1160,Finland,1994.0,0,1,29,30
1161,Finland,1998.0,2,7,49,58
1162,Finland,2006.0,0,34,7,41
1163,Finland,2010.0,0,1,46,47
1164,Finland,2010.0,0,1,46,47
1165,Finland,1920.0,21,14,17,52
1166,Finland,1932.0,6,9,17,32
1167,Finland,1956.0,8,7,23,38
1168,Finland,1912.0,9,40,22,71
1169,Finland,1920.0,21,14,17,52
1170,Finland,2012.0,0,1,4,5
1171,Finland,1932.0,6,9,17,32
1172,Finland,1936.0,12,8,16,36
1173,Finland,1924.0,28,21,18,67
1174,Finland,1928.0,10,9,10,29
1175,Finland,1936.0,12,8,16,36
1176,Finland,2014.0,2,7,24,33
1177,Finland,2010.0,0,1,46,47
1178,Finland,2008.0,1,2,2,5
1179,Finland,2010.0,0,1,46,47
1180,Finland,1976.0,9,12,1,22
1181,Finland,1980.0,4,6,11,21
1182,Finland,1956.0,8,7,23,38
1183,Finland,1960.0,6,4,9,19
1184,Finland,1908.0,1,1,28,30
1185,Finland,1908.0,1,1,28,30
1186,Finland,1980.0,4,6,11,21
1187,Finland,1992.0,7,5,8,20
1188,Finland,1956.0,8,7,23,38
1189,Finland,1920.0,21,14,17,52
1190,Finland,1932.0,6,9,17,32
1191,Finland,2010.0,0,1,46,47
1192,Finland,2016.0,0,0,1,1
1193,Finland,1956.0,8,7,23,38
1194,Finland,2006.0,0,34,7,41
1195,Finland,1960.0,6,4,9,19
1196,Finland,1964.0,6,7,7,20
1197,Finland,1980.0,4,6,11,21
1198,Finland,1984.0,8,5,18,31
1199,Finland,1988.0,8,23,7,38
1200,Finland,1998.0,2,7,49,58
1201,Finland,1964.0,6,7,7,20
1202,Finland,1928.0,10,9,10,29
1203,Finland,1964.0,6,7,7,20
1204,Finland,1998.0,2,7,49,58
1205,Finland,1908.0,1,1,28,30
1206,Finland,2010.0,0,1,46,47
1207,Finland,1964.0,6,7,7,20
1208,Finland,1998.0,2,7,49,58
1209,Finland,2010.0,0,1,46,47
1210,Finland,1996.0,1,2,1,4
1211,Finland,1952.0,14,7,31,52
1212,Finland,1956.0,8,7,23,38
1213,Finland,1960.0,6,4,9,19
1214,Finland,1992.0,7,5,8,20
1215,Finland,1994.0,0,1,29,30
1216,Finland,2014.0,2,7,24,33
1217,Finland,1920.0,21,14,17,52
1218,Finland,1924.0,28,21,18,67
1219,Finland,2010.0,0,1,46,47
1220,Finland,1988.0,8,23,7,38
1221,Finland,1992.0,7,5,8,20
1222,Finland,1996.0,1,2,1,4
1223,Finland,1984.0,8,5,18,31
1224,Finland,1952.0,14,7,31,52
1225,Finland,1948.0,18,14,10,42
1226,Finland,1980.0,4,6,11,21
1227,Finland,1998.0,2,7,49,58
1228,Finland,1936.0,12,8,16,36
1229,Finland,1998.0,2,7,49,58
1230,Finland,1972.0,3,10,7,20
1231,Finland,1976.0,9,12,1,22
1232,Finland,1980.0,4,6,11,21
1233,Finland,1980.0,4,6,11,21
1234,Finland,1998.0,2,7,49,58
1235,Finland,1908.0,1,1,28,30
1236,Finland,1998.0,2,7,49,58
1237,Finland,1984.0,8,5,18,31
1238,Finland,1924.0,28,21,18,67
1239,Finland,1924.0,28,21,18,67
1240,Finland,1924.0,28,21,18,67
1241,Finland,1924.0,28,21,18,67
1242,Finland,1924.0,28,21,18,67
1243,Finland,1924.0,28,21,18,67
1244,Finland,1928.0,10,9,10,29
1245,Finland,1928.0,10,9,10,29
1246,Finland,1952.0,14,7,31,52
1247,Finland,1992.0,7,5,8,20
1248,Finland,1992.0,7,5,8,20
1249,Finland,2006.0,0,34,7,41
1250,Finland,1972.0,3,10,7,20
1251,Finland,1920.0,21,14,17,52
1252,Finland,1924.0,28,21,18,67
1253,Finland,1912.0,9,40,22,71
1254,Finland,1948.0,18,14,10,42
1255,Finland,1948.0,18,14,10,42
1256,Finland,1952.0,14,7,31,52
1257,Finland,2014.0,2,7,24,33
1258,Finland,1960.0,6,4,9,19
1259,Finland,1988.0,8,23,7,38
1260,Finland,1988.0,8,23,7,38
1261,Finland,2012.0,0,1,4,5
1262,Finland,2006.0,0,34,7,41
1263,Finland,2010.0,0,1,46,47
1264,Finland,2010.0,0,1,46,47
1265,Finland,2014.0,2,7,24,33
1266,Finland,1912.0,9,40,22,71
1267,Finland,1948.0,18,14,10,42
1268,Finland,1908.0,1,1,28,30
1269,Finland,1912.0,9,40,22,71
1270,Finland,2006.0,0,34,7,41
1271,Finland,2010.0,0,1,46,47
1272,Finland,2010.0,0,1,46,47
1273,Finland,2014.0,2,7,24,33
1274,Finland,2014.0,2,7,24,33
1275,Finland,1908.0,1,1,28,30
1276,Finland,2010.0,0,1,46,47
1277,Finland,1988.0,8,23,7,38
1278,Finland,1932.0,6,9,17,32
1279,Finland,1932.0,6,9,17,32
1280,Finland,1912.0,9,40,22,71
1281,Finland,1912.0,9,40,22,71
1282,Finland,1936.0,12,8,16,36
1283,Finland,1936.0,12,8,16,36
1284,Finland,1948.0,18,14,10,42
1285,Finland,1912.0,9,40,22,71
1286,Finland,1908.0,1,1,28,30
1287,Finland,1952.0,14,7,31,52
1288,Finland,1972.0,3,10,7,20
1289,Finland,1976.0,9,12,1,22
1290,Finland,1948.0,18,14,10,42
1291,Finland,1936.0,12,8,16,36
1292,Finland,2014.0,2,7,24,33
1293,Finland,1972.0,3,10,7,20
1294,Finland,1998.0,2,7,49,58
1295,Finland,2006.0,0,34,7,41
1296,Finland,2010.0,0,1,46,47
1297,Finland,2014.0,2,7,24,33
1298,Finland,2006.0,0,34,7,41
1299,Finland,1984.0,8,5,18,31
1300,Finland,1956.0,8,7,23,38
1301,Finland,1908.0,1,1,28,30
1302,Finland,1912.0,9,40,22,71
1303,Finland,1912.0,9,40,22,71
1304,Heatherbell,1912.0,9,40,22,71
1305,Finland,1908.0,1,1,28,30
1306,Finland,1928.0,10,9,10,29
1307,Finland,1932.0,6,9,17,32
1308,Finland,1932.0,6,9,17,32
1309,Finland,1932.0,6,9,17,32
1310,Finland,1932.0,6,9,17,32
1311,Finland,1936.0,12,8,16,36
1312,Finland,1948.0,18,14,10,42
1313,Finland,1948.0,18,14,10,42
1314,Finland,1952.0,14,7,31,52
1315,Finland,1988.0,8,23,7,38
1316,Finland,1936.0,12,8,16,36
1317,Finland,1998.0,2,7,49,58
1318,Finland,2006.0,0,34,7,41
1319,Finland,2010.0,0,1,46,47
1320,Finland,2014.0,2,7,24,33
1321,Finland,1998.0,2,7,49,58
1322,Finland,1924.0,28,21,18,67
1323,Finland,1996.0,1,2,1,4
1324,Finland,1928.0,10,9,10,29
1325,Finland,1912.0,9,40,22,71
1326,Finland,1976.0,9,12,1,22
1327,Heatherbell,1912.0,9,40,22,71
1328,Finland,1952.0,14,7,31,52
1329,Finland,1948.0,18,14,10,42
1330,Finland,1908.0,1,1,28,30
1331,Finland,1984.0,8,5,18,31
1332,Finland,1988.0,8,23,7,38
1333,Finland,1924.0,28,21,18,67
1334,Finland,1932.0,6,9,17,32
1335,Finland,1912.0,9,40,22,71
1336,Finland,2010.0,0,1,46,47
1337,Ralia,1952.0,14,7,31,52
1338,Finland,1924.0,28,21,18,67
1339,Finland,1924.0,28,21,18,67
1340,Finland,1924.0,28,21,18,67
1341,Finland,1928.0,10,9,10,29
1342,Finland,1908.0,1,1,28,30
1343,Finland,1998.0,2,7,49,58
1344,Finland,1998.0,2,7,49,58
1345,Finland,1998.0,2,7,49,58
1346,Finland,1908.0,1,1,28,30
1347,Finland,1994.0,0,1,29,30
1348,Finland,2008.0,1,2,2,5
1349,Finland,1908.0,1,1,28,30
1350,Finland,1912.0,9,40,22,71
1351,Finland,1912.0,9,40,22,71
1352,Finland,1924.0,28,21,18,67
1353,Finland,1994.0,0,1,29,30
1354,Finland,1952.0,14,7,31,52
1355,Finland,1952.0,14,7,31,52
1356,Finland,1976.0,9,12,1,22
1357,Finland,1988.0,8,23,7,38
1358,Finland,1998.0,2,7,49,58
1359,Finland,1912.0,9,40,22,71
1360,Finland,1956.0,8,7,23,38
1361,Finland,1988.0,8,23,7,38
1362,Finland,1972.0,3,10,7,20
1363,Finland,1976.0,9,12,1,22
1364,Finland,1936.0,12,8,16,36
1365,Finland,1912.0,9,40,22,71
1366,Finland,1912.0,9,40,22,71
1367,Finland,1920.0,21,14,17,52
1368,Finland,1968.0,2,4,6,12
1369,Finland,1924.0,28,21,18,67
1370,Lucky Girl-1,1912.0,9,40,22,71
1371,Finland,1980.0,4,6,11,21
1372,Lucky Girl-1,1912.0,9,40,22,71
1373,Finland,2002.0,7,5,1,13
1374,Finland,2002.0,7,5,1,13
1375,Finland,2006.0,0,34,7,41
1376,Finland,1988.0,8,23,7,38
1377,Finland,1994.0,0,1,29,30
1378,Finland,1920.0,21,14,17,52
1379,Finland,1912.0,9,40,22,71
1380,Finland,1932.0,6,9,17,32
1381,Finland,1932.0,6,9,17,32
1382,Finland,1936.0,12,8,16,36
1383,Finland,1948.0,18,14,10,42
1384,Finland,1976.0,9,12,1,22
1385,Finland,1980.0,4,6,11,21
1386,Finland,1924.0,28,21,18,67
1387,Finland,1924.0,28,21,18,67
1388,Finland,1924.0,28,21,18,67
1389,Finland,1924.0,28,21,18,67
1390,Finland,1924.0,28,21,18,67
1391,Finland,1928.0,10,9,10,29
1392,Finland,1928.0,10,9,10,29
1393,Finland,1964.0,6,7,7,20
1394,Finland,1964.0,6,7,7,20
1395,Finland,1984.0,8,5,18,31
1396,Finland,1908.0,1,1,28,30
1397,Finland,1912.0,9,40,22,71
1398,Finland,1998.0,2,7,49,58
1399,Finland,1920.0,21,14,17,52
1400,Finland,1920.0,21,14,17,52
1401,Finland,1924.0,28,21,18,67
1402,Finland,2010.0,0,1,46,47
1403,Finland,1998.0,2,7,49,58
1404,Finland,2006.0,0,34,7,41
1405,Finland,2010.0,0,1,46,47
1406,Finland,2014.0,2,7,24,33
1407,Finland,1924.0,28,21,18,67
1408,Finland,1932.0,6,9,17,32
1409,Finland,1936.0,12,8,16,36
1410,Finland,1912.0,9,40,22,71
1411,Finland,1912.0,9,40,22,71
1412,Finland,1920.0,21,14,17,52
1413,Finland,1920.0,21,14,17,52
1414,Finland,1988.0,8,23,7,38
1415,Finland,1998.0,2,7,49,58
1416,Finland,1980.0,4,6,11,21
1417,Finland,1936.0,12,8,16,36
1418,Finland,1936.0,12,8,16,36
1419,Finland,2010.0,0,1,46,47
1420,Finland,2010.0,0,1,46,47
1421,Finland,1988.0,8,23,7,38
1422,Ralia,1952.0,14,7,31,52
1423,Finland,1948.0,18,14,10,42
1424,Finland,1920.0,21,14,17,52
1425,Finland,1924.0,28,21,18,67
1426,Finland,1928.0,10,9,10,29
1427,Finland,1948.0,18,14,10,42
1428,Finland,1960.0,6,4,9,19
1429,Finland,1976.0,9,12,1,22
1430,Finland,1932.0,6,9,17,32
1431,Finland,1936.0,12,8,16,36
1432,Finland,2006.0,0,34,7,41
1433,Finland,1912.0,9,40,22,71
1434,Finland,2014.0,2,7,24,33
1435,Finland,1998.0,2,7,49,58
1436,Finland,1912.0,9,40,22,71
1437,Finland,2010.0,0,1,46,47
1438,Finland,1956.0,8,7,23,38
1439,Finland,1948.0,18,14,10,42
1440,Finland,1912.0,9,40,22,71
1441,Finland,1920.0,21,14,17,52
1442,Finland,1994.0,0,1,29,30
1443,Finland,1972.0,3,10,7,20
1444,Finland,1912.0,9,40,22,71
1445,Finland,2014.0,2,7,24,33
1446,Finland,1920.0,21,14,17,52
1447,Finland,1920.0,21,14,17,52
1448,Finland,1920.0,21,14,17,52
1449,Finland,1948.0,18,14,10,42
1450,Finland,1956.0,8,7,23,38
1451,Finland,1952.0,14,7,31,52
1452,Finland,1972.0,3,10,7,20
1453,Finland,1972.0,3,10,7,20
1454,Finland,1976.0,9,12,1,22
1455,Finland,1976.0,9,12,1,22
1456,Finland,1994.0,0,1,29,30
1457,Finland,1936.0,12,8,16,36
1458,Finland,1988.0,8,23,7,38
1459,Finland,1932.0,6,9,17,32
1460,Finland,1932.0,6,9,17,32
1461,Finland,1972.0,3,10,7,20
1462,Finland,1952.0,14,7,31,52
1463,Finland,2010.0,0,1,46,47
1464,Nina,1912.0,9,40,22,71
1465,Finland,1952.0,14,7,31,52
1466,Finland,1936.0,12,8,16,36
1467,Finland,1936.0,12,8,16,36
1468,Finland,1936.0,12,8,16,36
1469,Finland,1906.0,2,1,1,4
1470,Finland,1906.0,2,1,1,4
1471,Finland,1908.0,1,1,28,30
1472,Finland,1908.0,1,1,28,30
1473,Finland,1920.0,21,14,17,52
1474,Finland,1920.0,21,14,17,52
1475,Finland,1920.0,21,14,17,52
1476,Finland,1924.0,28,21,18,67
1477,Finland,1924.0,28,21,18,67
1478,Finland,1928.0,10,9,10,29
1479,Ralia,1952.0,14,7,31,52
1480,Finland,1924.0,28,21,18,67
1481,Lucky Girl-1,1912.0,9,40,22,71
1482,Finland,1952.0,14,7,31,52
1483,Finland,1924.0,28,21,18,67
1484,Finland,1924.0,28,21,18,67
1485,Finland,1948.0,18,14,10,42
1486,Finland,1952.0,14,7,31,52
1487,Finland,1952.0,14,7,31,52
1488,Finland,2012.0,0,1,4,5
1489,Finland,2000.0,3,1,1,5
1490,Finland,2004.0,0,2,0,2
1491,Finland,1984.0,8,5,18,31
1492,Finland,1988.0,8,23,7,38
1493,Finland,1998.0,2,7,49,58
1494,Finland,1952.0,14,7,31,52
1495,Finland,1956.0,8,7,23,38
1496,Finland,1928.0,10,9,10,29
1497,Norway,1992.0,11,30,6,47
1498,Norway,1992.0,11,30,6,47
1499,Norway,1994.0,8,17,5,30
1500,Norway,1994.0,8,17,5,30
1501,Norway,1994.0,8,17,5,30
1502,Norway,2002.0,23,11,7,41
1503,Norway,2002.0,23,11,7,41
1504,Norway,2006.0,2,9,12,23
1505,Norway,2008.0,16,5,1,22
1506,Norway,1920.0,58,52,27,137
1507,Norway,1996.0,2,3,18,23
1508,Norway,1920.0,58,52,27,137
1509,Norway,1952.0,12,14,6,32
1510,Norway,1960.0,5,6,0,11
1511,Taifun,1912.0,40,6,34,80
1512,Fornebo,1920.0,58,52,27,137
1513,Norway,1912.0,40,6,34,80
1514,Stella-2,1920.0,58,52,27,137
1515,Heira II,1920.0,58,52,27,137
1516,Norway,1994.0,8,17,5,30
1517,Norway,1994.0,8,17,5,30
1518,Norway,1998.0,13,15,12,40
1519,Norway,1998.0,13,15,12,40
1520,Norway,2002.0,23,11,7,41
1521,Norway,2002.0,23,11,7,41
1522,Norway,2012.0,15,1,1,17
1523,Norway,2016.0,0,0,19,19
1524,Norway,1908.0,7,32,3,42
1525,Norway,1912.0,40,6,34,80
1526,Norway,1968.0,15,11,2,28
1527,Norway,1972.0,4,10,11,25
1528,Norway,1928.0,10,8,6,24
1529,Norway,1996.0,2,3,18,23
1530,Norway,1900.0,0,6,3,9
1531,Norway,1906.0,20,5,0,25
1532,Norway,1908.0,7,32,3,42
1533,Norway,1920.0,58,52,27,137
1534,Norway,1952.0,12,14,6,32
1535,Norway,1952.0,12,14,6,32
1536,Norway,1952.0,12,14,6,32
1537,Norway,1912.0,40,6,34,80
1538,Norway,1920.0,58,52,27,137
1539,Norway,1988.0,2,26,5,33
1540,Norway,1992.0,11,30,6,47
1541,Norway,1996.0,2,3,18,23
1542,Norway,1936.0,8,20,18,46
1543,Norway,1980.0,1,5,9,15
1544,Norway,1984.0,6,6,7,19
1545,Norway,1998.0,13,15,12,40
1546,Norway,2002.0,23,11,7,41
1547,Norway,1976.0,5,10,1,16
1548,Norway,1998.0,13,15,12,40
1549,Norway,2002.0,23,11,7,41
1550,Norway,2006.0,2,9,12,23
1551,Norna,1928.0,10,8,6,24
1552,Magda IX,1912.0,40,6,34,80
1553,Norna,1928.0,10,8,6,24
1554,Norway,1992.0,11,30,6,47
1555,Norway,1994.0,8,17,5,30
1556,Mosk II,1920.0,58,52,27,137
1557,Elisabeth X,1952.0,12,14,6,32
1558,Norway,2016.0,0,0,19,19
1559,Norway,1968.0,15,11,2,28
1560,Norway,1968.0,15,11,2,28
1561,Norway,1972.0,4,10,11,25
1562,Norway,2002.0,23,11,7,41
1563,Norway,1980.0,1,5,9,15
1564,Norway,1980.0,1,5,9,15
1565,Norway,1980.0,1,5,9,15
1566,Norway,1984.0,6,6,7,19
1567,Norway,1984.0,6,6,7,19
1568,Norway,1908.0,7,32,3,42
1569,Norway,1928.0,10,8,6,24
1570,Norway,1928.0,10,8,6,24
1571,Norway,1932.0,3,4,3,10
1572,Norway,1936.0,8,20,18,46
1573,Norway,1936.0,8,20,18,46
1574,Norway,1936.0,8,20,18,46
1575,Norway,1936.0,8,20,18,46
1576,Norway,2010.0,16,14,9,39
1577,Norway,2014.0,18,5,13,36
1578,Pan,1948.0,7,7,17,31
1579,Pan,1952.0,12,14,6,32
1580,Norway,1920.0,58,52,27,137
1581,Norway,1932.0,3,4,3,10
1582,Norway,2000.0,20,4,19,43
1583,Norway,2000.0,20,4,19,43
1584,Norway,1952.0,12,14,6,32
1585,Norway,2016.0,0,0,19,19
1586,Norway,2010.0,16,14,9,39
1587,Norway,2010.0,16,14,9,39
1588,Norway,2014.0,18,5,13,36
1589,Norway,2014.0,18,5,13,36
1590,Norway,2014.0,18,5,13,36
1591,Norway,1968.0,15,11,2,28
1592,Norway,1972.0,4,10,11,25
1593,Norway,1952.0,12,14,6,32
1594,Norway,1976.0,5,10,1,16
1595,Sirene,1960.0,5,6,0,11
1596,Stella-2,1920.0,58,52,27,137
1597,Norway,2010.0,16,14,9,39
1598,Magda IX,1912.0,40,6,34,80
1599,Norway,1912.0,40,6,34,80
1600,Norway,1912.0,40,6,34,80
1601,Atlanta,1920.0,58,52,27,137
1602,Atlanta,1920.0,58,52,27,137
1603,Norway,1912.0,40,6,34,80
1604,Norway,1988.0,2,26,5,33
1605,Norway,1992.0,11,30,6,47
1606,Norway,2002.0,23,11,7,41
1607,Norway,2006.0,2,9,12,23
1608,Norway,2010.0,16,14,9,39
1609,Norway,2010.0,16,14,9,39
1610,Norway,2010.0,16,14,9,39
1611,Norway,2010.0,16,14,9,39
1612,Norway,2010.0,16,14,9,39
1613,Norway,2014.0,18,5,13,36
1614,Norway,2014.0,18,5,13,36
1615,Norway,2014.0,18,5,13,36
1616,Norway,1988.0,2,26,5,33
1617,Norway,1998.0,13,15,12,40
1618,Norway,1998.0,13,15,12,40
1619,Norway,1998.0,13,15,12,40
1620,Norway,2002.0,23,11,7,41
1621,Norway,2002.0,23,11,7,41
1622,Norway,2002.0,23,11,7,41
1623,Norway,2002.0,23,11,7,41
1624,Norway,2006.0,2,9,12,23
1625,Norway,2006.0,2,9,12,23
1626,Norway,2006.0,2,9,12,23
1627,Norway,2010.0,16,14,9,39
1628,Norway,2010.0,16,14,9,39
1629,Norway,2014.0,18,5,13,36
1630,Norway,2014.0,18,5,13,36
1631,Norway,1912.0,40,6,34,80
1632,Norway,1920.0,58,52,27,137
1633,Ormsund Roklub-2,1912.0,40,6,34,80
1634,Bera,1924.0,18,12,9,39
1635,Norway,1920.0,58,52,27,137
1636,Norway,1908.0,7,32,3,42
1637,Norway,1924.0,18,12,9,39
1638,Norway,2016.0,0,0,19,19
1639,Heira II,1920.0,58,52,27,137
1640,Norway,1956.0,3,1,3,7
1641,Norway,2010.0,16,14,9,39
1642,Norway,1980.0,1,5,9,15
1643,Norway,1920.0,58,52,27,137
1644,Norway,2010.0,16,14,9,39
1645,Norway,1908.0,7,32,3,42
1646,Norway,1912.0,40,6,34,80
1647,Norway,1920.0,58,52,27,137
1648,Norway,1972.0,4,10,11,25
1649,Norway,1980.0,1,5,9,15
1650,Norway,1998.0,13,15,12,40
1651,Norway,1906.0,20,5,0,25
1652,Norway,1908.0,7,32,3,42
1653,Norway,1964.0,3,6,6,15
1654,Norway,1964.0,3,6,6,15
1655,Taifun,1912.0,40,6,34,80
1656,Jo,1920.0,58,52,27,137
1657,Norway,1994.0,8,17,5,30
1658,Norway,1994.0,8,17,5,30
1659,Norway,2008.0,16,5,1,22
1660,Norway,2012.0,15,1,1,17
1661,Norway,1952.0,12,14,6,32
1662,Norway,1952.0,12,14,6,32
1663,Norway,1956.0,3,1,3,7
1664,Norway,1960.0,5,6,0,11
1665,Norway,1936.0,8,20,18,46
1666,Norway,1936.0,8,20,18,46
1667,Norway,2008.0,16,5,1,22
1668,Norway,2016.0,0,0,19,19
1669,Norway,1936.0,8,20,18,46
1670,Norway,1912.0,40,6,34,80
1671,Norway,1960.0,5,6,0,11
1672,Norway,1960.0,5,6,0,11
1673,Norna,1928.0,10,8,6,24
1674,Norway,1920.0,58,52,27,137
1675,Norway,1920.0,58,52,27,137
1676,Norway,2006.0,2,9,12,23
1677,Norway,1998.0,13,15,12,40
1678,Norway,1948.0,7,7,17,31
1679,Norway,1906.0,20,5,0,25
1680,Norway,1908.0,7,32,3,42
1681,Norway,2006.0,2,9,12,23
1682,Norway,2006.0,2,9,12,23
1683,Norway,2006.0,2,9,12,23
1684,Norway,1996.0,2,3,18,23
1685,Norway,1906.0,20,5,0,25
1686,Norway,1908.0,7,32,3,42
1687,Norway,1912.0,40,6,34,80
1688,Atlanta,1920.0,58,52,27,137
1689,Taifun,1912.0,40,6,34,80
1690,Norway,1972.0,4,10,11,25
1691,Elisabeth V,1924.0,18,12,9,39
1692,Norway,1992.0,11,30,6,47
1693,Norway,2004.0,5,0,2,7
1694,Norway,1988.0,2,26,5,33
1695,Norway,1956.0,3,1,3,7
1696,Norway,2002.0,23,11,7,41
1697,Norway,1920.0,58,52,27,137
1698,Norway,2000.0,20,4,19,43
1699,Fornebo,1920.0,58,52,27,137
1700,Norway,1976.0,5,10,1,16
1701,Norway,1988.0,2,26,5,33
1702,Silja,1936.0,8,20,18,46
1703,Silja,1936.0,8,20,18,46
1704,Norway,1992.0,11,30,6,47
1705,Norway,2000.0,20,4,19,43
1706,Norway,1988.0,2,26,5,33
1707,Norway,1992.0,11,30,6,47
1708,Norway,1994.0,8,17,5,30
1709,Norway,2014.0,18,5,13,36
1710,Norway,2014.0,18,5,13,36
1711,Norway,2014.0,18,5,13,36
1712,Norway,1992.0,11,30,6,47
1713,Norway,1988.0,2,26,5,33
1714,Norway,1992.0,11,30,6,47
1715,Norway,1988.0,2,26,5,33
1716,Norway,1968.0,15,11,2,28
1717,Norway,1968.0,15,11,2,28
1718,Norway,1920.0,58,52,27,137
1719,Norway,1920.0,58,52,27,137
1720,Norway,1964.0,3,6,6,15
1721,Norway,1964.0,3,6,6,15
1722,Norway,1912.0,40,6,34,80
1723,Norway,1984.0,6,6,7,19
1724,Norway,1912.0,40,6,34,80
1725,Norway,1968.0,15,11,2,28
1726,Marmi II-1,1920.0,58,52,27,137
1727,Norway,1904.0,2,0,0,2
1728,Norway,1948.0,7,7,17,31
1729,Norway,2000.0,20,4,19,43
1730,Norway,1906.0,20,5,0,25
1731,Norway,1968.0,15,11,2,28
1732,Norway,1980.0,1,5,9,15
1733,Norway,1912.0,40,6,34,80
1734,Norway,1936.0,8,20,18,46
1735,Norway,1952.0,12,14,6,32
1736,Norway,1952.0,12,14,6,32
1737,Norway,1996.0,2,3,18,23
1738,Norway,2000.0,20,4,19,43
1739,Norway,1952.0,12,14,6,32
1740,Norway,1952.0,12,14,6,32
1741,Norway,2002.0,23,11,7,41
1742,Norway,2002.0,23,11,7,41
1743,Norway,2002.0,23,11,7,41
1744,Norway,2006.0,2,9,12,23
1745,Norway,1928.0,10,8,6,24
1746,Norway,1928.0,10,8,6,24
1747,Norway,1928.0,10,8,6,24
1748,Norway,1932.0,3,4,3,10
1749,Norway,1948.0,7,7,17,31
1750,Norway,2010.0,16,14,9,39
1751,Norway,1906.0,20,5,0,25
1752,Magda IX,1912.0,40,6,34,80
1753,Norway,1952.0,12,14,6,32
1754,Mosk II,1920.0,58,52,27,137
1755,Encore,1952.0,12,14,6,32
1756,Norway,2014.0,18,5,13,36
1757,Norway,1948.0,7,7,17,31
1758,Fornebo,1920.0,58,52,27,137
1759,Norway,1920.0,58,52,27,137
1760,Elisabeth X,1952.0,12,14,6,32
1761,Elisabeth X,1952.0,12,14,6,32
1762,Norway,1988.0,2,26,5,33
1763,Norway,2004.0,5,0,2,7
1764,Norway,1906.0,20,5,0,25
1765,Norway,2014.0,18,5,13,36
1766,Norway,1972.0,4,10,11,25
1767,Norway,1972.0,4,10,11,25
1768,Norway,1976.0,5,10,1,16
1769,Norway,1976.0,5,10,1,16
1770,Norway,2008.0,16,5,1,22
1771,Norway,2012.0,15,1,1,17
1772,Norway,2016.0,0,0,19,19
1773,Norway,1998.0,13,15,12,40
1774,Norway,1936.0,8,20,18,46
1775,Norway,1906.0,20,5,0,25
1776,Heira II,1920.0,58,52,27,137
1777,Norway,1996.0,2,3,18,23
1778,Norway,1900.0,0,6,3,9
1779,Norway,1992.0,11,30,6,47
1780,Norway,1998.0,13,15,12,40
1781,Mosk II,1920.0,58,52,27,137
1782,Mosk II,1920.0,58,52,27,137
1783,Norway,1998.0,13,15,12,40
1784,Norway,2002.0,23,11,7,41
1785,Norway,1956.0,3,1,3,7
1786,Norway,1964.0,3,6,6,15
1787,Taifun,1912.0,40,6,34,80
1788,Norway,1992.0,11,30,6,47
1789,Norway,2000.0,20,4,19,43
1790,Norway,2014.0,18,5,13,36
1791,Norway,2014.0,18,5,13,36
1792,Norway,1948.0,7,7,17,31
1793,Norway,1984.0,6,6,7,19
1794,Norway,2008.0,16,5,1,22
1795,Norway,2012.0,15,1,1,17
1796,Norway,2016.0,0,0,19,19
1797,Norway,1998.0,13,15,12,40
1798,Norway,2000.0,20,4,19,43
1799,Norway,1968.0,15,11,2,28
1800,Norway,1908.0,7,32,3,42
1801,Norway,1960.0,5,6,0,11
1802,Norway,1964.0,3,6,6,15
1803,Norway,1964.0,3,6,6,15
1804,Norway,1968.0,15,11,2,28
1805,Norway,1968.0,15,11,2,28
1806,Norway,2010.0,16,14,9,39
1807,Norway,1972.0,4,10,11,25
1808,Norway,1972.0,4,10,11,25
1809,Norway,1924.0,18,12,9,39
1810,Norway,1924.0,18,12,9,39
1811,Norway,1924.0,18,12,9,39
1812,Norway,1928.0,10,8,6,24
1813,Norway,1928.0,10,8,6,24
1814,Norway,1932.0,3,4,3,10
1815,Norway,1920.0,58,52,27,137
1816,Norway,2000.0,20,4,19,43
1817,Norway,2000.0,20,4,19,43
1818,Norway,1908.0,7,32,3,42
1819,Norway,2000.0,20,4,19,43
1820,Norway,1998.0,13,15,12,40
1821,Norway,1906.0,20,5,0,25
1822,Norway,1906.0,20,5,0,25
1823,Bera,1924.0,18,12,9,39
1824,Norway,1936.0,8,20,18,46
1825,Norway,1936.0,8,20,18,46
1826,Norway,1936.0,8,20,18,46
1827,Norway,1948.0,7,7,17,31
1828,Norway,1920.0,58,52,27,137
1829,Norway,1920.0,58,52,27,137
1830,Norway,1908.0,7,32,3,42
1831,Norway,1908.0,7,32,3,42
1832,Norway,1988.0,2,26,5,33
1833,Norway,2000.0,20,4,19,43
1834,Norway,1906.0,20,5,0,25
1835,Norway,1908.0,7,32,3,42
1836,Norway,2008.0,16,5,1,22
1837,Norway,1998.0,13,15,12,40
1838,Norway,1998.0,13,15,12,40
1839,Norway,2002.0,23,11,7,41
1840,Norway,2006.0,2,9,12,23
1841,Norway,2006.0,2,9,12,23
1842,Norway,2010.0,16,14,9,39
1843,Norway,1912.0,40,6,34,80
1844,Norway,1976.0,5,10,1,16
1845,Norway,1988.0,2,26,5,33
1846,Norway,1904.0,2,0,0,2
1847,Norway,1972.0,4,10,11,25
1848,Norway,1976.0,5,10,1,16
1849,Magda IX,1912.0,40,6,34,80
1850,Norway,1948.0,7,7,17,31
1851,Norway,1908.0,7,32,3,42
1852,Norway,1936.0,8,20,18,46
1853,Norway,1924.0,18,12,9,39
1854,Norway,2008.0,16,5,1,22
1855,Norway,2012.0,15,1,1,17
1856,Norway,1972.0,4,10,11,25
1857,Norway,1972.0,4,10,11,25
1858,Heira II,1920.0,58,52,27,137
1859,Norway,2014.0,18,5,13,36
1860,Norway,1992.0,11,30,6,47
1861,Norway,1994.0,8,17,5,30
1862,Norway,1924.0,18,12,9,39
1863,Norway,1924.0,18,12,9,39
1864,Norway,1924.0,18,12,9,39
1865,Norway,1996.0,2,3,18,23
1866,Norway,1964.0,3,6,6,15
1867,Norway,2000.0,20,4,19,43
1868,Norway,1952.0,12,14,6,32
1869,Norway,1928.0,10,8,6,24
1870,Norway,1988.0,2,26,5,33
1871,Elisabeth X,1952.0,12,14,6,32
1872,Norway,1988.0,2,26,5,33
1873,Magda IX,1912.0,40,6,34,80
1874,Norway,1906.0,20,5,0,25
1875,Norway,1908.0,7,32,3,42
1876,Norway,1908.0,7,32,3,42
1877,Norway,1912.0,40,6,34,80
1878,Norway,1920.0,58,52,27,137
1879,Norway,1920.0,58,52,27,137
1880,Norway,1920.0,58,52,27,137
1881,Norway,1948.0,7,7,17,31
1882,Norway,1920.0,58,52,27,137
1883,Norway,1928.0,10,8,6,24
1884,Norway,1932.0,3,4,3,10
1885,Norway,1936.0,8,20,18,46
1886,Norway,1992.0,11,30,6,47
1887,Norway,1900.0,0,6,3,9
1888,Norway,2012.0,15,1,1,17
1889,Norway,2016.0,0,0,19,19
1890,Eleda,1920.0,58,52,27,137
1891,Ormsund Roklub-2,1912.0,40,6,34,80
1892,Norway,2002.0,23,11,7,41
1893,Norway,2006.0,2,9,12,23
1894,Norway,2010.0,16,14,9,39
1895,Norway,2000.0,20,4,19,43
1896,Norway,2002.0,23,11,7,41
1897,Norway,2010.0,16,14,9,39
1898,Norway,1936.0,8,20,18,46
1899,Norway,1936.0,8,20,18,46
1900,Norway,1988.0,2,26,5,33
1901,Norway,1992.0,11,30,6,47
1902,Norway,1906.0,20,5,0,25
1903,Norway,1908.0,7,32,3,42
1904,Norway,1912.0,40,6,34,80
1905,Norway,1920.0,58,52,27,137
1906,Irene,1920.0,58,52,27,137
1907,Norway,1906.0,20,5,0,25
1908,Norway,1992.0,11,30,6,47
1909,Norway,1992.0,11,30,6,47
1910,Norway,1996.0,2,3,18,23
1911,Norway,1996.0,2,3,18,23
1912,Norway,2000.0,20,4,19,43
1913,Norway,2000.0,20,4,19,43
1914,Norway,1936.0,8,20,18,46
1915,Norway,1936.0,8,20,18,46
1916,Ormsund Roklub-2,1912.0,40,6,34,80
1917,Eleda,1920.0,58,52,27,137
1918,Norway,2014.0,18,5,13,36
1919,Norway,1936.0,8,20,18,46
1920,Ormsund Roklub-2,1912.0,40,6,34,80
1921,Norway,1948.0,7,7,17,31
1922,Norway,2000.0,20,4,19,43
1923,Norway,1906.0,20,5,0,25
1924,Norway,1908.0,7,32,3,42
1925,Norway,1912.0,40,6,34,80
1926,Norway,1912.0,40,6,34,80
1927,Norway,2006.0,2,9,12,23
1928,Norway,1936.0,8,20,18,46
1929,Norway,1968.0,15,11,2,28
1930,Norway,1936.0,8,20,18,46
1931,Norway,1908.0,7,32,3,42
1932,Norway,2010.0,16,14,9,39
1933,Norway,1912.0,40,6,34,80
1934,Norway,1992.0,11,30,6,47
1935,Norway,1984.0,6,6,7,19
1936,Norway,1984.0,6,6,7,19
1937,Norway,1988.0,2,26,5,33
1938,Irene,1920.0,58,52,27,137
1939,Eleda,1920.0,58,52,27,137
1940,Eleda,1920.0,58,52,27,137
1941,Norway,2010.0,16,14,9,39
1942,Norway,2014.0,18,5,13,36
1943,Norway,2014.0,18,5,13,36
1944,Taifun,1912.0,40,6,34,80
1945,Norway,1980.0,1,5,9,15
1946,Norway,2000.0,20,4,19,43
1947,Norway,1912.0,40,6,34,80
1948,Norway,1972.0,4,10,11,25
1949,Norway,1912.0,40,6,34,80
1950,Norway,1906.0,20,5,0,25
1951,Norway,1908.0,7,32,3,42
1952,Norway,1998.0,13,15,12,40
1953,Norway,1998.0,13,15,12,40
1954,Norway,1956.0,3,1,3,7
1955,Norway,1960.0,5,6,0,11
1956,Norway,1960.0,5,6,0,11
1957,Norway,1964.0,3,6,6,15
1958,Norway,1964.0,3,6,6,15
1959,Norway,2000.0,20,4,19,43
1960,Norway,1920.0,58,52,27,137
1961,Norway,1908.0,7,32,3,42
1962,Norway,1952.0,12,14,6,32
1963,Norway,1928.0,10,8,6,24
1964,Norway,1936.0,8,20,18,46
1965,Norway,1968.0,15,11,2,28
1966,Norway,1972.0,4,10,11,25
1967,Norway,1920.0,58,52,27,137
1968,Norway,2008.0,16,5,1,22
1969,Norway,2012.0,15,1,1,17
1970,Norway,1920.0,58,52,27,137
1971,Norway,1920.0,58,52,27,137
1972,Norway,2010.0,16,14,9,39
1973,Norway,2014.0,18,5,13,36
1974,Norway,2014.0,18,5,13,36
1975,Norway,1912.0,40,6,34,80
1976,Norway,1988.0,2,26,5,33
1977,Norway,1988.0,2,26,5,33
1978,Norway,1988.0,2,26,5,33
1979,Norway,1964.0,3,6,6,15
1980,Norway,1968.0,15,11,2,28
1981,Norway,1912.0,40,6,34,80
1982,Norway,2000.0,20,4,19,43
1983,Eleda,1920.0,58,52,27,137
1984,Norway,1936.0,8,20,18,46
1985,Jo,1920.0,58,52,27,137
1986,Norway,1992.0,11,30,6,47
1987,Norway,1992.0,11,30,6,47
1988,Norway,1952.0,12,14,6,32
1989,Norway,1908.0,7,32,3,42
1990,Norway,1998.0,13,15,12,40
1991,Norway,1994.0,8,17,5,30
1992,Norway,1998.0,13,15,12,40
1993,Norway,1998.0,13,15,12,40
1994,Norway,2002.0,23,11,7,41
1995,Norway,2002.0,23,11,7,41
1996,Norway,1988.0,2,26,5,33
1997,Kristiania Roklub-1,1912.0,40,6,34,80
1998,Norway,1920.0,58,52,27,137
1999,Norway,2014.0,18,5,13,36
2000,Norway,1908.0,7,32,3,42
2001,Marmi II-1,1920.0,58,52,27,137
2002,Norway,1912.0,40,6,34,80
2003,Norway,1972.0,4,10,11,25
2004,Norway,2000.0,20,4,19,43
2005,Norway,1960.0,5,6,0,11
2006,Norway,1964.0,3,6,6,15
2007,Norway,1952.0,12,14,6,32
2008,Lully II,1936.0,8,20,18,46
2009,Magda IX,1912.0,40,6,34,80
2010,Sildra-1,1920.0,58,52,27,137
2011,Lully II,1936.0,8,20,18,46
2012,Norway,1976.0,5,10,1,16
2013,Norway,1992.0,11,30,6,47
2014,Norway,1992.0,11,30,6,47
2015,Norway,1994.0,8,17,5,30
2016,Norway,1994.0,8,17,5,30
2017,Norway,1994.0,8,17,5,30
2018,Norway,1948.0,7,7,17,31
2019,Norway,1948.0,7,7,17,31
2020,Norway,2000.0,20,4,19,43
2021,Norway,2016.0,0,0,19,19
2022,Norway,2012.0,15,1,1,17
2023,Norway,2014.0,18,5,13,36
2024,Sildra-1,1920.0,58,52,27,137
2025,Norway,1920.0,58,52,27,137
2026,Norway,1936.0,8,20,18,46
2027,Norway,2014.0,18,5,13,36
2028,Norway,2014.0,18,5,13,36
2029,Norway,1920.0,58,52,27,137
2030,Norway,2012.0,15,1,1,17
2031,Norway,2016.0,0,0,19,19
2032,Norway,1984.0,6,6,7,19
2033,Norway,1984.0,6,6,7,19
2034,Norway,1984.0,6,6,7,19
2035,Norway,1936.0,8,20,18,46
2036,Norway,1992.0,11,30,6,47
2037,Norway,1992.0,11,30,6,47
2038,Magda IX,1912.0,40,6,34,80
2039,Norway,1908.0,7,32,3,42
2040,Norway,2004.0,5,0,2,7
2041,Norway,2004.0,5,0,2,7
2042,Norway,2008.0,16,5,1,22
2043,Norway,2012.0,15,1,1,17
2044,Norway,1956.0,3,1,3,7
2045,Kristiania Roklub-1,1912.0,40,6,34,80
2046,Norway,1920.0,58,52,27,137
2047,Magda IX,1912.0,40,6,34,80
2048,Norway,1924.0,18,12,9,39
2049,Norway,1924.0,18,12,9,39
2050,Norway,1924.0,18,12,9,39
2051,Norway,1924.0,18,12,9,39
2052,Norway,1924.0,18,12,9,39
2053,Norway,1928.0,10,8,6,24
2054,Norway,1908.0,7,32,3,42
2055,Norway,2000.0,20,4,19,43
2056,Norway,2008.0,16,5,1,22
2057,Norway,1952.0,12,14,6,32
2058,Norway,1984.0,6,6,7,19
2059,Norway,1908.0,7,32,3,42
2060,Norway,2000.0,20,4,19,43
2061,Norway,2000.0,20,4,19,43
2062,Norway,1908.0,7,32,3,42
2063,Norway,1948.0,7,7,17,31
2064,Norway,1948.0,7,7,17,31
2065,Norway,1908.0,7,32,3,42
2066,Norway,1912.0,40,6,34,80
2067,Norway,1920.0,58,52,27,137
2068,Norway,1920.0,58,52,27,137
2069,Norway,1920.0,58,52,27,137
2070,Norway,1924.0,18,12,9,39
2071,Norway,1924.0,18,12,9,39
2072,Norway,1994.0,8,17,5,30
2073,Norway,1912.0,40,6,34,80
2074,Norway,1912.0,40,6,34,80
2075,Pan,1948.0,7,7,17,31
2076,Pan,1952.0,12,14,6,32
2077,Norway,1920.0,58,52,27,137
2078,Norway,1920.0,58,52,27,137
2079,Norway,1920.0,58,52,27,137
2080,Norway,1924.0,18,12,9,39
2081,Norway,1924.0,18,12,9,39
2082,Norway,1924.0,18,12,9,39
2083,Norway,1984.0,6,6,7,19
2084,Norway,2006.0,2,9,12,23
2085,Norway,2006.0,2,9,12,23
2086,Norway,2012.0,15,1,1,17
2087,Norway,2016.0,0,0,19,19
2088,Norway,1984.0,6,6,7,19
2089,Norway,1920.0,58,52,27,137
2090,Norway,1912.0,40,6,34,80
2091,Norway,1992.0,11,30,6,47
2092,Norway,1994.0,8,17,5,30
2093,Norway,1994.0,8,17,5,30
2094,Norway,1998.0,13,15,12,40
2095,Norway,1948.0,7,7,17,31
2096,Norway,1948.0,7,7,17,31
2097,Elisabeth V,1924.0,18,12,9,39
2098,Encore,1952.0,12,14,6,32
2099,Sirene,1960.0,5,6,0,11
2100,Norway,1968.0,15,11,2,28
2101,Encore,1952.0,12,14,6,32
2102,Norway,2008.0,16,5,1,22
2103,Norway,2012.0,15,1,1,17
2104,Norway,2016.0,0,0,19,19
2105,Elisabeth V,1924.0,18,12,9,39
2106,Norway,1964.0,3,6,6,15
2107,Norway,1964.0,3,6,6,15
2108,Norway,1968.0,15,11,2,28
2109,Norway,1968.0,15,11,2,28
2110,Sildra-1,1920.0,58,52,27,137
2111,Norway,1936.0,8,20,18,46
2112,Norway,1968.0,15,11,2,28
2113,Norway,1968.0,15,11,2,28
2114,Norway,1976.0,5,10,1,16
2115,Norway,1912.0,40,6,34,80
2116,Norway,1936.0,8,20,18,46
2117,Norway,1948.0,7,7,17,31
2118,Norway,1912.0,40,6,34,80
2119,Norway,1996.0,2,3,18,23
2120,Norway,2000.0,20,4,19,43
2121,Lully II,1936.0,8,20,18,46
2122,Norway,1920.0,58,52,27,137
2123,Norway,1988.0,2,26,5,33
2124,Norway,1988.0,2,26,5,33
2125,Norway,2006.0,2,9,12,23
2126,Norway,2006.0,2,9,12,23
2127,Norway,2014.0,18,5,13,36
2128,Norway,2014.0,18,5,13,36
2129,Norway,1996.0,2,3,18,23
2130,Norway,1964.0,3,6,6,15
2131,Norway,1908.0,7,32,3,42
2132,Norway,1924.0,18,12,9,39
2133,Norway,1994.0,8,17,5,30
2134,Norway,1998.0,13,15,12,40
2135,Norway,1998.0,13,15,12,40
2136,Norway,2002.0,23,11,7,41
2137,Norway,2002.0,23,11,7,41
2138,Norway,2016.0,0,0,19,19
2139,Norway,1936.0,8,20,18,46
2140,Norway,1948.0,7,7,17,31
2141,Norway,1948.0,7,7,17,31
2142,Norway,1920.0,58,52,27,137
2143,Elisabeth X,1952.0,12,14,6,32
2144,Atlanta,1920.0,58,52,27,137
2145,Norway,1906.0,20,5,0,25
2146,Norway,1968.0,15,11,2,28
2147,Norway,1968.0,15,11,2,28
2148,Norway,1972.0,4,10,11,25
2149,Norway,2016.0,0,0,19,19
2150,Norway,1906.0,20,5,0,25
2151,Norway,1996.0,2,3,18,23
2152,Norway,1972.0,4,10,11,25
2153,Norway,1980.0,1,5,9,15
2154,Norway,1976.0,5,10,1,16
2155,Norway,1920.0,58,52,27,137
2156,Norway,1920.0,58,52,27,137
2157,Norway,1920.0,58,52,27,137
2158,Norway,1920.0,58,52,27,137
2159,Norway,1920.0,58,52,27,137
2160,Norway,1924.0,18,12,9,39
2161,Norway,1924.0,18,12,9,39
2162,Norway,1948.0,7,7,17,31
2163,Norway,2002.0,23,11,7,41
2164,Norway,2010.0,16,14,9,39
2165,Eleda,1920.0,58,52,27,137
2166,Bera,1924.0,18,12,9,39
2167,Fornebo,1920.0,58,52,27,137
2168,Norway,1920.0,58,52,27,137
2169,Norway,1992.0,11,30,6,47
2170,Norway,1994.0,8,17,5,30
2171,Norway,1998.0,13,15,12,40
2172,Norway,1936.0,8,20,18,46
2173,Norway,1994.0,8,17,5,30
2174,Norway,1920.0,58,52,27,137
2175,Norway,2000.0,20,4,19,43
2176,Norway,1936.0,8,20,18,46
2177,Norway,1996.0,2,3,18,23
2178,Norway,2000.0,20,4,19,43
2179,Norway,2008.0,16,5,1,22
2180,Norway,1920.0,58,52,27,137
2181,Norway,1920.0,58,52,27,137
2182,Norway,2010.0,16,14,9,39
2183,Norway,2010.0,16,14,9,39
2184,Norway,2010.0,16,14,9,39
2185,Norway,2010.0,16,14,9,39
2186,Norway,2008.0,16,5,1,22
2187,Norway,2012.0,15,1,1,17
2188,Norway,2008.0,16,5,1,22
2189,Norway,1948.0,7,7,17,31
2190,Norway,1984.0,6,6,7,19
2191,Norway,1992.0,11,30,6,47
2192,Norway,1994.0,8,17,5,30
2193,Lully II,1936.0,8,20,18,46
2194,Norway,1928.0,10,8,6,24
2195,Norway,2008.0,16,5,1,22
2196,Norway,2016.0,0,0,19,19
2197,Norway,1948.0,7,7,17,31
2198,Norna,1928.0,10,8,6,24
2199,Norway,1920.0,58,52,27,137
2200,Norway,1920.0,58,52,27,137
2201,Norway,1906.0,20,5,0,25
2202,Norway,1908.0,7,32,3,42
2203,Norway,1912.0,40,6,34,80
2204,Irene,1920.0,58,52,27,137
2205,Norway,1924.0,18,12,9,39
2206,Norway,1920.0,58,52,27,137
2207,Norway,1920.0,58,52,27,137
2208,Norway,1920.0,58,52,27,137
2209,Norway,1920.0,58,52,27,137
2210,Norway,1920.0,58,52,27,137
2211,Norway,1924.0,18,12,9,39
2212,Norway,1924.0,18,12,9,39
2213,Norway,1924.0,18,12,9,39
2214,Ormsund Roklub-2,1912.0,40,6,34,80
2215,Norway,1912.0,40,6,34,80
2216,Norway,1920.0,58,52,27,137
2217,Norway,1912.0,40,6,34,80
2218,Norway,1920.0,58,52,27,137
2219,Norway,1912.0,40,6,34,80
2220,Norway,1928.0,10,8,6,24
2221,Heira II,1920.0,58,52,27,137
2222,Heira II,1920.0,58,52,27,137
2223,Heira II,1920.0,58,52,27,137
2224,Norway,2014.0,18,5,13,36
2225,Norway,2014.0,18,5,13,36
2226,Norway,1960.0,5,6,0,11
2227,Norway,1948.0,7,7,17,31
2228,Norway,1912.0,40,6,34,80
2229,Norway,1920.0,58,52,27,137
2230,Norway,1920.0,58,52,27,137
2231,Norway,1920.0,58,52,27,137
2232,Norway,1920.0,58,52,27,137
2233,Atlanta,1920.0,58,52,27,137
2234,Atlanta,1920.0,58,52,27,137
2235,Atlanta,1920.0,58,52,27,137
2236,Atlanta,1920.0,58,52,27,137
2237,Norway,1900.0,0,6,3,9
2238,Norway,1900.0,0,6,3,9
2239,Norway,1900.0,0,6,3,9
2240,Norway,1900.0,0,6,3,9
2241,Norway,1994.0,8,17,5,30
2242,Norway,1980.0,1,5,9,15
2243,Norway,1980.0,1,5,9,15
2244,Norway,1912.0,40,6,34,80
2245,Norway,1948.0,7,7,17,31
2246,Norway,1906.0,20,5,0,25
2247,Norway,1908.0,7,32,3,42
2248,Norway,1912.0,40,6,34,80
2249,Norway,2002.0,23,11,7,41
2250,Norway,2006.0,2,9,12,23
2251,Norway,1908.0,7,32,3,42
2252,Norway,1912.0,40,6,34,80
2253,Norway,1992.0,11,30,6,47
2254,Norway,1948.0,7,7,17,31
2255,Stella-2,1920.0,58,52,27,137
2256,Norway,1906.0,20,5,0,25
2257,Norway,1906.0,20,5,0,25
2258,Norway,2010.0,16,14,9,39
2259,Norway,1912.0,40,6,34,80
2260,Norway,1980.0,1,5,9,15
2261,Norway,1984.0,6,6,7,19
2262,Norway,1984.0,6,6,7,19
2263,Norway,1988.0,2,26,5,33
2264,Norway,1992.0,11,30,6,47
2265,Norway,1996.0,2,3,18,23
2266,Norway,2000.0,20,4,19,43
2267,Norway,2010.0,16,14,9,39
2268,Norway,2012.0,15,1,1,17
2269,Norway,1988.0,2,26,5,33
2270,Norway,1928.0,10,8,6,24
2271,Norway,2002.0,23,11,7,41
2272,Norway,1998.0,13,15,12,40
2273,Norway,2000.0,20,4,19,43
2274,Heira II,1920.0,58,52,27,137
2275,Norway,2008.0,16,5,1,22
2276,Norway,2012.0,15,1,1,17
2277,Norway,2016.0,0,0,19,19
2278,Norway,1996.0,2,3,18,23
2279,Norway,2000.0,20,4,19,43
2280,Bera,1924.0,18,12,9,39
2281,Irene,1920.0,58,52,27,137
2282,Bera,1924.0,18,12,9,39
2283,Norway,1912.0,40,6,34,80
2284,Norway,1924.0,18,12,9,39
2285,Norway,1928.0,10,8,6,24
2286,Norway,1996.0,2,3,18,23
2287,Norway,2000.0,20,4,19,43
2288,Norway,2006.0,2,9,12,23
2289,Jo,1920.0,58,52,27,137
2290,Norway,1936.0,8,20,18,46
2291,Norway,1948.0,7,7,17,31
2292,Norway,1906.0,20,5,0,25
2293,Norway,1980.0,1,5,9,15
2294,Norway,1988.0,2,26,5,33
2295,Norway,1992.0,11,30,6,47
2296,Norway,1932.0,3,4,3,10
2297,Norway,1932.0,3,4,3,10
2298,Norway,1936.0,8,20,18,46
2299,Norway,1948.0,7,7,17,31
2300,Norway,1928.0,10,8,6,24
2301,Norway,1920.0,58,52,27,137
2302,Norway,1976.0,5,10,1,16
2303,Norway,1992.0,11,30,6,47
2304,Lyn-2,1920.0,58,52,27,137
2305,Norway,1996.0,2,3,18,23
2306,Norway,2000.0,20,4,19,43
2307,Norway,2014.0,18,5,13,36
2308,Norway,1984.0,6,6,7,19
2309,Norway,2000.0,20,4,19,43
2310,Norway,1912.0,40,6,34,80
2311,Norway,1920.0,58,52,27,137
2312,Norway,1908.0,7,32,3,42
2313,Norway,1912.0,40,6,34,80
2314,Norway,1992.0,11,30,6,47
2315,Norway,1900.0,0,6,3,9
2316,Norway,1908.0,7,32,3,42
2317,Norway,1908.0,7,32,3,42
2318,Norway,1912.0,40,6,34,80
2319,Norway,2002.0,23,11,7,41
2320,Norway,2000.0,20,4,19,43
2321,Lyn-2,1920.0,58,52,27,137
2322,Norway,1912.0,40,6,34,80
2323,Norway,1948.0,7,7,17,31
2324,Mosk II,1920.0,58,52,27,137
2325,Mosk II,1920.0,58,52,27,137
2326,Lyn-2,1920.0,58,52,27,137
2327,Silja,1936.0,8,20,18,46
2328,Norway,1900.0,0,6,3,9
2329,Mosk II,1920.0,58,52,27,137
2330,Norway,1912.0,40,6,34,80
2331,Norway,1998.0,13,15,12,40
2332,Norway,1920.0,58,52,27,137
2333,Norway,1988.0,2,26,5,33
2334,Norway,1908.0,7,32,3,42
2335,Norway,1912.0,40,6,34,80
2336,Norway,1994.0,8,17,5,30
2337,Norway,1994.0,8,17,5,30
2338,Norway,1998.0,13,15,12,40
2339,Norway,1912.0,40,6,34,80
2340,Norway,1948.0,7,7,17,31
2341,Norway,1998.0,13,15,12,40
2342,Norway,1998.0,13,15,12,40
2343,Norway,1998.0,13,15,12,40
2344,Norway,2002.0,23,11,7,41
2345,Norway,2002.0,23,11,7,41
2346,Norway,2002.0,23,11,7,41
2347,Norway,1906.0,20,5,0,25
2348,Norway,1908.0,7,32,3,42
2349,Norway,1912.0,40,6,34,80
2350,Norway,1920.0,58,52,27,137
2351,Norway,1998.0,13,15,12,40
2352,Norway,2002.0,23,11,7,41
2353,Norway,1998.0,13,15,12,40
2354,Norway,2002.0,23,11,7,41
2355,Norway,2002.0,23,11,7,41
2356,Norway,1992.0,11,30,6,47
2357,Norway,2002.0,23,11,7,41
2358,Norway,2002.0,23,11,7,41
2359,Norway,1920.0,58,52,27,137
2360,Norway,2010.0,16,14,9,39
2361,Norway,1912.0,40,6,34,80
2362,Norway,1988.0,2,26,5,33
2363,Norway,1992.0,11,30,6,47
2364,Norway,1908.0,7,32,3,42
2365,Norway,1952.0,12,14,6,32
2366,Norway,1920.0,58,52,27,137
2367,Norway,1920.0,58,52,27,137
2368,Norway,1920.0,58,52,27,137
2369,Norway,1912.0,40,6,34,80
2370,Norway,1908.0,7,32,3,42
2371,Norway,1928.0,10,8,6,24
2372,Norway,2008.0,16,5,1,22
2373,Norway,2012.0,15,1,1,17
2374,Norway,1968.0,15,11,2,28
2375,Norway,1968.0,15,11,2,28
2376,Norway,1972.0,4,10,11,25
2377,Norway,2016.0,0,0,19,19
2378,Norway,1996.0,2,3,18,23
2379,Norway,2000.0,20,4,19,43
2380,Norway,2008.0,16,5,1,22
2381,Norway,1984.0,6,6,7,19
2382,Norway,1968.0,15,11,2,28
2383,Norway,1972.0,4,10,11,25
2384,Norway,1992.0,11,30,6,47
2385,Norway,1998.0,13,15,12,40
2386,Norway,2002.0,23,11,7,41
2387,Eleda,1920.0,58,52,27,137
2388,Norway,2000.0,20,4,19,43
2389,Norway,2008.0,16,5,1,22
2390,Norway,1920.0,58,52,27,137
2391,Norway,1924.0,18,12,9,39
2392,Magda IX,1912.0,40,6,34,80
2393,Norway,1988.0,2,26,5,33
2394,Norway,1992.0,11,30,6,47
2395,Norway,1920.0,58,52,27,137
2396,Norway,2010.0,16,14,9,39
2397,Norway,2014.0,18,5,13,36
2398,Norway,1932.0,3,4,3,10
2399,Norway,1952.0,12,14,6,32
2400,Norway,1956.0,3,1,3,7
2401,Norway,1972.0,4,10,11,25
2402,Norway,1972.0,4,10,11,25
2403,Norway,1976.0,5,10,1,16
2404,Norway,1976.0,5,10,1,16
2405,Norway,1980.0,1,5,9,15
2406,Norway,1980.0,1,5,9,15
2407,Norway,1992.0,11,30,6,47
2408,Norway,2000.0,20,4,19,43
2409,Norway,1920.0,58,52,27,137
2410,Atlanta,1920.0,58,52,27,137
2411,Norway,2000.0,20,4,19,43
2412,Norway,1952.0,12,14,6,32
2413,Norway,1994.0,8,17,5,30
2414,Norway,1994.0,8,17,5,30
2415,Norway,1976.0,5,10,1,16
2416,Norway,1984.0,6,6,7,19
2417,Norway,1908.0,7,32,3,42
2418,Norway,2016.0,0,0,19,19
2419,Silja,1936.0,8,20,18,46
2420,Norway,1912.0,40,6,34,80
2421,Norway,1924.0,18,12,9,39
2422,Norway,1924.0,18,12,9,39
2423,Norway,1906.0,20,5,0,25
2424,Norway,1996.0,2,3,18,23
2425,Norway,1996.0,2,3,18,23
2426,Norway,2012.0,15,1,1,17
2427,Norway,1988.0,2,26,5,33
2428,Norway,1992.0,11,30,6,47
2429,Norway,1920.0,58,52,27,137
2430,Norway,2010.0,16,14,9,39
2431,Norway,2014.0,18,5,13,36
2432,Norway,2004.0,5,0,2,7
2433,Norway,1928.0,10,8,6,24
2434,Norway,2010.0,16,14,9,39
2435,Norway,2006.0,2,9,12,23
2436,Norway,1988.0,2,26,5,33
2437,Norway,1992.0,11,30,6,47
2438,Norway,2010.0,16,14,9,39
2439,Norway,2010.0,16,14,9,39
2440,Norway,2010.0,16,14,9,39
2441,Norway,2014.0,18,5,13,36
2442,Norway,2014.0,18,5,13,36
2443,Norway,1996.0,2,3,18,23
2444,Norway,2010.0,16,14,9,39
2445,Norway,2010.0,16,14,9,39
2446,Norway,2010.0,16,14,9,39
2447,Norway,1908.0,7,32,3,42
2448,Norway,1996.0,2,3,18,23
2449,Norway,1924.0,18,12,9,39
2450,Silja,1936.0,8,20,18,46
2451,Magda IX,1912.0,40,6,34,80
2452,Lyn-2,1920.0,58,52,27,137
2453,Norway,1968.0,15,11,2,28
2454,Norway,1998.0,13,15,12,40
2455,Norway,2004.0,5,0,2,7
2456,Norway,2008.0,16,5,1,22
2457,Norway,1992.0,11,30,6,47
2458,Norway,1988.0,2,26,5,33
2459,Norway,1992.0,11,30,6,47
2460,Norway,1912.0,40,6,34,80
2461,Norway,1908.0,7,32,3,42
2462,Norway,1912.0,40,6,34,80
2463,Pan,1948.0,7,7,17,31
2464,Pan,1952.0,12,14,6,32
2465,Norway,1972.0,4,10,11,25
2466,Norway,1936.0,8,20,18,46
2467,Norway,1992.0,11,30,6,47
2468,Norway,2000.0,20,4,19,43
2469,Norway,2002.0,23,11,7,41
2470,Norway,1920.0,58,52,27,137
2471,Marmi II-1,1920.0,58,52,27,137
2472,Norway,1912.0,40,6,34,80
2473,Kristiania Roklub-1,1912.0,40,6,34,80
2474,Norway,1998.0,13,15,12,40
2475,Norway,2000.0,20,4,19,43
2476,Kristiania Roklub-1,1912.0,40,6,34,80
2477,Kristiania Roklub-1,1912.0,40,6,34,80
2478,Norway,1920.0,58,52,27,137
2479,Norway,1998.0,13,15,12,40
2480,Norway,2002.0,23,11,7,41
2481,Norway,2006.0,2,9,12,23
2482,Norway,2002.0,23,11,7,41
2483,Lyn-2,1920.0,58,52,27,137
2484,Norway,2000.0,20,4,19,43
2485,Norway,2004.0,5,0,2,7
2486,Norway,2008.0,16,5,1,22
2487,Norway,2016.0,0,0,19,19
2488,Lully II,1936.0,8,20,18,46
2489,Norway,1976.0,5,10,1,16
2490,Norway,1968.0,15,11,2,28
2491,Norway,1972.0,4,10,11,25
2492,Norway,1972.0,4,10,11,25
2493,Norway,1972.0,4,10,11,25
2494,Norway,1976.0,5,10,1,16
2495,Norway,2000.0,20,4,19,43
2496,Norway,2008.0,16,5,1,22
2497,Norway,1936.0,8,20,18,46
2498,Norway,2010.0,16,14,9,39
2499,Norway,1988.0,2,26,5,33
2500,Norway,1992.0,11,30,6,47
2501,Norway,1992.0,11,30,6,47
2502,Norway,1992.0,11,30,6,47
2503,Norway,1992.0,11,30,6,47
2504,Norway,1994.0,8,17,5,30
2505,Norway,1992.0,11,30,6,47
2506,Norway,1996.0,2,3,18,23
2507,Norway,2002.0,23,11,7,41
2508,Norway,1920.0,58,52,27,137
2509,Norway,1994.0,8,17,5,30
2510,Norway,1994.0,8,17,5,30
2511,Norway,1998.0,13,15,12,40
2512,Norway,1998.0,13,15,12,40
2513,Sildra-1,1920.0,58,52,27,137
2514,Norway,1928.0,10,8,6,24
2515,Norway,1932.0,3,4,3,10
2516,Norway,1988.0,2,26,5,33
2517,Norway,1924.0,18,12,9,39
2518,Norway,1912.0,40,6,34,80
2519,Irene,1920.0,58,52,27,137
2520,Norway,1932.0,3,4,3,10
2521,Silja,1936.0,8,20,18,46
2522,Norway,1968.0,15,11,2,28
2523,Norway,2014.0,18,5,13,36
2524,Heira II,1920.0,58,52,27,137
2525,Norway,1920.0,58,52,27,137
2526,Norway,1968.0,15,11,2,28
2527,Norway,1988.0,2,26,5,33
2528,Norway,1994.0,8,17,5,30
2529,Norway,1998.0,13,15,12,40
2530,Netherlands,1988.0,6,8,38,52
2531,Netherlands,1996.0,38,9,26,73
2532,Netherlands,2012.0,21,29,19,69
2533,Netherlands,2016.0,9,25,13,47
2534,Netherlands,2008.0,39,18,4,61
2535,Netherlands,2012.0,21,29,19,69
2536,Netherlands,1928.0,20,29,8,57
2537,Netherlands,1952.0,0,21,0,21
2538,Netherlands,1928.0,20,29,8,57
2539,Netherlands,2000.0,27,29,23,79
2540,Netherlands,2012.0,21,29,19,69
2541,Netherlands,1968.0,9,10,4,23
2542,Netherlands,1968.0,9,10,4,23
2543,Netherlands,1972.0,7,4,4,15
2544,Netherlands,1972.0,7,4,4,15
2545,Netherlands,2012.0,21,29,19,69
2546,Netherlands,2012.0,21,29,19,69
2547,Netherlands,1928.0,20,29,8,57
2548,Netherlands,1992.0,6,21,10,37
2549,Netherlands,1996.0,38,9,26,73
2550,Netherlands,1996.0,38,9,26,73
2551,Netherlands,2000.0,27,29,23,79
2552,Netherlands,2004.0,4,51,22,77
2553,Netherlands,1908.0,0,0,16,16
2554,Netherlands,1924.0,8,1,18,27
2555,Netherlands,1920.0,15,10,25,50
2556,Netherlands,2012.0,21,29,19,69
2557,Netherlands,1992.0,6,21,10,37
2558,Netherlands,1984.0,20,7,14,41
2559,Netherlands,1988.0,6,8,38,52
2560,Netherlands,1988.0,6,8,38,52
2561,Netherlands,2014.0,13,7,9,29
2562,Netherlands,2014.0,13,7,9,29
2563,Netherlands,2008.0,39,18,4,61
2564,Netherlands,2012.0,21,29,19,69
2565,Netherlands,2008.0,39,18,4,61
2566,Netherlands,2016.0,9,25,13,47
2567,Boreas-2,1920.0,15,10,25,50
2568,Netherlands,1964.0,6,11,16,33
2569,Netherlands,1920.0,15,10,25,50
2570,Netherlands,1964.0,6,11,16,33
2571,Netherlands,1964.0,6,11,16,33
2572,Netherlands,1992.0,6,21,10,37
2573,Netherlands,1996.0,38,9,26,73
2574,Netherlands,1948.0,8,2,32,42
2575,Netherlands,1948.0,8,2,32,42
2576,Netherlands,1948.0,8,2,32,42
2577,Netherlands,1948.0,8,2,32,42
2578,Netherlands,2010.0,4,1,6,11
2579,Netherlands,2014.0,13,7,9,29
2580,Netherlands,2014.0,13,7,9,29
2581,Netherlands,1984.0,20,7,14,41
2582,Netherlands,2014.0,13,7,9,29
2583,Netherlands,2014.0,13,7,9,29
2584,Netherlands,1948.0,8,2,32,42
2585,Netherlands,1952.0,0,21,0,21
2586,Netherlands,1900.0,3,8,16,27
2587,Netherlands,1984.0,20,7,14,41
2588,Netherlands,1988.0,6,8,38,52
2589,Netherlands,1992.0,6,21,10,37
2590,Netherlands,2000.0,27,29,23,79
2591,Netherlands,2000.0,27,29,23,79
2592,Netherlands,2000.0,27,29,23,79
2593,Netherlands,2004.0,4,51,22,77
2594,Netherlands,2008.0,39,18,4,61
2595,Netherlands,2000.0,27,29,23,79
2596,Netherlands,2004.0,4,51,22,77
2597,Netherlands,1924.0,8,1,18,27
2598,Netherlands,1980.0,1,3,6,10
2599,Netherlands,1998.0,5,4,2,11
2600,Netherlands,2002.0,3,5,0,8
2601,Netherlands,1964.0,6,11,16,33
2602,Netherlands,2004.0,4,51,22,77
2603,Netherlands,2016.0,9,25,13,47
2604,Netherlands,2008.0,39,18,4,61
2605,Netherlands,2004.0,4,51,22,77
2606,Netherlands,2008.0,39,18,4,61
2607,Netherlands,2012.0,21,29,19,69
2608,Netherlands,1924.0,8,1,18,27
2609,Netherlands,1928.0,20,29,8,57
2610,Netherlands,1928.0,20,29,8,57
2611,Netherlands,1920.0,15,10,25,50
2612,Netherlands,1992.0,6,21,10,37
2613,Netherlands,1924.0,8,1,18,27
2614,Netherlands,1912.0,0,0,26,26
2615,Netherlands,1912.0,0,0,26,26
2616,Netherlands,1912.0,0,0,26,26
2617,Netherlands,2012.0,21,29,19,69
2618,Netherlands,2016.0,9,25,13,47
2619,Netherlands,1900.0,3,8,16,27
2620,Netherlands,1948.0,8,2,32,42
2621,Netherlands,2012.0,21,29,19,69
2622,Netherlands,2016.0,9,25,13,47
2623,Netherlands,1988.0,6,8,38,52
2624,Netherlands,1996.0,38,9,26,73
2625,Netherlands,1948.0,8,2,32,42
2626,Netherlands,1928.0,20,29,8,57
2627,Minerva Amsterdam,1900.0,3,8,16,27
2628,Minerva Amsterdam,1900.0,3,8,16,27
2629,Netherlands,1928.0,20,29,8,57
2630,Netherlands,1996.0,38,9,26,73
2631,Netherlands,2004.0,4,51,22,77
2632,Netherlands,1988.0,6,8,38,52
2633,Netherlands,1976.0,1,4,15,20
2634,Netherlands,1976.0,1,4,15,20
2635,Netherlands,1988.0,6,8,38,52
2636,Netherlands,1996.0,38,9,26,73
2637,Netherlands,2000.0,27,29,23,79
2638,Minerva Amsterdam,1900.0,3,8,16,27
2639,Minerva Amsterdam,1900.0,3,8,16,27
2640,Minerva Amsterdam,1900.0,3,8,16,27
2641,Netherlands,1952.0,0,21,0,21
2642,Netherlands,1952.0,0,21,0,21
2643,Netherlands,1948.0,8,2,32,42
2644,Netherlands,1924.0,8,1,18,27
2645,Netherlands-1,2016.0,9,25,13,47
2646,Netherlands,2004.0,4,51,22,77
2647,Netherlands,1952.0,0,21,0,21
2648,Netherlands,2004.0,4,51,22,77
2649,Netherlands,2016.0,9,25,13,47
2650,Netherlands,1920.0,15,10,25,50
2651,Netherlands,1920.0,15,10,25,50
2652,Netherlands,2000.0,27,29,23,79
2653,Amstel Amsterdam,1908.0,0,0,16,16
2654,Netherlands,1988.0,6,8,38,52
2655,Netherlands,1976.0,1,4,15,20
2656,Netherlands,2008.0,39,18,4,61
2657,Oranje,1920.0,15,10,25,50
2658,Oranje,1920.0,15,10,25,50
2659,Willem-Six,1924.0,8,1,18,27
2660,Netherlands,1948.0,8,2,32,42
2661,Netherlands,2004.0,4,51,22,77
2662,Netherlands,1924.0,8,1,18,27
2663,Netherlands,1964.0,6,11,16,33
2664,Netherlands,2012.0,21,29,19,69
2665,Netherlands,2012.0,21,29,19,69
2666,Netherlands,1984.0,20,7,14,41
2667,Netherlands,1988.0,6,8,38,52
2668,Amstel Amsterdam,1908.0,0,0,16,16
2669,Netherlands,1988.0,6,8,38,52
2670,Netherlands,1996.0,38,9,26,73
2671,Netherlands,1984.0,20,7,14,41
2672,Netherlands,1988.0,6,8,38,52
2673,Netherlands,2012.0,21,29,19,69
2674,Netherlands,1980.0,1,3,6,10
2675,Netherlands,1920.0,15,10,25,50
2676,Netherlands,2004.0,4,51,22,77
2677,Netherlands,2008.0,39,18,4,61
2678,Netherlands,2000.0,27,29,23,79
2679,Netherlands,2000.0,27,29,23,79
2680,Netherlands,2000.0,27,29,23,79
2681,Netherlands,2000.0,27,29,23,79
2682,Netherlands,2004.0,4,51,22,77
2683,Netherlands,2004.0,4,51,22,77
2684,Netherlands,2004.0,4,51,22,77
2685,Netherlands,2004.0,4,51,22,77
2686,Netherlands,1908.0,0,0,16,16
2687,Netherlands,1936.0,9,7,21,37
2688,Netherlands,2008.0,39,18,4,61
2689,Netherlands,2012.0,21,29,19,69
2690,Netherlands,2016.0,9,25,13,47
2691,Netherlands,1912.0,0,0,26,26
2692,Netherlands,2012.0,21,29,19,69
2693,Netherlands,2004.0,4,51,22,77
2694,Netherlands,2008.0,39,18,4,61
2695,Netherlands,2012.0,21,29,19,69
2696,Netherlands,1996.0,38,9,26,73
2697,Netherlands,1912.0,0,0,26,26
2698,Netherlands,1912.0,0,0,26,26
2699,Netherlands,1912.0,0,0,26,26
2700,Netherlands,1920.0,15,10,25,50
2701,Netherlands,1920.0,15,10,25,50
2702,Netherlands,1924.0,8,1,18,27
2703,Netherlands,1998.0,5,4,2,11
2704,Netherlands,2006.0,3,2,8,13
2705,Netherlands,2010.0,4,1,6,11
2706,Netherlands,2014.0,13,7,9,29
2707,Netherlands,1948.0,8,2,32,42
2708,Netherlands,1980.0,1,3,6,10
2709,Netherlands,1992.0,6,21,10,37
2710,Netherlands,1908.0,0,0,16,16
2711,Netherlands,1912.0,0,0,26,26
2712,Netherlands,1924.0,8,1,18,27
2713,Netherlands,1928.0,20,29,8,57
2714,Netherlands,1928.0,20,29,8,57
2715,Netherlands,1976.0,1,4,15,20
2716,Netherlands,1928.0,20,29,8,57
2717,Netherlands,1936.0,9,7,21,37
2718,Netherlands,1936.0,9,7,21,37
2719,Netherlands,1920.0,15,10,25,50
2720,Netherlands,1996.0,38,9,26,73
2721,Netherlands,2000.0,27,29,23,79
2722,Netherlands,2004.0,4,51,22,77
2723,Netherlands,2012.0,21,29,19,69
2724,Netherlands,2004.0,4,51,22,77
2725,Netherlands,2008.0,39,18,4,61
2726,Netherlands,1936.0,9,7,21,37
2727,Netherlands,1984.0,20,7,14,41
2728,Netherlands,1984.0,20,7,14,41
2729,Netherlands,1996.0,38,9,26,73
2730,Netherlands,2012.0,21,29,19,69
2731,Netherlands,1920.0,15,10,25,50
2732,Netherlands,1992.0,6,21,10,37
2733,Netherlands,1924.0,8,1,18,27
2734,Bem II,1936.0,9,7,21,37
2735,Netherlands,1928.0,20,29,8,57
2736,Netherlands,1936.0,9,7,21,37
2737,Netherlands,2016.0,9,25,13,47
2738,Netherlands,2012.0,21,29,19,69
2739,Hollandia,1928.0,20,29,8,57
2740,Netherlands,1912.0,0,0,26,26
2741,Netherlands,1976.0,1,4,15,20
2742,Netherlands,2000.0,27,29,23,79
2743,Netherlands,1992.0,6,21,10,37
2744,Netherlands,2008.0,39,18,4,61
2745,Netherlands,2004.0,4,51,22,77
2746,Netherlands,2008.0,39,18,4,61
2747,Netherlands,2012.0,21,29,19,69
2748,Netherlands,2004.0,4,51,22,77
2749,Netherlands,1920.0,15,10,25,50
2750,Netherlands,1992.0,6,21,10,37
2751,Netherlands,1988.0,6,8,38,52
2752,Netherlands,1996.0,38,9,26,73
2753,Netherlands,1996.0,38,9,26,73
2754,Netherlands,2000.0,27,29,23,79
2755,Netherlands,2004.0,4,51,22,77
2756,Netherlands,1968.0,9,10,4,23
2757,Netherlands,1932.0,2,10,1,13
2758,Netherlands,1932.0,2,10,1,13
2759,Netherlands,1936.0,9,7,21,37
2760,Netherlands,1920.0,15,10,25,50
2761,Netherlands,1984.0,20,7,14,41
2762,Netherlands,1988.0,6,8,38,52
2763,Netherlands,1948.0,8,2,32,42
2764,Netherlands,1952.0,0,21,0,21
2765,Netherlands,2004.0,4,51,22,77
2766,Netherlands,2004.0,4,51,22,77
2767,Netherlands,2004.0,4,51,22,77
2768,Netherlands,1988.0,6,8,38,52
2769,Netherlands,1960.0,0,2,3,5
2770,Netherlands,1964.0,6,11,16,33
2771,Netherlands,2008.0,39,18,4,61
2772,Netherlands,2012.0,21,29,19,69
2773,Netherlands,2016.0,9,25,13,47
2774,Hollandia,1928.0,20,29,8,57
2775,Netherlands,1964.0,6,11,16,33
2776,Netherlands,1996.0,38,9,26,73
2777,Netherlands,2000.0,27,29,23,79
2778,Netherlands,2004.0,4,51,22,77
2779,Netherlands,1912.0,0,0,26,26
2780,Netherlands,1912.0,0,0,26,26
2781,Netherlands,1920.0,15,10,25,50
2782,Netherlands,1924.0,8,1,18,27
2783,Netherlands,1948.0,8,2,32,42
2784,Netherlands,1952.0,0,21,0,21
2785,Netherlands,1968.0,9,10,4,23
2786,Netherlands,1900.0,3,8,16,27
2787,Netherlands,2000.0,27,29,23,79
2788,Netherlands,2016.0,9,25,13,47
2789,Netherlands,1928.0,20,29,8,57
2790,Netherlands,1996.0,38,9,26,73
2791,Netherlands,1996.0,38,9,26,73
2792,Netherlands,2004.0,4,51,22,77
2793,Netherlands,1996.0,38,9,26,73
2794,Netherlands,2000.0,27,29,23,79
2795,Netherlands,2004.0,4,51,22,77
2796,Netherlands,1948.0,8,2,32,42
2797,Netherlands,1952.0,0,21,0,21
2798,Netherlands,2004.0,4,51,22,77
2799,Netherlands,2012.0,21,29,19,69
2800,Netherlands,1988.0,6,8,38,52
2801,Netherlands,1912.0,0,0,26,26
2802,Netherlands,1988.0,6,8,38,52
2803,Netherlands,1996.0,38,9,26,73
2804,Netherlands,1988.0,6,8,38,52
2805,Netherlands,2016.0,9,25,13,47
2806,Netherlands,1912.0,0,0,26,26
2807,Netherlands,2004.0,4,51,22,77
2808,Netherlands,2012.0,21,29,19,69
2809,Netherlands,1996.0,38,9,26,73
2810,Netherlands,2000.0,27,29,23,79
2811,Netherlands,1964.0,6,11,16,33
2812,Netherlands,1968.0,9,10,4,23
2813,Netherlands,1968.0,9,10,4,23
2814,Netherlands,2010.0,4,1,6,11
2815,Netherlands,1964.0,6,11,16,33
2816,Netherlands,1928.0,20,29,8,57
2817,Netherlands,1912.0,0,0,26,26
2818,Netherlands,2008.0,39,18,4,61
2819,Netherlands,2012.0,21,29,19,69
2820,Netherlands,1968.0,9,10,4,23
2821,Netherlands,1996.0,38,9,26,73
2822,Netherlands,1996.0,38,9,26,73
2823,Netherlands,2004.0,4,51,22,77
2824,Netherlands,2008.0,39,18,4,61
2825,Netherlands,1936.0,9,7,21,37
2826,Netherlands,2002.0,3,5,0,8
2827,Netherlands,2006.0,3,2,8,13
2828,Netherlands,2008.0,39,18,4,61
2829,Netherlands,2012.0,21,29,19,69
2830,Netherlands,1920.0,15,10,25,50
2831,Netherlands,2000.0,27,29,23,79
2832,Netherlands,2004.0,4,51,22,77
2833,Netherlands,2014.0,13,7,9,29
2834,Willem-Six,1924.0,8,1,18,27
2835,Netherlands,2008.0,39,18,4,61
2836,Netherlands,1936.0,9,7,21,37
2837,Netherlands,2008.0,39,18,4,61
2838,Netherlands,1992.0,6,21,10,37
2839,Netherlands,1996.0,38,9,26,73
2840,Netherlands,1996.0,38,9,26,73
2841,Netherlands,1964.0,6,11,16,33
2842,Netherlands,2016.0,9,25,13,47
2843,Netherlands,2008.0,39,18,4,61
2844,Netherlands,2012.0,21,29,19,69
2845,Netherlands,1960.0,0,2,3,5
2846,Netherlands,1936.0,9,7,21,37
2847,Netherlands,1908.0,0,0,16,16
2848,Netherlands,1948.0,8,2,32,42
2849,Netherlands,1952.0,0,21,0,21
2850,Netherlands,1996.0,38,9,26,73
2851,Netherlands,1992.0,6,21,10,37
2852,Netherlands,1996.0,38,9,26,73
2853,Netherlands,1984.0,20,7,14,41
2854,Netherlands,1984.0,20,7,14,41
2855,Netherlands,1984.0,20,7,14,41
2856,Netherlands,1984.0,20,7,14,41
2857,Netherlands,1984.0,20,7,14,41
2858,Netherlands,2016.0,9,25,13,47
2859,Netherlands,1920.0,15,10,25,50
2860,Netherlands,2000.0,27,29,23,79
2861,Minerva Amsterdam,1900.0,3,8,16,27
2862,Netherlands,1984.0,20,7,14,41
2863,Beatrijs III-1,1920.0,15,10,25,50
2864,Beatrijs III-1,1920.0,15,10,25,50
2865,Beatrijs III-1,1920.0,15,10,25,50
2866,Netherlands,1964.0,6,11,16,33
2867,Netherlands,1976.0,1,4,15,20
2868,Netherlands,2012.0,21,29,19,69
2869,Amstel Amsterdam,1908.0,0,0,16,16
2870,Netherlands,1988.0,6,8,38,52
2871,Netherlands,1996.0,38,9,26,73
2872,Netherlands,2004.0,4,51,22,77
2873,Netherlands,2008.0,39,18,4,61
2874,Netherlands,2012.0,21,29,19,69
2875,Netherlands,2016.0,9,25,13,47
2876,Mascotte,1900.0,3,8,16,27
2877,Netherlands,2008.0,39,18,4,61
2878,Netherlands,2012.0,21,29,19,69
2879,Netherlands,1912.0,0,0,26,26
2880,Netherlands,1912.0,0,0,26,26
2881,Netherlands,1920.0,15,10,25,50
2882,Netherlands,1996.0,38,9,26,73
2883,Netherlands,2000.0,27,29,23,79
2884,Netherlands,2004.0,4,51,22,77
2885,Netherlands,1920.0,15,10,25,50
2886,Netherlands,1920.0,15,10,25,50
2887,Netherlands,1928.0,20,29,8,57
2888,Netherlands,1972.0,7,4,4,15
2889,Netherlands,1928.0,20,29,8,57
2890,Netherlands,1968.0,9,10,4,23
2891,Netherlands,1988.0,6,8,38,52
2892,Netherlands,1996.0,38,9,26,73
2893,Netherlands,2000.0,27,29,23,79
2894,Netherlands,1920.0,15,10,25,50
2895,Netherlands,1920.0,15,10,25,50
2896,Netherlands,2016.0,9,25,13,47
2897,Netherlands,1996.0,38,9,26,73
2898,Netherlands,2000.0,27,29,23,79
2899,Netherlands,2004.0,4,51,22,77
2900,Netherlands,2012.0,21,29,19,69
2901,Netherlands,2012.0,21,29,19,69
2902,Netherlands,2012.0,21,29,19,69
2903,Netherlands,2016.0,9,25,13,47
2904,Nrnberg,1936.0,9,7,21,37
2905,Netherlands,2004.0,4,51,22,77
2906,Netherlands,1964.0,6,11,16,33
2907,Netherlands,1928.0,20,29,8,57
2908,Netherlands,1948.0,8,2,32,42
2909,Netherlands,2016.0,9,25,13,47
2910,Netherlands,1988.0,6,8,38,52
2911,Netherlands,2012.0,21,29,19,69
2912,Netherlands,2000.0,27,29,23,79
2913,Netherlands,2004.0,4,51,22,77
2914,Hollandia,1928.0,20,29,8,57
2915,Netherlands,1972.0,7,4,4,15
2916,Netherlands,1972.0,7,4,4,15
2917,Netherlands,1972.0,7,4,4,15
2918,Netherlands,2008.0,39,18,4,61
2919,Netherlands,2012.0,21,29,19,69
2920,Netherlands,1988.0,6,8,38,52
2921,Netherlands,2004.0,4,51,22,77
2922,Netherlands,2014.0,13,7,9,29
2923,Netherlands,2008.0,39,18,4,61
2924,Minerva Amsterdam,1900.0,3,8,16,27
2925,Minerva Amsterdam,1900.0,3,8,16,27
2926,Netherlands,1996.0,38,9,26,73
2927,Netherlands,1976.0,1,4,15,20
2928,Netherlands,1976.0,1,4,15,20
2929,Netherlands,1980.0,1,3,6,10
2930,Netherlands,1992.0,6,21,10,37
2931,Netherlands,1964.0,6,11,16,33
2932,Netherlands,2014.0,13,7,9,29
2933,Netherlands,1988.0,6,8,38,52
2934,Netherlands,1992.0,6,21,10,37
2935,Netherlands,1964.0,6,11,16,33
2936,Netherlands,1964.0,6,11,16,33
2937,Netherlands,1964.0,6,11,16,33
2938,Netherlands,1968.0,9,10,4,23
2939,Netherlands,1908.0,0,0,16,16
2940,Netherlands,1988.0,6,8,38,52
2941,Netherlands,1996.0,38,9,26,73
2942,Netherlands,2008.0,39,18,4,61
2943,Netherlands,1928.0,20,29,8,57
2944,Netherlands,1948.0,8,2,32,42
2945,Netherlands,2004.0,4,51,22,77
2946,Netherlands,1936.0,9,7,21,37
2947,Netherlands,2006.0,3,2,8,13
2948,Netherlands,2006.0,3,2,8,13
2949,Netherlands,2010.0,4,1,6,11
2950,Netherlands,2010.0,4,1,6,11
2951,Netherlands,2014.0,13,7,9,29
2952,Netherlands,2014.0,13,7,9,29
2953,Netherlands,2014.0,13,7,9,29
2954,Netherlands,1968.0,9,10,4,23
2955,Netherlands,2008.0,39,18,4,61
2956,Netherlands,2012.0,21,29,19,69
2957,Netherlands,2012.0,21,29,19,69
2958,Netherlands,2012.0,21,29,19,69
2959,Netherlands,1976.0,1,4,15,20
2960,Netherlands,1988.0,6,8,38,52
2961,Netherlands,1948.0,8,2,32,42
2962,Netherlands,1952.0,0,21,0,21
2963,Netherlands,1972.0,7,4,4,15
2964,Netherlands,1996.0,38,9,26,73
2965,Netherlands,1920.0,15,10,25,50
2966,Netherlands,2010.0,4,1,6,11
2967,Netherlands,1932.0,2,10,1,13
2968,Netherlands,1960.0,0,2,3,5
2969,Netherlands,2012.0,21,29,19,69
2970,Netherlands,1976.0,1,4,15,20
2971,Netherlands,1948.0,8,2,32,42
2972,Netherlands,1992.0,6,21,10,37
2973,Netherlands,1964.0,6,11,16,33
2974,Netherlands,1996.0,38,9,26,73
2975,Netherlands,1984.0,20,7,14,41
2976,Netherlands,1928.0,20,29,8,57
2977,Netherlands,1984.0,20,7,14,41
2978,Minerva Amsterdam,1900.0,3,8,16,27
2979,Netherlands,1928.0,20,29,8,57
2980,Netherlands,1936.0,9,7,21,37
2981,Netherlands,2014.0,13,7,9,29
2982,Netherlands,1988.0,6,8,38,52
2983,Netherlands,1988.0,6,8,38,52
2984,Netherlands,1988.0,6,8,38,52
2985,Netherlands,2016.0,9,25,13,47
2986,Netherlands,1996.0,38,9,26,73
2987,Netherlands,2016.0,9,25,13,47
2988,Netherlands,1948.0,8,2,32,42
2989,Netherlands,1948.0,8,2,32,42
2990,Netherlands,1952.0,0,21,0,21
2991,Netherlands,2000.0,27,29,23,79
2992,Netherlands,1968.0,9,10,4,23
2993,Netherlands,1948.0,8,2,32,42
2994,Netherlands,1952.0,0,21,0,21
2995,Netherlands,1996.0,38,9,26,73
2996,Netherlands,2000.0,27,29,23,79
2997,Netherlands,1912.0,0,0,26,26
2998,Minerva Amsterdam,1900.0,3,8,16,27
2999,Minerva Amsterdam,1900.0,3,8,16,27
3000,Netherlands,2016.0,9,25,13,47
3001,Netherlands,1972.0,7,4,4,15
3002,Netherlands,1980.0,1,3,6,10
3003,Netherlands,1932.0,2,10,1,13
3004,Bem II,1936.0,9,7,21,37
3005,Starita,1948.0,8,2,32,42
3006,Netherlands,1928.0,20,29,8,57
3007,Netherlands,1996.0,38,9,26,73
3008,Netherlands,1920.0,15,10,25,50
3009,Netherlands,2004.0,4,51,22,77
3010,Netherlands,1948.0,8,2,32,42
3011,Netherlands,1936.0,9,7,21,37
3012,Netherlands,1936.0,9,7,21,37
3013,Netherlands,1936.0,9,7,21,37
3014,Netherlands,1936.0,9,7,21,37
3015,Netherlands,1996.0,38,9,26,73
3016,Netherlands,2000.0,27,29,23,79
3017,Netherlands,1928.0,20,29,8,57
3018,Netherlands-1,2016.0,9,25,13,47
3019,Netherlands,2000.0,27,29,23,79
3020,Netherlands,1924.0,8,1,18,27
3021,Netherlands,1992.0,6,21,10,37
3022,Minerva Amsterdam,1900.0,3,8,16,27
3023,Netherlands,1906.0,0,1,5,6
3024,Netherlands,2004.0,4,51,22,77
3025,Netherlands,1960.0,0,2,3,5
3026,Netherlands,2016.0,9,25,13,47
3027,Netherlands,2004.0,4,51,22,77
3028,Minerva Amsterdam,1900.0,3,8,16,27
3029,Netherlands,1928.0,20,29,8,57
3030,Nadine,2008.0,39,18,4,61
3031,Netherlands,2000.0,27,29,23,79
3032,Netherlands,2004.0,4,51,22,77
3033,Netherlands,2008.0,39,18,4,61
3034,Netherlands,1988.0,6,8,38,52
3035,Netherlands,1988.0,6,8,38,52
3036,Netherlands,2004.0,4,51,22,77
3037,Netherlands,2008.0,39,18,4,61
3038,Netherlands,1952.0,0,21,0,21
3039,Netherlands,2008.0,39,18,4,61
3040,Netherlands,2014.0,13,7,9,29
3041,Netherlands,2014.0,13,7,9,29
3042,Netherlands,2014.0,13,7,9,29
3043,Netherlands,2012.0,21,29,19,69
3044,Netherlands,1964.0,6,11,16,33
3045,Netherlands,1908.0,0,0,16,16
3046,Netherlands,1912.0,0,0,26,26
3047,Netherlands,1984.0,20,7,14,41
3048,Netherlands,1984.0,20,7,14,41
3049,Netherlands,1988.0,6,8,38,52
3050,Netherlands,1980.0,1,3,6,10
3051,Netherlands,1928.0,20,29,8,57
3052,Netherlands,1968.0,9,10,4,23
3053,Netherlands,1980.0,1,3,6,10
3054,Minerva Amsterdam,1900.0,3,8,16,27
3055,Netherlands,1984.0,20,7,14,41
3056,Netherlands,1988.0,6,8,38,52
3057,Netherlands,1936.0,9,7,21,37
3058,Netherlands,2000.0,27,29,23,79
3059,Netherlands,1936.0,9,7,21,37
3060,Netherlands,1936.0,9,7,21,37
3061,Netherlands,1906.0,0,1,5,6
3062,Netherlands,1908.0,0,0,16,16
3063,Netherlands,1964.0,6,11,16,33
3064,Netherlands,1932.0,2,10,1,13
3065,Netherlands,1920.0,15,10,25,50
3066,Netherlands,1924.0,8,1,18,27
3067,Netherlands,1928.0,20,29,8,57
3068,Netherlands,1928.0,20,29,8,57
3069,Netherlands,1932.0,2,10,1,13
3070,Netherlands,1932.0,2,10,1,13
3071,Netherlands,1988.0,6,8,38,52
3072,Netherlands,2016.0,9,25,13,47
3073,Netherlands,2008.0,39,18,4,61
3074,Netherlands,2012.0,21,29,19,69
3075,Netherlands,2016.0,9,25,13,47
3076,Netherlands,1988.0,6,8,38,52
3077,Netherlands,1920.0,15,10,25,50
3078,Netherlands,1924.0,8,1,18,27
3079,Netherlands,2000.0,27,29,23,79
3080,Netherlands,1960.0,0,2,3,5
3081,Netherlands,1928.0,20,29,8,57
3082,Netherlands,1928.0,20,29,8,57
3083,Netherlands,1964.0,6,11,16,33
3084,Netherlands,1968.0,9,10,4,23
3085,Netherlands,1928.0,20,29,8,57
3086,Netherlands,1996.0,38,9,26,73
3087,Netherlands,1928.0,20,29,8,57
3088,Netherlands,2008.0,39,18,4,61
3089,Netherlands,2012.0,21,29,19,69
3090,Netherlands,1976.0,1,4,15,20
3091,Netherlands,1984.0,20,7,14,41
3092,Netherlands,1992.0,6,21,10,37
3093,Netherlands,1996.0,38,9,26,73
3094,Netherlands,1998.0,5,4,2,11
3095,Netherlands,1998.0,5,4,2,11
3096,Netherlands,2000.0,27,29,23,79
3097,Netherlands,1984.0,20,7,14,41
3098,Netherlands,1992.0,6,21,10,37
3099,Netherlands,1992.0,6,21,10,37
3100,Netherlands,2004.0,4,51,22,77
3101,Netherlands,1908.0,0,0,16,16
3102,Netherlands,1984.0,20,7,14,41
3103,Netherlands,2008.0,39,18,4,61
3104,Netherlands,2012.0,21,29,19,69
3105,Netherlands,1948.0,8,2,32,42
3106,Netherlands,1988.0,6,8,38,52
3107,Netherlands,1992.0,6,21,10,37
3108,Netherlands,1996.0,38,9,26,73
3109,Netherlands,1968.0,9,10,4,23
3110,Netherlands,1994.0,0,1,3,4
3111,Netherlands,1994.0,0,1,3,4
3112,Netherlands,1998.0,5,4,2,11
3113,Netherlands,1998.0,5,4,2,11
3114,Netherlands,1998.0,5,4,2,11
3115,Netherlands,2006.0,3,2,8,13
3116,Netherlands,1996.0,38,9,26,73
3117,Netherlands,2016.0,9,25,13,47
3118,Netherlands,1948.0,8,2,32,42
3119,Netherlands,1998.0,5,4,2,11
3120,Netherlands,1998.0,5,4,2,11
3121,Netherlands,2002.0,3,5,0,8
3122,Netherlands,1992.0,6,21,10,37
3123,Netherlands,1924.0,8,1,18,27
3124,Netherlands,1996.0,38,9,26,73
3125,Netherlands,1996.0,38,9,26,73
3126,Netherlands,1996.0,38,9,26,73
3127,Netherlands,1964.0,6,11,16,33
3128,Netherlands,1948.0,8,2,32,42
3129,Netherlands,1972.0,7,4,4,15
3130,Netherlands,1972.0,7,4,4,15
3131,Netherlands,1948.0,8,2,32,42
3132,Netherlands,1992.0,6,21,10,37
3133,Netherlands,2010.0,4,1,6,11
3134,Netherlands,1912.0,0,0,26,26
3135,Netherlands,1928.0,20,29,8,57
3136,Netherlands,1928.0,20,29,8,57
3137,Netherlands,2004.0,4,51,22,77
3138,Netherlands,1928.0,20,29,8,57
3139,Netherlands,2012.0,21,29,19,69
3140,Sunrise,2008.0,39,18,4,61
3141,Netherlands,1968.0,9,10,4,23
3142,Netherlands,1972.0,7,4,4,15
3143,Netherlands,1972.0,7,4,4,15
3144,Netherlands,1972.0,7,4,4,15
3145,Netherlands,1924.0,8,1,18,27
3146,Netherlands,2016.0,9,25,13,47
3147,Netherlands,1988.0,6,8,38,52
3148,Netherlands,1936.0,9,7,21,37
3149,Netherlands,2004.0,4,51,22,77
3150,Netherlands,2008.0,39,18,4,61
3151,Netherlands,2008.0,39,18,4,61
3152,Netherlands,2012.0,21,29,19,69
3153,Netherlands,2012.0,21,29,19,69
3154,Netherlands,2012.0,21,29,19,69
3155,Netherlands,1996.0,38,9,26,73
3156,Netherlands,1932.0,2,10,1,13
3157,Netherlands,1968.0,9,10,4,23
3158,Netherlands,1964.0,6,11,16,33
3159,Netherlands,1936.0,9,7,21,37
3160,Netherlands,1992.0,6,21,10,37
3161,Netherlands,1936.0,9,7,21,37
3162,Netherlands,1984.0,20,7,14,41
3163,Netherlands,2016.0,9,25,13,47
3164,Netherlands,2004.0,4,51,22,77
3165,Netherlands,2008.0,39,18,4,61
3166,Netherlands,2008.0,39,18,4,61
3167,Netherlands,1900.0,3,8,16,27
3168,Netherlands,1996.0,38,9,26,73
3169,Netherlands,2000.0,27,29,23,79
3170,Netherlands,2004.0,4,51,22,77
3171,Netherlands,2000.0,27,29,23,79
3172,Netherlands,2004.0,4,51,22,77
3173,Netherlands,1948.0,8,2,32,42
3174,Netherlands,1948.0,8,2,32,42
3175,Netherlands,2000.0,27,29,23,79
3176,Netherlands,2000.0,27,29,23,79
3177,Netherlands,2004.0,4,51,22,77
3178,Netherlands,2008.0,39,18,4,61
3179,Netherlands,2014.0,13,7,9,29
3180,Netherlands,2002.0,3,5,0,8
3181,Netherlands,2008.0,39,18,4,61
3182,Netherlands,1976.0,1,4,15,20
3183,Netherlands,1948.0,8,2,32,42
3184,Mascotte,1900.0,3,8,16,27
3185,Netherlands,2012.0,21,29,19,69
3186,Netherlands,2004.0,4,51,22,77
3187,Netherlands,2008.0,39,18,4,61
3188,Netherlands,1908.0,0,0,16,16
3189,Netherlands,2004.0,4,51,22,77
3190,Netherlands,1908.0,0,0,16,16
3191,Netherlands,2012.0,21,29,19,69
3192,Netherlands,2016.0,9,25,13,47
3193,Netherlands,1936.0,9,7,21,37
3194,Netherlands,1988.0,6,8,38,52
3195,Netherlands,1948.0,8,2,32,42
3196,Netherlands,1984.0,20,7,14,41
3197,Netherlands,1948.0,8,2,32,42
3198,Netherlands,1920.0,15,10,25,50
3199,Netherlands,1996.0,38,9,26,73
3200,Netherlands,1988.0,6,8,38,52
3201,Netherlands,1928.0,20,29,8,57
3202,Netherlands,2012.0,21,29,19,69
3203,Netherlands,1972.0,7,4,4,15
3204,Netherlands,1976.0,1,4,15,20
3205,Starita,1948.0,8,2,32,42
3206,Netherlands,1968.0,9,10,4,23
3207,Netherlands,1900.0,3,8,16,27
3208,Netherlands,1976.0,1,4,15,20
3209,Netherlands,2004.0,4,51,22,77
3210,Netherlands,2004.0,4,51,22,77
3211,Netherlands,2008.0,39,18,4,61
3212,Netherlands,1936.0,9,7,21,37
3213,Netherlands,1996.0,38,9,26,73
3214,Netherlands,2000.0,27,29,23,79
3215,Netherlands,2000.0,27,29,23,79
3216,Netherlands,1992.0,6,21,10,37
3217,Netherlands,1912.0,0,0,26,26
3218,Netherlands,2000.0,27,29,23,79
3219,Netherlands,2014.0,13,7,9,29
3220,Netherlands,2014.0,13,7,9,29
3221,Netherlands,1948.0,8,2,32,42
3222,Netherlands,1952.0,0,21,0,21
3223,Netherlands,1952.0,0,21,0,21
3224,Netherlands,1964.0,6,11,16,33
3225,Netherlands,1964.0,6,11,16,33
3226,Minerva Amsterdam,1900.0,3,8,16,27
3227,Netherlands,1996.0,38,9,26,73
3228,Netherlands,2000.0,27,29,23,79
3229,Netherlands,1920.0,15,10,25,50
3230,Netherlands,1908.0,0,0,16,16
3231,Netherlands,1948.0,8,2,32,42
3232,Netherlands,1952.0,0,21,0,21
3233,Netherlands,1924.0,8,1,18,27
3234,Netherlands,1998.0,5,4,2,11
3235,Netherlands,1998.0,5,4,2,11
3236,Netherlands,2006.0,3,2,8,13
3237,Netherlands,1976.0,1,4,15,20
3238,Netherlands,1992.0,6,21,10,37
3239,Netherlands,2000.0,27,29,23,79
3240,Netherlands,1996.0,38,9,26,73
3241,Netherlands,1928.0,20,29,8,57
3242,Minerva Amsterdam,1900.0,3,8,16,27
3243,Netherlands,2006.0,3,2,8,13
3244,Netherlands,2010.0,4,1,6,11
3245,Netherlands,2010.0,4,1,6,11
3246,Netherlands,2016.0,9,25,13,47
3247,Netherlands,2002.0,3,5,0,8
3248,Netherlands,2002.0,3,5,0,8
3249,Netherlands,2002.0,3,5,0,8
3250,Netherlands,1984.0,20,7,14,41
3251,Netherlands,2000.0,27,29,23,79
3252,Netherlands,2008.0,39,18,4,61
3253,Netherlands,2012.0,21,29,19,69
3254,Netherlands,2016.0,9,25,13,47
3255,Netherlands,2000.0,27,29,23,79
3256,Netherlands,2014.0,13,7,9,29
3257,Netherlands,2014.0,13,7,9,29
3258,Netherlands,2008.0,39,18,4,61
3259,Netherlands,1980.0,1,3,6,10
3260,Netherlands,1984.0,20,7,14,41
3261,Netherlands,1988.0,6,8,38,52
3262,Netherlands,1906.0,0,1,5,6
3263,Netherlands,1992.0,6,21,10,37
3264,Netherlands,1912.0,0,0,26,26
3265,Netherlands,1920.0,15,10,25,50
3266,Netherlands,1996.0,38,9,26,73
3267,Netherlands,1996.0,38,9,26,73
3268,Netherlands,1964.0,6,11,16,33
3269,Netherlands,1964.0,6,11,16,33
3270,Netherlands,1996.0,38,9,26,73
3271,Netherlands,2000.0,27,29,23,79
3272,Netherlands,1928.0,20,29,8,57
3273,Netherlands,1936.0,9,7,21,37
3274,Netherlands,2008.0,39,18,4,61
3275,Netherlands,1928.0,20,29,8,57
3276,Netherlands,1984.0,20,7,14,41
3277,Netherlands,1924.0,8,1,18,27
3278,Netherlands,1900.0,3,8,16,27
3279,Netherlands,1996.0,38,9,26,73
3280,Netherlands,2000.0,27,29,23,79
3281,Netherlands,1928.0,20,29,8,57
3282,Netherlands,2008.0,39,18,4,61
3283,Netherlands,1988.0,6,8,38,52
3284,Netherlands,1996.0,38,9,26,73
3285,Netherlands,2000.0,27,29,23,79
3286,Netherlands,2000.0,27,29,23,79
3287,Netherlands,2000.0,27,29,23,79
3288,Netherlands,2000.0,27,29,23,79
3289,Netherlands,2004.0,4,51,22,77
3290,Netherlands,2004.0,4,51,22,77
3291,Netherlands,2004.0,4,51,22,77
3292,Netherlands,1948.0,8,2,32,42
3293,Boreas-2,1920.0,15,10,25,50
3294,Netherlands,2016.0,9,25,13,47
3295,Netherlands,2016.0,9,25,13,47
3296,Netherlands,2004.0,4,51,22,77
3297,Netherlands,1964.0,6,11,16,33
3298,Netherlands,1936.0,9,7,21,37
3299,Netherlands,1928.0,20,29,8,57
3300,Netherlands,1992.0,6,21,10,37
3301,Netherlands,1928.0,20,29,8,57
3302,Netherlands,2012.0,21,29,19,69
3303,Netherlands,1948.0,8,2,32,42
3304,Netherlands,2004.0,4,51,22,77
3305,Netherlands,2008.0,39,18,4,61
3306,Netherlands,1936.0,9,7,21,37
3307,Netherlands,1996.0,38,9,26,73
3308,Netherlands,2008.0,39,18,4,61
3309,Netherlands,1992.0,6,21,10,37
3310,Netherlands,1996.0,38,9,26,73
3311,Netherlands,1988.0,6,8,38,52
3312,Netherlands,1912.0,0,0,26,26
3313,Netherlands,2000.0,27,29,23,79
3314,Netherlands,2004.0,4,51,22,77
3315,Netherlands,1928.0,20,29,8,57
3316,Netherlands,1928.0,20,29,8,57
3317,Mascotte,1900.0,3,8,16,27
3318,Netherlands,2012.0,21,29,19,69
3319,Netherlands,1952.0,0,21,0,21
3320,Netherlands,1924.0,8,1,18,27
3321,Netherlands,1924.0,8,1,18,27
3322,Netherlands,1928.0,20,29,8,57
3323,Netherlands,2012.0,21,29,19,69
3324,Netherlands,2000.0,27,29,23,79
3325,Netherlands,2004.0,4,51,22,77
3326,Netherlands,2008.0,39,18,4,61
3327,Netherlands,1920.0,15,10,25,50
3328,Netherlands,1924.0,8,1,18,27
3329,Netherlands,1996.0,38,9,26,73
3330,Netherlands,2000.0,27,29,23,79
3331,Netherlands,1964.0,6,11,16,33
3332,Netherlands,2000.0,27,29,23,79
3333,Netherlands,1996.0,38,9,26,73
3334,Netherlands,1928.0,20,29,8,57
3335,Minerva Amsterdam,1900.0,3,8,16,27
3336,Netherlands,1968.0,9,10,4,23
3337,Netherlands,2000.0,27,29,23,79
3338,Netherlands,2000.0,27,29,23,79
3339,Netherlands,1984.0,20,7,14,41
3340,Netherlands,1988.0,6,8,38,52
3341,Netherlands,1920.0,15,10,25,50
3342,Netherlands,1984.0,20,7,14,41
3343,Netherlands,1924.0,8,1,18,27
3344,Netherlands,1932.0,2,10,1,13
3345,Netherlands,1932.0,2,10,1,13
3346,Netherlands,2016.0,9,25,13,47
3347,Netherlands,1984.0,20,7,14,41
3348,Netherlands,2004.0,4,51,22,77
3349,Netherlands,2008.0,39,18,4,61
3350,Netherlands,1948.0,8,2,32,42
3351,Netherlands,1920.0,15,10,25,50
3352,Netherlands,2004.0,4,51,22,77
3353,Netherlands,2008.0,39,18,4,61
3354,Netherlands,2012.0,21,29,19,69
3355,Netherlands,2016.0,9,25,13,47
3356,Netherlands,1988.0,6,8,38,52
3357,Netherlands,1988.0,6,8,38,52
3358,Netherlands,1988.0,6,8,38,52
3359,Netherlands,1920.0,15,10,25,50
3360,Netherlands,2016.0,9,25,13,47
3361,Netherlands,1992.0,6,21,10,37
3362,Netherlands,1996.0,38,9,26,73
3363,Netherlands,1996.0,38,9,26,73
3364,Netherlands,2000.0,27,29,23,79
3365,Netherlands,2000.0,27,29,23,79
3366,Netherlands,2004.0,4,51,22,77
3367,Netherlands,2008.0,39,18,4,61
3368,Salinero,2008.0,39,18,4,61
3369,Netherlands,2012.0,21,29,19,69
3370,Netherlands,1948.0,8,2,32,42
3371,Netherlands,1952.0,0,21,0,21
3372,Netherlands,1976.0,1,4,15,20
3373,Netherlands,1976.0,1,4,15,20
3374,Netherlands,1976.0,1,4,15,20
3375,Netherlands,1924.0,8,1,18,27
3376,Univ. of Brussels,1900.0,3,8,16,27
3377,Netherlands,2000.0,27,29,23,79
3378,Hollandia,1928.0,20,29,8,57
3379,Netherlands,2004.0,4,51,22,77
3380,Netherlands,1928.0,20,29,8,57
3381,Netherlands,1992.0,6,21,10,37
3382,Netherlands,1932.0,2,10,1,13
3383,Netherlands,1936.0,9,7,21,37
3384,Netherlands,1906.0,0,1,5,6
3385,Netherlands,1920.0,15,10,25,50
3386,Netherlands,1920.0,15,10,25,50
3387,Netherlands,2012.0,21,29,19,69
3388,Netherlands,2016.0,9,25,13,47
3389,Netherlands,2012.0,21,29,19,69
3390,Netherlands,2016.0,9,25,13,47
3391,Netherlands,1984.0,20,7,14,41
3392,Netherlands,1988.0,6,8,38,52
3393,Netherlands,1996.0,38,9,26,73
3394,Netherlands,1920.0,15,10,25,50
3395,Netherlands,1996.0,38,9,26,73
3396,Netherlands,2000.0,27,29,23,79
3397,Netherlands,2000.0,27,29,23,79
3398,Netherlands,1968.0,9,10,4,23
3399,Netherlands,1996.0,38,9,26,73
3400,Netherlands,2000.0,27,29,23,79
3401,Netherlands,1928.0,20,29,8,57
3402,Netherlands,1920.0,15,10,25,50
3403,Netherlands,1928.0,20,29,8,57
3404,Netherlands,1920.0,15,10,25,50
3405,Netherlands,1920.0,15,10,25,50
3406,Netherlands,2010.0,4,1,6,11
3407,Netherlands,2012.0,21,29,19,69
3408,Netherlands,2016.0,9,25,13,47
3409,Netherlands,2000.0,27,29,23,79
3410,Netherlands,2008.0,39,18,4,61
3411,Netherlands,1906.0,0,1,5,6
3412,Netherlands,1906.0,0,1,5,6
3413,Netherlands,1912.0,0,0,26,26
3414,Netherlands,1912.0,0,0,26,26
3415,Netherlands,2016.0,9,25,13,47
3416,Netherlands,2004.0,4,51,22,77
3417,Netherlands,2008.0,39,18,4,61
3418,Netherlands,1928.0,20,29,8,57
3419,Netherlands,1936.0,9,7,21,37
3420,Hollandia,1928.0,20,29,8,57
3421,Netherlands,1984.0,20,7,14,41
3422,Netherlands,1996.0,38,9,26,73
3423,Netherlands,2002.0,3,5,0,8
3424,Netherlands,1980.0,1,3,6,10
3425,Netherlands,1984.0,20,7,14,41
3426,Netherlands,1936.0,9,7,21,37
3427,Netherlands,1936.0,9,7,21,37
3428,Netherlands,1948.0,8,2,32,42
3429,Netherlands,1952.0,0,21,0,21
3430,Netherlands,2000.0,27,29,23,79
3431,Netherlands,1964.0,6,11,16,33
3432,Netherlands,1996.0,38,9,26,73
3433,Netherlands,2000.0,27,29,23,79
3434,Netherlands,1976.0,1,4,15,20
3435,Netherlands,1984.0,20,7,14,41
3436,Netherlands,1988.0,6,8,38,52
3437,Netherlands,1992.0,6,21,10,37
3438,Netherlands,1996.0,38,9,26,73
3439,Netherlands,2000.0,27,29,23,79
3440,Netherlands,1964.0,6,11,16,33
3441,Netherlands,2012.0,21,29,19,69
3442,Netherlands,2004.0,4,51,22,77
3443,Netherlands,2000.0,27,29,23,79
3444,Netherlands,1976.0,1,4,15,20
3445,Netherlands,2004.0,4,51,22,77
3446,Netherlands,2004.0,4,51,22,77
3447,Netherlands,2008.0,39,18,4,61
3448,Netherlands,2012.0,21,29,19,69
3449,Netherlands,2012.0,21,29,19,69
3450,Netherlands,1992.0,6,21,10,37
3451,Netherlands,1994.0,0,1,3,4
3452,Netherlands,2004.0,4,51,22,77
3453,Netherlands,2000.0,27,29,23,79
3454,Netherlands,2000.0,27,29,23,79
3455,Netherlands,2012.0,21,29,19,69
3456,Netherlands,2006.0,3,2,8,13
3457,Netherlands,2006.0,3,2,8,13
3458,Netherlands,1928.0,20,29,8,57
3459,Netherlands,1964.0,6,11,16,33
3460,Netherlands,1968.0,9,10,4,23
3461,Netherlands,1968.0,9,10,4,23
3462,Netherlands,1972.0,7,4,4,15
3463,Netherlands,2004.0,4,51,22,77
3464,Netherlands,2012.0,21,29,19,69
3465,Netherlands,2016.0,9,25,13,47
3466,Netherlands,2016.0,9,25,13,47
3467,Netherlands,1984.0,20,7,14,41
3468,Netherlands,1984.0,20,7,14,41
3469,Netherlands,1984.0,20,7,14,41
3470,Netherlands,1928.0,20,29,8,57
3471,Netherlands,1920.0,15,10,25,50
3472,Netherlands,2014.0,13,7,9,29
3473,Netherlands,2014.0,13,7,9,29
3474,Netherlands,1932.0,2,10,1,13
3475,Netherlands,1988.0,6,8,38,52
3476,Netherlands,1988.0,6,8,38,52
3477,Netherlands,1992.0,6,21,10,37
3478,Netherlands,1992.0,6,21,10,37
3479,Netherlands,1980.0,1,3,6,10
3480,Netherlands,1928.0,20,29,8,57
3481,Netherlands,1996.0,38,9,26,73
3482,Netherlands,1996.0,38,9,26,73
3483,Netherlands,1996.0,38,9,26,73
3484,Netherlands,2000.0,27,29,23,79
3485,Netherlands,2004.0,4,51,22,77
3486,Netherlands,1920.0,15,10,25,50
3487,Netherlands,1984.0,20,7,14,41
3488,Netherlands,1988.0,6,8,38,52
3489,Netherlands,2000.0,27,29,23,79
3490,Netherlands,1948.0,8,2,32,42
3491,Netherlands,1912.0,0,0,26,26
3492,Netherlands,2008.0,39,18,4,61
3493,Netherlands,2012.0,21,29,19,69
3494,Netherlands,1984.0,20,7,14,41
3495,Willem-Six,1924.0,8,1,18,27
3496,Netherlands,2012.0,21,29,19,69
3497,Hollandia,1928.0,20,29,8,57
3498,Netherlands,1936.0,9,7,21,37
3499,Netherlands,2016.0,9,25,13,47
3500,Netherlands,2004.0,4,51,22,77
3501,Netherlands,1908.0,0,0,16,16
3502,Netherlands,2008.0,39,18,4,61
3503,Netherlands,2012.0,21,29,19,69
3504,Netherlands,2016.0,9,25,13,47
3505,Netherlands,2006.0,3,2,8,13
3506,Netherlands,2006.0,3,2,8,13
3507,Oranje,1920.0,15,10,25,50
3508,Netherlands,1952.0,0,21,0,21
3509,Netherlands,2012.0,21,29,19,69
3510,Netherlands,2000.0,27,29,23,79
3511,Netherlands,1936.0,9,7,21,37
3512,Netherlands,1932.0,2,10,1,13
3513,Netherlands,2012.0,21,29,19,69
3514,Netherlands,2016.0,9,25,13,47
3515,Netherlands,1952.0,0,21,0,21
3516,Amstel Amsterdam,1908.0,0,0,16,16
3517,Netherlands,1968.0,9,10,4,23
3518,Netherlands,2016.0,9,25,13,47
3519,Netherlands,2016.0,9,25,13,47
3520,Netherlands,1936.0,9,7,21,37
3521,Netherlands,1936.0,9,7,21,37
3522,Netherlands,1920.0,15,10,25,50
3523,Netherlands,1924.0,8,1,18,27
3524,Netherlands,1912.0,0,0,26,26
3525,Netherlands,2008.0,39,18,4,61
3526,Netherlands,1924.0,8,1,18,27
3527,Netherlands,1920.0,15,10,25,50
3528,Netherlands,1984.0,20,7,14,41
3529,Netherlands,1988.0,6,8,38,52
3530,Netherlands,1928.0,20,29,8,57
3531,Netherlands,2000.0,27,29,23,79
3532,Netherlands,1964.0,6,11,16,33
3533,Netherlands,2008.0,39,18,4,61
3534,Netherlands,1948.0,8,2,32,42
3535,Netherlands,1988.0,6,8,38,52
3536,Netherlands,2004.0,4,51,22,77
3537,Netherlands,2008.0,39,18,4,61
3538,Netherlands,2000.0,27,29,23,79
3539,Netherlands,2006.0,3,2,8,13
3540,Netherlands,2006.0,3,2,8,13
3541,Netherlands,2010.0,4,1,6,11
3542,Netherlands,2014.0,13,7,9,29
3543,Netherlands,2014.0,13,7,9,29
3544,Netherlands,2014.0,13,7,9,29
3545,Netherlands,2014.0,13,7,9,29
3546,Netherlands,2014.0,13,7,9,29
3547,Netherlands,1988.0,6,8,38,52
3548,Netherlands,1992.0,6,21,10,37
3549,Netherlands,1994.0,0,1,3,4
3550,Netherlands,2004.0,4,51,22,77
3551,Netherlands,1984.0,20,7,14,41
3552,Netherlands,1920.0,15,10,25,50
3553,Netherlands,2000.0,27,29,23,79
3554,Netherlands,2000.0,27,29,23,79
3555,Netherlands,2000.0,27,29,23,79
3556,Netherlands,2000.0,27,29,23,79
3557,Netherlands,2004.0,4,51,22,77
3558,Netherlands,2004.0,4,51,22,77
3559,Netherlands,1964.0,6,11,16,33
3560,Netherlands,1968.0,9,10,4,23
3561,Netherlands,2012.0,21,29,19,69
3562,Netherlands,1992.0,6,21,10,37
3563,Netherlands,2000.0,27,29,23,79
3564,Netherlands,2004.0,4,51,22,77
3565,Netherlands,1992.0,6,21,10,37
3566,Netherlands,1996.0,38,9,26,73
3567,Netherlands,1996.0,38,9,26,73
3568,Netherlands,1992.0,6,21,10,37
3569,Netherlands,1996.0,38,9,26,73
3570,France,1956.0,7,13,13,33
3571,France,2008.0,25,24,28,77
3572,France,2012.0,30,30,22,82
3573,France,2016.0,20,55,21,96
3574,France,2008.0,25,24,28,77
3575,France,2004.0,21,10,22,53
3576,France,2008.0,25,24,28,77
3577,France,2012.0,30,30,22,82
3578,France,1948.0,28,23,26,77
3579,France-1,1992.0,14,11,44,69
3580,France-1,1996.0,21,10,20,51
3581,France,2016.0,20,55,21,96
3582,France,2012.0,30,30,22,82
3583,France,2012.0,30,30,22,82
3584,France,2012.0,30,30,22,82
3585,Union des Socits Franais de Sports Athletiques,1900.0,52,101,82,235
3586,France-3,1920.0,13,71,57,141
3587,Union des Socits Franais de Sports Athletiques,1900.0,52,101,82,235
3588,Martha-1,1900.0,52,101,82,235
3589,Martha-1,1900.0,52,101,82,235
3590,France,1984.0,20,17,33,70
3591,France,1988.0,13,4,14,31
3592,France,1920.0,13,71,57,141
3593,France,1908.0,12,5,23,40
3594,France,1908.0,12,5,23,40
3595,France,1936.0,13,13,19,45
3596,France,1992.0,14,11,44,69
3597,USFSA,1900.0,52,101,82,235
3598,France,1996.0,21,10,20,51
3599,France,1996.0,21,10,20,51
3600,France,2002.0,5,5,5,15
3601,France,1920.0,13,71,57,141
3602,France,1920.0,13,71,57,141
3603,France,1928.0,14,24,14,52
3604,France,2016.0,20,55,21,96
3605,France,1908.0,12,5,23,40
3606,France,1920.0,13,71,57,141
3607,France,1924.0,37,51,32,120
3608,France,1996.0,21,10,20,51
3609,France,2000.0,22,30,14,66
3610,France-1,1998.0,2,1,12,15
3611,France-1,2002.0,5,5,5,15
3612,France,1952.0,14,9,18,41
3613,France,2010.0,2,6,6,14
3614,France,1928.0,14,24,14,52
3615,France,1964.0,4,17,17,38
3616,France,1924.0,37,51,32,120
3617,France,1900.0,52,101,82,235
3618,France,2008.0,25,24,28,77
3619,France,1928.0,14,24,14,52
3620,France,2004.0,21,10,22,53
3621,Guyoni,1908.0,12,5,23,40
3622,France,1948.0,28,23,26,77
3623,France,2000.0,22,30,14,66
3624,Union des Socits Franais de Sports Athletiques,1900.0,52,101,82,235
3625,France,1908.0,12,5,23,40
3626,France,1908.0,12,5,23,40
3627,Carabinier-15,1900.0,52,101,82,235
3628,France,1900.0,52,101,82,235
3629,France,1900.0,52,101,82,235
3630,France,1992.0,14,11,44,69
3631,France,1984.0,20,17,33,70
3632,France,1900.0,52,101,82,235
3633,France,1900.0,52,101,82,235
3634,France,2016.0,20,55,21,96
3635,France,2016.0,20,55,21,96
3636,France,2008.0,25,24,28,77
3637,USFSA,1900.0,52,101,82,235
3638,France,1920.0,13,71,57,141
3639,France,1992.0,14,11,44,69
3640,France,2008.0,25,24,28,77
3641,France,1932.0,28,8,6,42
3642,France,2006.0,3,2,10,15
3643,France,2010.0,2,6,6,14
3644,France,1994.0,0,1,10,11
3645,France,1998.0,2,1,12,15
3646,France,1996.0,21,10,20,51
3647,France,2000.0,22,30,14,66
3648,France,2000.0,22,30,14,66
3649,France,1908.0,12,5,23,40
3650,France,2012.0,30,30,22,82
3651,France,1968.0,16,8,12,36
3652,France,2012.0,30,30,22,82
3653,France,1996.0,21,10,20,51
3654,France,1920.0,13,71,57,141
3655,France,1928.0,14,24,14,52
3656,France,2000.0,22,30,14,66
3657,France,1906.0,20,16,28,64
3658,France,1906.0,20,16,28,64
3659,France,1996.0,21,10,20,51
3660,France,1996.0,21,10,20,51
3661,France,1984.0,20,17,33,70
3662,France,2016.0,20,55,21,96
3663,France,1948.0,28,23,26,77
3664,France,1980.0,18,5,7,30
3665,France,1980.0,18,5,7,30
3666,France,1900.0,52,101,82,235
3667,France,1900.0,52,101,82,235
3668,France,2016.0,20,55,21,96
3669,Racing Club de France,1900.0,52,101,82,235
3670,France,1900.0,52,101,82,235
3671,France,2016.0,20,55,21,96
3672,France,1956.0,7,13,13,33
3673,Crabe II-1,1900.0,52,101,82,235
3674,Crabe II-4,1900.0,52,101,82,235
3675,Nina Claire-2,1900.0,52,101,82,235
3676,Nina Claire-2,1900.0,52,101,82,235
3677,France,2008.0,25,24,28,77
3678,France,2012.0,30,30,22,82
3679,France,2012.0,30,30,22,82
3680,France,2016.0,20,55,21,96
3681,France,2008.0,25,24,28,77
3682,France,2004.0,21,10,22,53
3683,France,2006.0,3,2,10,15
3684,France,2006.0,3,2,10,15
3685,France,1924.0,37,51,32,120
3686,France,2014.0,4,4,10,18
3687,France,1928.0,14,24,14,52
3688,France,2016.0,20,55,21,96
3689,France,2006.0,3,2,10,15
3690,France,2010.0,2,6,6,14
3691,France,1924.0,37,51,32,120
3692,France,1924.0,37,51,32,120
3693,France,2012.0,30,30,22,82
3694,France,2000.0,22,30,14,66
3695,France-2,2012.0,30,30,22,82
3696,France,1920.0,13,71,57,141
3697,France,1908.0,12,5,23,40
3698,Socit Nautique de Bayonne-1,1906.0,20,16,28,64
3699,Socit Nautique de Bayonne-2,1906.0,20,16,28,64
3700,France,2008.0,25,24,28,77
3701,France,2008.0,25,24,28,77
3702,France,2008.0,25,24,28,77
3703,France,2012.0,30,30,22,82
3704,France,1948.0,28,23,26,77
3705,France,1952.0,14,9,18,41
3706,France,1920.0,13,71,57,141
3707,France,1968.0,16,8,12,36
3708,France,1972.0,2,6,17,25
3709,France,2008.0,25,24,28,77
3710,France,1988.0,13,4,14,31
3711,France,1924.0,37,51,32,120
3712,France,1972.0,2,6,17,25
3713,France,1928.0,14,24,14,52
3714,Tritons Lillois-2,1900.0,52,101,82,235
3715,France,1968.0,16,8,12,36
3716,France,2000.0,22,30,14,66
3717,France,1988.0,13,4,14,31
3718,France,1948.0,28,23,26,77
3719,France,1948.0,28,23,26,77
3720,France,1952.0,14,9,18,41
3721,France,1956.0,7,13,13,33
3722,France,1984.0,20,17,33,70
3723,France,1984.0,20,17,33,70
3724,France,2000.0,22,30,14,66
3725,Esterel-1,1900.0,52,101,82,235
3726,Union des Socits Franais de Sports Athletiques,1900.0,52,101,82,235
3727,France,1924.0,37,51,32,120
3728,France,2002.0,5,5,5,15
3729,France,1924.0,37,51,32,120
3730,France,1924.0,37,51,32,120
3731,Olle,1900.0,52,101,82,235
3732,Olle,1900.0,52,101,82,235
3733,USFSA,1900.0,52,101,82,235
3734,France,1952.0,14,9,18,41
3735,France,1948.0,28,23,26,77
3736,France,1984.0,20,17,33,70
3737,France,1980.0,18,5,7,30
3738,France,1976.0,5,7,9,21
3739,France,1996.0,21,10,20,51
3740,France,2004.0,21,10,22,53
3741,France,1980.0,18,5,7,30
3742,France,1984.0,20,17,33,70
3743,France,1984.0,20,17,33,70
3744,France,2004.0,21,10,22,53
3745,France,1952.0,14,9,18,41
3746,France,1952.0,14,9,18,41
3747,France,1992.0,14,11,44,69
3748,France,2000.0,22,30,14,66
3749,France,1932.0,28,8,6,42
3750,France,1936.0,13,13,19,45
3751,France,1980.0,18,5,7,30
3752,France,1948.0,28,23,26,77
3753,France,1964.0,4,17,17,38
3754,France,1908.0,12,5,23,40
3755,France,1924.0,37,51,32,120
3756,France,2012.0,30,30,22,82
3757,France,1948.0,28,23,26,77
3758,France,1980.0,18,5,7,30
3759,France,1908.0,12,5,23,40
3760,France,2008.0,25,24,28,77
3761,France,1924.0,37,51,32,120
3762,France,1920.0,13,71,57,141
3763,France,2016.0,20,55,21,96
3764,France-2,1924.0,37,51,32,120
3765,France,1980.0,18,5,7,30
3766,France,1996.0,21,10,20,51
3767,France,2016.0,20,55,21,96
3768,France,1984.0,20,17,33,70
3769,L'Aile VI,1928.0,14,24,14,52
3770,France,1984.0,20,17,33,70
3771,France,1920.0,13,71,57,141
3772,Cercle de l'Aviron Roubaix-4,1900.0,52,101,82,235
3773,France,1964.0,4,17,17,38
3774,France,1988.0,13,4,14,31
3775,France,1900.0,52,101,82,235
3776,France,1932.0,28,8,6,42
3777,France,1936.0,13,13,19,45
3778,France,1948.0,28,23,26,77
3779,France,2008.0,25,24,28,77
3780,France,1908.0,12,5,23,40
3781,France,1912.0,10,11,5,26
3782,France,1952.0,14,9,18,41
3783,France,1920.0,13,71,57,141
3784,France,1900.0,52,101,82,235
3785,France,1996.0,21,10,20,51
3786,France,1988.0,13,4,14,31
3787,France,1992.0,14,11,44,69
3788,France,2004.0,21,10,22,53
3789,France,2008.0,25,24,28,77
3790,France,2008.0,25,24,28,77
3791,France,1964.0,4,17,17,38
3792,France,1920.0,13,71,57,141
3793,France,1924.0,37,51,32,120
3794,France,2008.0,25,24,28,77
3795,France,1992.0,14,11,44,69
3796,France,1948.0,28,23,26,77
3797,France,1984.0,20,17,33,70
3798,France,1984.0,20,17,33,70
3799,France,2014.0,4,4,10,18
3800,France,1960.0,1,6,8,15
3801,France,1952.0,14,9,18,41
3802,France,2010.0,2,6,6,14
3803,France,1984.0,20,17,33,70
3804,France,1984.0,20,17,33,70
3805,Namoussa,1924.0,37,51,32,120
3806,France,2012.0,30,30,22,82
3807,France,1992.0,14,11,44,69
3808,France,1994.0,0,1,10,11
3809,France,1994.0,0,1,10,11
3810,France,1984.0,20,17,33,70
3811,France,1964.0,4,17,17,38
3812,France,1964.0,4,17,17,38
3813,France,1972.0,2,6,17,25
3814,France,1912.0,10,11,5,26
3815,France,1912.0,10,11,5,26
3816,France,1920.0,13,71,57,141
3817,France,1980.0,18,5,7,30
3818,France,1984.0,20,17,33,70
3819,France-1,1924.0,37,51,32,120
3820,France,1920.0,13,71,57,141
3821,France,1920.0,13,71,57,141
3822,France,1920.0,13,71,57,141
3823,France,1920.0,13,71,57,141
3824,France,1920.0,13,71,57,141
3825,France,2010.0,2,6,6,14
3826,France,2010.0,2,6,6,14
3827,France,1932.0,28,8,6,42
3828,France-1,1924.0,37,51,32,120
3829,France,1928.0,14,24,14,52
3830,France,1932.0,28,8,6,42
3831,France-1,1924.0,37,51,32,120
3832,France,1928.0,14,24,14,52
3833,France,1932.0,28,8,6,42
3834,France,1920.0,13,71,57,141
3835,France,1932.0,28,8,6,42
3836,France,1924.0,37,51,32,120
3837,France,1928.0,14,24,14,52
3838,France,1928.0,14,24,14,52
3839,France,1932.0,28,8,6,42
3840,France,1932.0,28,8,6,42
3841,France,1936.0,13,13,19,45
3842,France,1920.0,13,71,57,141
3843,France,1920.0,13,71,57,141
3844,France,1948.0,28,23,26,77
3845,France,2016.0,20,55,21,96
3846,France,1928.0,14,24,14,52
3847,France,2008.0,25,24,28,77
3848,France,1948.0,28,23,26,77
3849,France,1984.0,20,17,33,70
3850,France,1920.0,13,71,57,141
3851,France,1908.0,12,5,23,40
3852,Tritons Lillois-2,1900.0,52,101,82,235
3853,France,1920.0,13,71,57,141
3854,France,2016.0,20,55,21,96
3855,France,1980.0,18,5,7,30
3856,Sarcelle-3,1900.0,52,101,82,235
3857,France,1896.0,5,4,2,11
3858,France,1964.0,4,17,17,38
3859,Pupilles de Neptune de Lille #2-1,1900.0,52,101,82,235
3860,France,1994.0,0,1,10,11
3861,France,1998.0,2,1,12,15
3862,USFSA,1900.0,52,101,82,235
3863,France,1912.0,10,11,5,26
3864,France,1912.0,10,11,5,26
3865,France,1924.0,37,51,32,120
3866,France,2006.0,3,2,10,15
3867,France,1920.0,13,71,57,141
3868,France,1920.0,13,71,57,141
3869,France,1996.0,21,10,20,51
3870,France,1988.0,13,4,14,31
3871,France,2008.0,25,24,28,77
3872,France,1972.0,2,6,17,25
3873,France,1912.0,10,11,5,26
3874,France,1912.0,10,11,5,26
3875,France,1912.0,10,11,5,26
3876,France,1964.0,4,17,17,38
3877,France,1988.0,13,4,14,31
3878,France,1992.0,14,11,44,69
3879,France,1972.0,2,6,17,25
3880,France,1920.0,13,71,57,141
3881,France,1924.0,37,51,32,120
3882,Racing Club de France,1900.0,52,101,82,235
3883,France,1920.0,13,71,57,141
3884,France,1920.0,13,71,57,141
3885,France,1920.0,13,71,57,141
3886,France,1924.0,37,51,32,120
3887,France,1924.0,37,51,32,120
3888,France,1928.0,14,24,14,52
3889,France,1932.0,28,8,6,42
3890,France,1932.0,28,8,6,42
3891,France,1936.0,13,13,19,45
3892,Cercle de l'Aviron Roubaix-4,1900.0,52,101,82,235
3893,France,1920.0,13,71,57,141
3894,France,1900.0,52,101,82,235
3895,France,1984.0,20,17,33,70
3896,France,1924.0,37,51,32,120
3897,France,1932.0,28,8,6,42
3898,France,1932.0,28,8,6,42
3899,France,1936.0,13,13,19,45
3900,France,1900.0,52,101,82,235
3901,Racing Club de France,1900.0,52,101,82,235
3902,France,2000.0,22,30,14,66
3903,France,1956.0,7,13,13,33
3904,France,2014.0,4,4,10,18
3905,France,1964.0,4,17,17,38
3906,France,2008.0,25,24,28,77
3907,Quand-Mme-2,1900.0,52,101,82,235
3908,Quand-Mme-2,1900.0,52,101,82,235
3909,France,2008.0,25,24,28,77
3910,France,2012.0,30,30,22,82
3911,France,1984.0,20,17,33,70
3912,Cercle de l'Aviron Roubaix-4,1900.0,52,101,82,235
3913,France,1906.0,20,16,28,64
3914,France,1906.0,20,16,28,64
3915,France,1936.0,13,13,19,45
3916,France,1936.0,13,13,19,45
3917,France,1936.0,13,13,19,45
3918,France,1900.0,52,101,82,235
3919,Racing Club de France,1900.0,52,101,82,235
3920,France,2008.0,25,24,28,77
3921,France,1936.0,13,13,19,45
3922,France,1948.0,28,23,26,77
3923,France,2006.0,3,2,10,15
3924,France,1948.0,28,23,26,77
3925,France-1,2000.0,22,30,14,66
3926,France,1920.0,13,71,57,141
3927,France,1948.0,28,23,26,77
3928,France,1932.0,28,8,6,42
3929,France,1924.0,37,51,32,120
3930,France,1996.0,21,10,20,51
3931,France,2016.0,20,55,21,96
3932,France,1900.0,52,101,82,235
3933,France,1992.0,14,11,44,69
3934,France,1994.0,0,1,10,11
3935,Libellule de Paris,1900.0,52,101,82,235
3936,France,1996.0,21,10,20,51
3937,France,2000.0,22,30,14,66
3938,France,1956.0,7,13,13,33
3939,France,2016.0,20,55,21,96
3940,France,1972.0,2,6,17,25
3941,France,1924.0,37,51,32,120
3942,France-1,1924.0,37,51,32,120
3943,France,2008.0,25,24,28,77
3944,France,1956.0,7,13,13,33
3945,France,2016.0,20,55,21,96
3946,France,1984.0,20,17,33,70
3947,France,1908.0,12,5,23,40
3948,France,1912.0,10,11,5,26
3949,France,1912.0,10,11,5,26
3950,France,1924.0,37,51,32,120
3951,Racing Club de France,1900.0,52,101,82,235
3952,Union des Socits Franais de Sports Athletiques,1900.0,52,101,82,235
3953,France,1908.0,12,5,23,40
3954,France,1924.0,37,51,32,120
3955,France,2012.0,30,30,22,82
3956,France,1924.0,37,51,32,120
3957,France,1920.0,13,71,57,141
3958,France,1924.0,37,51,32,120
3959,France,1904.0,0,2,0,2
3960,Chicago Athletic Association,1904.0,0,2,0,2
3961,France,1928.0,14,24,14,52
3962,France,1948.0,28,23,26,77
3963,France,1996.0,21,10,20,51
3964,France,1936.0,13,13,19,45
3965,France,1948.0,28,23,26,77
3966,France,1900.0,52,101,82,235
3967,France,1988.0,13,4,14,31
3968,Pupilles de Neptune de Lille #2-1,1900.0,52,101,82,235
3969,France,1924.0,37,51,32,120
3970,France,1908.0,12,5,23,40
3971,France,1924.0,37,51,32,120
3972,France,2004.0,21,10,22,53
3973,France,1964.0,4,17,17,38
3974,France,1924.0,37,51,32,120
3975,France,1936.0,13,13,19,45
3976,France,1948.0,28,23,26,77
3977,France,1948.0,28,23,26,77
3978,France,1920.0,13,71,57,141
3979,France,1998.0,2,1,12,15
3980,France,1984.0,20,17,33,70
3981,France,1924.0,37,51,32,120
3982,France,1924.0,37,51,32,120
3983,France,1992.0,14,11,44,69
3984,France,1920.0,13,71,57,141
3985,France,1928.0,14,24,14,52
3986,France,2012.0,30,30,22,82
3987,France,2016.0,20,55,21,96
3988,France,1920.0,13,71,57,141
3989,France,2008.0,25,24,28,77
3990,France,1956.0,7,13,13,33
3991,France,1992.0,14,11,44,69
3992,France,1928.0,14,24,14,52
3993,France,2016.0,20,55,21,96
3994,France,2004.0,21,10,22,53
3995,France,2008.0,25,24,28,77
3996,France,1964.0,4,17,17,38
3997,France,2006.0,3,2,10,15
3998,France,1900.0,52,101,82,235
3999,France,1992.0,14,11,44,69
4000,France,1992.0,14,11,44,69
4001,France,1936.0,13,13,19,45
4002,France,1900.0,52,101,82,235
4003,France,1906.0,20,16,28,64
4004,France,1906.0,20,16,28,64
4005,France,1906.0,20,16,28,64
4006,France,1908.0,12,5,23,40
4007,France,1948.0,28,23,26,77
4008,France,1948.0,28,23,26,77
4009,France,1952.0,14,9,18,41
4010,France,1920.0,13,71,57,141
4011,France,1900.0,52,101,82,235
4012,Gwendoline-2,1900.0,52,101,82,235
4013,France-1,1900.0,52,101,82,235
4014,France,1900.0,52,101,82,235
4015,France,1906.0,20,16,28,64
4016,France,1906.0,20,16,28,64
4017,L'Aile VI,1928.0,14,24,14,52
4018,France,2006.0,3,2,10,15
4019,France,1924.0,37,51,32,120
4020,"BLO Polo Club, Rugby",1900.0,52,101,82,235
4021,France,1900.0,52,101,82,235
4022,France-1,1900.0,52,101,82,235
4023,France,1900.0,52,101,82,235
4024,"Bagatelle Polo Club, Paris",1900.0,52,101,82,235
4025,France,1920.0,13,71,57,141
4026,France,1972.0,2,6,17,25
4027,France,1976.0,5,7,9,21
4028,France,1924.0,37,51,32,120
4029,France,1956.0,7,13,13,33
4030,France,1992.0,14,11,44,69
4031,France,1948.0,28,23,26,77
4032,France,1948.0,28,23,26,77
4033,Quand-Mme-2,1900.0,52,101,82,235
4034,France,2008.0,25,24,28,77
4035,France,2012.0,30,30,22,82
4036,France,1924.0,37,51,32,120
4037,France,1906.0,20,16,28,64
4038,United States/France,1900.0,52,101,82,235
4039,France,1906.0,20,16,28,64
4040,France,1906.0,20,16,28,64
4041,France,1906.0,20,16,28,64
4042,France-3,1920.0,13,71,57,141
4043,France-3,1920.0,13,71,57,141
4044,Libellule de Paris,1900.0,52,101,82,235
4045,France,2000.0,22,30,14,66
4046,France,2016.0,20,55,21,96
4047,France,2002.0,5,5,5,15
4048,France,2006.0,3,2,10,15
4049,France,2006.0,3,2,10,15
4050,France,1924.0,37,51,32,120
4051,France,1956.0,7,13,13,33
4052,France,1906.0,20,16,28,64
4053,Socit Nautique de la Basse Seine-1,1906.0,20,16,28,64
4054,Socit Nautique de la Basse Seine-1,1906.0,20,16,28,64
4055,Socit Nautique de la Basse Seine-1,1906.0,20,16,28,64
4056,Socit Nautique de la Basse Seine-1,1906.0,20,16,28,64
4057,France,2008.0,25,24,28,77
4058,France,1924.0,37,51,32,120
4059,Cercle de l'Aviron Roubaix-4,1900.0,52,101,82,235
4060,France,1984.0,20,17,33,70
4061,France,1964.0,4,17,17,38
4062,France,1968.0,16,8,12,36
4063,Socit Nautique de la Basse Seine-1,1906.0,20,16,28,64
4064,France,1900.0,52,101,82,235
4065,Racing Club de France,1900.0,52,101,82,235
4066,France,1988.0,13,4,14,31
4067,France,1984.0,20,17,33,70
4068,France,1920.0,13,71,57,141
4069,France,1924.0,37,51,32,120
4070,Rowing Club Castillon-3,1900.0,52,101,82,235
4071,France,1920.0,13,71,57,141
4072,France,1900.0,52,101,82,235
4073,France,1920.0,13,71,57,141
4074,France,1908.0,12,5,23,40
4075,France,2016.0,20,55,21,96
4076,France,2000.0,22,30,14,66
4077,France,2006.0,3,2,10,15
4078,France,1948.0,28,23,26,77
4079,L'Aile VI,1928.0,14,24,14,52
4080,France,1936.0,13,13,19,45
4081,France,1948.0,28,23,26,77
4082,France,1924.0,37,51,32,120
4083,France,1936.0,13,13,19,45
4084,France,2008.0,25,24,28,77
4085,France,1948.0,28,23,26,77
4086,France,1920.0,13,71,57,141
4087,France,1924.0,37,51,32,120
4088,France,1920.0,13,71,57,141
4089,France,1900.0,52,101,82,235
4090,France,1906.0,20,16,28,64
4091,France,1906.0,20,16,28,64
4092,France,2000.0,22,30,14,66
4093,France,2000.0,22,30,14,66
4094,France,2012.0,30,30,22,82
4095,France,1906.0,20,16,28,64
4096,France,1906.0,20,16,28,64
4097,France,1906.0,20,16,28,64
4098,France,1968.0,16,8,12,36
4099,France,2008.0,25,24,28,77
4100,France,2012.0,30,30,22,82
4101,France,2000.0,22,30,14,66
4102,France,2016.0,20,55,21,96
4103,France,2008.0,25,24,28,77
4104,France,1948.0,28,23,26,77
4105,France,1948.0,28,23,26,77
4106,France,1948.0,28,23,26,77
4107,France,1952.0,14,9,18,41
4108,France,1952.0,14,9,18,41
4109,France,1956.0,7,13,13,33
4110,France,1956.0,7,13,13,33
4111,France,2008.0,25,24,28,77
4112,France,1924.0,37,51,32,120
4113,Mignon-3,1900.0,52,101,82,235
4114,France,2000.0,22,30,14,66
4115,France,1936.0,13,13,19,45
4116,France,2010.0,2,6,6,14
4117,France,2010.0,2,6,6,14
4118,Favorite-1,1900.0,52,101,82,235
4119,Favorite-1,1900.0,52,101,82,235
4120,France,1992.0,14,11,44,69
4121,France,1996.0,21,10,20,51
4122,France,2000.0,22,30,14,66
4123,France,1948.0,28,23,26,77
4124,France,1948.0,28,23,26,77
4125,France,1956.0,7,13,13,33
4126,France,1908.0,12,5,23,40
4127,France,1956.0,7,13,13,33
4128,France,1964.0,4,17,17,38
4129,France,1948.0,28,23,26,77
4130,France,1972.0,2,6,17,25
4131,France,1976.0,5,7,9,21
4132,France,1952.0,14,9,18,41
4133,Gitana-2,1900.0,52,101,82,235
4134,Gitana-2,1900.0,52,101,82,235
4135,France,1912.0,10,11,5,26
4136,Gitana-2,1900.0,52,101,82,235
4137,Gitana-2,1900.0,52,101,82,235
4138,France,2004.0,21,10,22,53
4139,France,2008.0,25,24,28,77
4140,France,2008.0,25,24,28,77
4141,Nina Claire-2,1900.0,52,101,82,235
4142,France,1984.0,20,17,33,70
4143,France,1992.0,14,11,44,69
4144,France-1,1992.0,14,11,44,69
4145,France-1,1992.0,14,11,44,69
4146,France,1920.0,13,71,57,141
4147,France,1920.0,13,71,57,141
4148,France,1924.0,37,51,32,120
4149,France,1924.0,37,51,32,120
4150,France,1924.0,37,51,32,120
4151,France,1924.0,37,51,32,120
4152,France,1924.0,37,51,32,120
4153,France,1928.0,14,24,14,52
4154,France,2004.0,21,10,22,53
4155,France,1912.0,10,11,5,26
4156,France,1924.0,37,51,32,120
4157,France,1928.0,14,24,14,52
4158,France,1936.0,13,13,19,45
4159,France,2012.0,30,30,22,82
4160,France,1960.0,1,6,8,15
4161,France,2000.0,22,30,14,66
4162,USFSA,1900.0,52,101,82,235
4163,France,1924.0,37,51,32,120
4164,France,1948.0,28,23,26,77
4165,France,1948.0,28,23,26,77
4166,France,1924.0,37,51,32,120
4167,France,1964.0,4,17,17,38
4168,France,1988.0,13,4,14,31
4169,France,1988.0,13,4,14,31
4170,France,1960.0,1,6,8,15
4171,France,1920.0,13,71,57,141
4172,France,1994.0,0,1,10,11
4173,France,1900.0,52,101,82,235
4174,Martha-1,1900.0,52,101,82,235
4175,Martha-1,1900.0,52,101,82,235
4176,France,1920.0,13,71,57,141
4177,France,1932.0,28,8,6,42
4178,France,2014.0,4,4,10,18
4179,France,1936.0,13,13,19,45
4180,France,1948.0,28,23,26,77
4181,Socit Nautique de la Basse Seine-1,1906.0,20,16,28,64
4182,France,2016.0,20,55,21,96
4183,France,1928.0,14,24,14,52
4184,France,1920.0,13,71,57,141
4185,France,1920.0,13,71,57,141
4186,France,2012.0,30,30,22,82
4187,France,1952.0,14,9,18,41
4188,France,2008.0,25,24,28,77
4189,France,1920.0,13,71,57,141
4190,France,1920.0,13,71,57,141
4191,France,1920.0,13,71,57,141
4192,France,1996.0,21,10,20,51
4193,France,1996.0,21,10,20,51
4194,France,1992.0,14,11,44,69
4195,France,1996.0,21,10,20,51
4196,France,2000.0,22,30,14,66
4197,France,2004.0,21,10,22,53
4198,France,2012.0,30,30,22,82
4199,France,1924.0,37,51,32,120
4200,France,2012.0,30,30,22,82
4201,France,1948.0,28,23,26,77
4202,France,1996.0,21,10,20,51
4203,France,2016.0,20,55,21,96
4204,France,1912.0,10,11,5,26
4205,France,1992.0,14,11,44,69
4206,France,1968.0,16,8,12,36
4207,France,1968.0,16,8,12,36
4208,Pupilles de Neptune de Lille #2-1,1900.0,52,101,82,235
4209,France,2012.0,30,30,22,82
4210,France,1996.0,21,10,20,51
4211,France,1920.0,13,71,57,141
4212,France,1906.0,20,16,28,64
4213,France,1920.0,13,71,57,141
4214,France,1920.0,13,71,57,141
4215,France,1920.0,13,71,57,141
4216,France,1948.0,28,23,26,77
4217,France,1908.0,12,5,23,40
4218,France,2004.0,21,10,22,53
4219,France,1968.0,16,8,12,36
4220,France,2012.0,30,30,22,82
4221,France,2008.0,25,24,28,77
4222,France,2012.0,30,30,22,82
4223,France,2000.0,22,30,14,66
4224,France,1920.0,13,71,57,141
4225,France,1920.0,13,71,57,141
4226,France,1920.0,13,71,57,141
4227,France,2004.0,21,10,22,53
4228,Pupilles de Neptune de Lille #2-1,1900.0,52,101,82,235
4229,France,1900.0,52,101,82,235
4230,France,1928.0,14,24,14,52
4231,France,1896.0,5,4,2,11
4232,France,1896.0,5,4,2,11
4233,France,1896.0,5,4,2,11
4234,France,1976.0,5,7,9,21
4235,France,1980.0,18,5,7,30
4236,France,1994.0,0,1,10,11
4237,France,1996.0,21,10,20,51
4238,France,1996.0,21,10,20,51
4239,France,2000.0,22,30,14,66
4240,France,2004.0,21,10,22,53
4241,France,2004.0,21,10,22,53
4242,France,1992.0,14,11,44,69
4243,France,2008.0,25,24,28,77
4244,France,1992.0,14,11,44,69
4245,France,2000.0,22,30,14,66
4246,France,1920.0,13,71,57,141
4247,France-1,1992.0,14,11,44,69
4248,France-1,1996.0,21,10,20,51
4249,France,1906.0,20,16,28,64
4250,France,1906.0,20,16,28,64
4251,France,1906.0,20,16,28,64
4252,France,1998.0,2,1,12,15
4253,France,1984.0,20,17,33,70
4254,France,1936.0,13,13,19,45
4255,France,2010.0,2,6,6,14
4256,France,2014.0,4,4,10,18
4257,France,2014.0,4,4,10,18
4258,France,2014.0,4,4,10,18
4259,France,1932.0,28,8,6,42
4260,"Bagatelle Polo Club, Paris",1900.0,52,101,82,235
4261,France,1932.0,28,8,6,42
4262,France,1928.0,14,24,14,52
4263,USFSA,1900.0,52,101,82,235
4264,Socit Nautique de la Basse Seine-1,1906.0,20,16,28,64
4265,Socit Nautique de la Basse Seine-1,1906.0,20,16,28,64
4266,France,1920.0,13,71,57,141
4267,France,1928.0,14,24,14,52
4268,France,1920.0,13,71,57,141
4269,France,2000.0,22,30,14,66
4270,France,1996.0,21,10,20,51
4271,France,2014.0,4,4,10,18
4272,USFSA,1900.0,52,101,82,235
4273,France,1924.0,37,51,32,120
4274,France,1996.0,21,10,20,51
4275,France,1920.0,13,71,57,141
4276,France,1948.0,28,23,26,77
4277,France,1948.0,28,23,26,77
4278,France,2000.0,22,30,14,66
4279,France,2004.0,21,10,22,53
4280,France,1924.0,37,51,32,120
4281,France,1924.0,37,51,32,120
4282,France,1952.0,14,9,18,41
4283,France,1976.0,5,7,9,21
4284,France,1984.0,20,17,33,70
4285,France,1980.0,18,5,7,30
4286,France,1992.0,14,11,44,69
4287,France,1936.0,13,13,19,45
4288,France,1932.0,28,8,6,42
4289,France,1936.0,13,13,19,45
4290,France,1936.0,13,13,19,45
4291,France,1900.0,52,101,82,235
4292,France,2016.0,20,55,21,96
4293,France,1956.0,7,13,13,33
4294,USFSA,1900.0,52,101,82,235
4295,France-2,2012.0,30,30,22,82
4296,France,1992.0,14,11,44,69
4297,France-1,2000.0,22,30,14,66
4298,France,1900.0,52,101,82,235
4299,France,1920.0,13,71,57,141
4300,France,1924.0,37,51,32,120
4301,France,1924.0,37,51,32,120
4302,France,1928.0,14,24,14,52
4303,France,1928.0,14,24,14,52
4304,France,1928.0,14,24,14,52
4305,France,1992.0,14,11,44,69
4306,Namoussa,1924.0,37,51,32,120
4307,Union des Socits Franais de Sports Athletiques,1900.0,52,101,82,235
4308,France,1952.0,14,9,18,41
4309,France,2002.0,5,5,5,15
4310,Pupilles de Neptune de Lille #2-1,1900.0,52,101,82,235
4311,France,1964.0,4,17,17,38
4312,France,2000.0,22,30,14,66
4313,France,2004.0,21,10,22,53
4314,France,1924.0,37,51,32,120
4315,France,1936.0,13,13,19,45
4316,France,1936.0,13,13,19,45
4317,France,2016.0,20,55,21,96
4318,France,1924.0,37,51,32,120
4319,France,1906.0,20,16,28,64
4320,France,1906.0,20,16,28,64
4321,France,1912.0,10,11,5,26
4322,Baby-1,1900.0,52,101,82,235
4323,Baby-1,1900.0,52,101,82,235
4324,France,1956.0,7,13,13,33
4325,France,1956.0,7,13,13,33
4326,Femur-1,1900.0,52,101,82,235
4327,France,2008.0,25,24,28,77
4328,France,2012.0,30,30,22,82
4329,France,2008.0,25,24,28,77
4330,France,2012.0,30,30,22,82
4331,France,1936.0,13,13,19,45
4332,France,2008.0,25,24,28,77
4333,France,2012.0,30,30,22,82
4334,France,2016.0,20,55,21,96
4335,France,1920.0,13,71,57,141
4336,France,1996.0,21,10,20,51
4337,Namoussa,1924.0,37,51,32,120
4338,France,1948.0,28,23,26,77
4339,Smyrna,1906.0,20,16,28,64
4340,Smyrna,1906.0,20,16,28,64
4341,France,2008.0,25,24,28,77
4342,France,1932.0,28,8,6,42
4343,Union des Socits Franais de Sports Athletiques,1900.0,52,101,82,235
4344,France,1968.0,16,8,12,36
4345,France,2016.0,20,55,21,96
4346,France,2012.0,30,30,22,82
4347,France,1912.0,10,11,5,26
4348,France,1912.0,10,11,5,26
4349,France,2012.0,30,30,22,82
4350,France,1920.0,13,71,57,141
4351,France,1992.0,14,11,44,69
4352,France,2012.0,30,30,22,82
4353,Favorite-1,1900.0,52,101,82,235
4354,Favorite-1,1900.0,52,101,82,235
4355,France,1964.0,4,17,17,38
4356,France,1964.0,4,17,17,38
4357,France,1964.0,4,17,17,38
4358,France,1964.0,4,17,17,38
4359,France,1968.0,16,8,12,36
4360,France,2004.0,21,10,22,53
4361,France,2012.0,30,30,22,82
4362,France,1906.0,20,16,28,64
4363,Racing Club de France,1900.0,52,101,82,235
4364,Union des Socits Franais de Sports Athletiques,1900.0,52,101,82,235
4365,France,1924.0,37,51,32,120
4366,France,1964.0,4,17,17,38
4367,France,1996.0,21,10,20,51
4368,France,1924.0,37,51,32,120
4369,France,1936.0,13,13,19,45
4370,France,1936.0,13,13,19,45
4371,France,1920.0,13,71,57,141
4372,France,1924.0,37,51,32,120
4373,France,1924.0,37,51,32,120
4374,France,2000.0,22,30,14,66
4375,France,2000.0,22,30,14,66
4376,France,1956.0,7,13,13,33
4377,France,2012.0,30,30,22,82
4378,USFSA,1900.0,52,101,82,235
4379,France,1984.0,20,17,33,70
4380,France,1992.0,14,11,44,69
4381,France,1896.0,5,4,2,11
4382,France,1908.0,12,5,23,40
4383,France,2016.0,20,55,21,96
4384,France,1920.0,13,71,57,141
4385,France,1924.0,37,51,32,120
4386,France,1908.0,12,5,23,40
4387,France,1920.0,13,71,57,141
4388,France,1920.0,13,71,57,141
4389,France,1920.0,13,71,57,141
4390,France,1984.0,20,17,33,70
4391,France,1992.0,14,11,44,69
4392,France,1994.0,0,1,10,11
4393,France,2012.0,30,30,22,82
4394,France,1900.0,52,101,82,235
4395,France,2016.0,20,55,21,96
4396,France,2016.0,20,55,21,96
4397,France,1968.0,16,8,12,36
4398,France,2008.0,25,24,28,77
4399,France,2008.0,25,24,28,77
4400,France,2012.0,30,30,22,82
4401,France,1948.0,28,23,26,77
4402,Namoussa,1924.0,37,51,32,120
4403,Gitana-2,1900.0,52,101,82,235
4404,Gitana-2,1900.0,52,101,82,235
4405,Gitana-2,1900.0,52,101,82,235
4406,Gitana-2,1900.0,52,101,82,235
4407,France,2000.0,22,30,14,66
4408,France,1984.0,20,17,33,70
4409,France,1992.0,14,11,44,69
4410,France,2008.0,25,24,28,77
4411,France,2012.0,30,30,22,82
4412,France,2016.0,20,55,21,96
4413,France,1968.0,16,8,12,36
4414,France,1956.0,7,13,13,33
4415,France,1992.0,14,11,44,69
4416,France,1998.0,2,1,12,15
4417,France,1920.0,13,71,57,141
4418,France,1920.0,13,71,57,141
4419,France,1948.0,28,23,26,77
4420,Gitana-2,1900.0,52,101,82,235
4421,Gitana-2,1900.0,52,101,82,235
4422,France,1952.0,14,9,18,41
4423,France,1956.0,7,13,13,33
4424,France,1964.0,4,17,17,38
4425,France,1992.0,14,11,44,69
4426,France,1998.0,2,1,12,15
4427,France,2000.0,22,30,14,66
4428,France,2004.0,21,10,22,53
4429,France,1968.0,16,8,12,36
4430,Socit Nautique de Bayonne-1,1906.0,20,16,28,64
4431,Socit Nautique de Bayonne-2,1906.0,20,16,28,64
4432,France,1924.0,37,51,32,120
4433,France,1924.0,37,51,32,120
4434,France,1948.0,28,23,26,77
4435,France,2004.0,21,10,22,53
4436,France,1924.0,37,51,32,120
4437,France,1992.0,14,11,44,69
4438,France,2012.0,30,30,22,82
4439,Cercle de l'Aviron Roubaix-4,1900.0,52,101,82,235
4440,France,1984.0,20,17,33,70
4441,France,1948.0,28,23,26,77
4442,France,1900.0,52,101,82,235
4443,France,1988.0,13,4,14,31
4444,France,1992.0,14,11,44,69
4445,France,1984.0,20,17,33,70
4446,France,1988.0,13,4,14,31
4447,France,1992.0,14,11,44,69
4448,France,1996.0,21,10,20,51
4449,France,1976.0,5,7,9,21
4450,L'Aile VI,1928.0,14,24,14,52
4451,France,1920.0,13,71,57,141
4452,France,1924.0,37,51,32,120
4453,France,1900.0,52,101,82,235
4454,France,1900.0,52,101,82,235
4455,France,1920.0,13,71,57,141
4456,Union des Socits Franais de Sports Athletiques,1900.0,52,101,82,235
4457,France,1924.0,37,51,32,120
4458,France,1994.0,0,1,10,11
4459,France,1920.0,13,71,57,141
4460,France,1924.0,37,51,32,120
4461,France,1924.0,37,51,32,120
4462,France,2000.0,22,30,14,66
4463,Tritons Lillois-2,1900.0,52,101,82,235
4464,Tritons Lillois-2,1900.0,52,101,82,235
4465,France,1920.0,13,71,57,141
4466,France,2012.0,30,30,22,82
4467,France,2016.0,20,55,21,96
4468,France,1998.0,2,1,12,15
4469,France,1928.0,14,24,14,52
4470,France,1932.0,28,8,6,42
4471,France,1936.0,13,13,19,45
4472,France,2016.0,20,55,21,96
4473,France,2016.0,20,55,21,96
4474,France,1984.0,20,17,33,70
4475,France,1992.0,14,11,44,69
4476,France,1924.0,37,51,32,120
4477,France,1948.0,28,23,26,77
4478,Martha-1,1900.0,52,101,82,235
4479,Martha-1,1900.0,52,101,82,235
4480,France,2004.0,21,10,22,53
4481,USFSA,1900.0,52,101,82,235
4482,France,1924.0,37,51,32,120
4483,France,1948.0,28,23,26,77
4484,France,1952.0,14,9,18,41
4485,France,1924.0,37,51,32,120
4486,France,2010.0,2,6,6,14
4487,France,2010.0,2,6,6,14
4488,France,1960.0,1,6,8,15
4489,Gwendoline-2,1900.0,52,101,82,235
4490,France,2004.0,21,10,22,53
4491,France,2008.0,25,24,28,77
4492,France,2008.0,25,24,28,77
4493,France,2004.0,21,10,22,53
4494,France,2008.0,25,24,28,77
4495,France,1984.0,20,17,33,70
4496,France,2016.0,20,55,21,96
4497,France,1996.0,21,10,20,51
4498,France,1924.0,37,51,32,120
4499,France,1900.0,52,101,82,235
4500,France,1900.0,52,101,82,235
4501,France,1908.0,12,5,23,40
4502,France,1920.0,13,71,57,141
4503,France,1920.0,13,71,57,141
4504,France,2012.0,30,30,22,82
4505,Smyrna,1906.0,20,16,28,64
4506,France,1980.0,18,5,7,30
4507,France,1980.0,18,5,7,30
4508,France,1984.0,20,17,33,70
4509,France,1952.0,14,9,18,41
4510,France,1964.0,4,17,17,38
4511,France,1964.0,4,17,17,38
4512,France,1968.0,16,8,12,36
4513,France,2010.0,2,6,6,14
4514,France,2004.0,21,10,22,53
4515,France,1932.0,28,8,6,42
4516,France,1932.0,28,8,6,42
4517,France,1936.0,13,13,19,45
4518,France,1948.0,28,23,26,77
4519,France,1948.0,28,23,26,77
4520,France,1952.0,14,9,18,41
4521,France,2000.0,22,30,14,66
4522,France,2016.0,20,55,21,96
4523,France,2008.0,25,24,28,77
4524,France,2012.0,30,30,22,82
4525,France,2016.0,20,55,21,96
4526,France,2008.0,25,24,28,77
4527,France,2012.0,30,30,22,82
4528,France,1928.0,14,24,14,52
4529,France,2004.0,21,10,22,53
4530,France,2008.0,25,24,28,77
4531,France,1972.0,2,6,17,25
4532,France,1948.0,28,23,26,77
4533,France,1968.0,16,8,12,36
4534,France,1968.0,16,8,12,36
4535,France,1968.0,16,8,12,36
4536,France,1920.0,13,71,57,141
4537,France,2004.0,21,10,22,53
4538,France,1900.0,52,101,82,235
4539,France,2016.0,20,55,21,96
4540,France,1960.0,1,6,8,15
4541,France,1948.0,28,23,26,77
4542,France,1996.0,21,10,20,51
4543,France,1920.0,13,71,57,141
4544,France,1924.0,37,51,32,120
4545,France,1924.0,37,51,32,120
4546,France,1928.0,14,24,14,52
4547,France,1920.0,13,71,57,141
4548,France,2012.0,30,30,22,82
4549,France,1984.0,20,17,33,70
4550,France-2,1924.0,37,51,32,120
4551,France,2016.0,20,55,21,96
4552,France,1964.0,4,17,17,38
4553,France,1972.0,2,6,17,25
4554,France,1928.0,14,24,14,52
4555,France,2016.0,20,55,21,96
4556,France,1920.0,13,71,57,141
4557,France,1964.0,4,17,17,38
4558,France,1928.0,14,24,14,52
4559,France,1928.0,14,24,14,52
4560,USFSA,1900.0,52,101,82,235
4561,France,1984.0,20,17,33,70
4562,France,1984.0,20,17,33,70
4563,France,1988.0,13,4,14,31
4564,France,1992.0,14,11,44,69
4565,France,1992.0,14,11,44,69
4566,France,2010.0,2,6,6,14
4567,France,1928.0,14,24,14,52
4568,France,2016.0,20,55,21,96
4569,France,2006.0,3,2,10,15
4570,France,1936.0,13,13,19,45
4571,France,1936.0,13,13,19,45
4572,France,1936.0,13,13,19,45
4573,France,1908.0,12,5,23,40
4574,Socit Nautique de Bayonne-2,1906.0,20,16,28,64
4575,Union des Socits Franais de Sports Athletiques,1900.0,52,101,82,235
4576,France,1952.0,14,9,18,41
4577,France,1906.0,20,16,28,64
4578,France,1924.0,37,51,32,120
4579,France,1948.0,28,23,26,77
4580,France,1952.0,14,9,18,41
4581,France,1956.0,7,13,13,33
4582,France,1992.0,14,11,44,69
4583,France,1976.0,5,7,9,21
4584,France,1980.0,18,5,7,30
4585,France,1984.0,20,17,33,70
4586,France,1952.0,14,9,18,41
4587,Libellule de Paris,1900.0,52,101,82,235
4588,France,1900.0,52,101,82,235
4589,France,1994.0,0,1,10,11
4590,France,1924.0,37,51,32,120
4591,France,1924.0,37,51,32,120
4592,France,2012.0,30,30,22,82
4593,France,2016.0,20,55,21,96
4594,France,2012.0,30,30,22,82
4595,France,2012.0,30,30,22,82
4596,Crabe II-1,1900.0,52,101,82,235
4597,Crabe II-4,1900.0,52,101,82,235
4598,France,1998.0,2,1,12,15
4599,France,2016.0,20,55,21,96
4600,France,2008.0,25,24,28,77
4601,France,1988.0,13,4,14,31
4602,France,1960.0,1,6,8,15
4603,France,1932.0,28,8,6,42
4604,Olle,1900.0,52,101,82,235
4605,Olle,1900.0,52,101,82,235
4606,France,1936.0,13,13,19,45
4607,France,2016.0,20,55,21,96
4608,France,2004.0,21,10,22,53
4609,France,1960.0,1,6,8,15
4610,France,1980.0,18,5,7,30
4611,France,2000.0,22,30,14,66
4612,France,1932.0,28,8,6,42
4613,France,1956.0,7,13,13,33
4614,France,1924.0,37,51,32,120
4615,France,2016.0,20,55,21,96
4616,France,1900.0,52,101,82,235
4617,France,1900.0,52,101,82,235
4618,France,1906.0,20,16,28,64
4619,France,1906.0,20,16,28,64
4620,France,1906.0,20,16,28,64
4621,France,1908.0,12,5,23,40
4622,France,1908.0,12,5,23,40
4623,France,1996.0,21,10,20,51
4624,France,1924.0,37,51,32,120
4625,France,1928.0,14,24,14,52
4626,Union des Socits Franais de Sports Athletiques,1900.0,52,101,82,235
4627,France,1964.0,4,17,17,38
4628,France,1968.0,16,8,12,36
4629,France,2012.0,30,30,22,82
4630,France,2012.0,30,30,22,82
4631,France,2004.0,21,10,22,53
4632,France,2008.0,25,24,28,77
4633,France,1952.0,14,9,18,41
4634,France,2016.0,20,55,21,96
4635,France,1984.0,20,17,33,70
4636,France,1952.0,14,9,18,41
4637,France,1960.0,1,6,8,15
4638,France,1964.0,4,17,17,38
4639,France,2004.0,21,10,22,53
4640,France,2012.0,30,30,22,82
4641,France,1912.0,10,11,5,26
4642,France,1920.0,13,71,57,141
4643,France,2012.0,30,30,22,82
4644,France,2016.0,20,55,21,96
4645,France,2016.0,20,55,21,96
4646,France,1932.0,28,8,6,42
4647,France,1936.0,13,13,19,45
4648,France,1984.0,20,17,33,70
4649,France,1920.0,13,71,57,141
4650,France-3,1920.0,13,71,57,141
4651,France,1920.0,13,71,57,141
4652,France,1984.0,20,17,33,70
4653,France,1988.0,13,4,14,31
4654,France,1948.0,28,23,26,77
4655,France,1924.0,37,51,32,120
4656,France,2016.0,20,55,21,96
4657,France,2012.0,30,30,22,82
4658,France,1896.0,5,4,2,11
4659,France,1996.0,21,10,20,51
4660,France,1920.0,13,71,57,141
4661,France,1920.0,13,71,57,141
4662,France,1920.0,13,71,57,141
4663,France,1924.0,37,51,32,120
4664,France,1932.0,28,8,6,42
4665,France,1932.0,28,8,6,42
4666,L'Aile VI,1928.0,14,24,14,52
4667,L'Aile VI,1928.0,14,24,14,52
4668,France,1920.0,13,71,57,141
4669,Pupilles de Neptune de Lille-1,1900.0,52,101,82,235
4670,France,1920.0,13,71,57,141
4671,France,1952.0,14,9,18,41
4672,France,2008.0,25,24,28,77
4673,France,2008.0,25,24,28,77
4674,France,2012.0,30,30,22,82
4675,France,2012.0,30,30,22,82
4676,France,1924.0,37,51,32,120
4677,France,2016.0,20,55,21,96
4678,France,2000.0,22,30,14,66
4679,France,1956.0,7,13,13,33
4680,France,2000.0,22,30,14,66
4681,Quand-Mme-2,1900.0,52,101,82,235
4682,Quand-Mme-2,1900.0,52,101,82,235
4683,France,1924.0,37,51,32,120
4684,France,1908.0,12,5,23,40
4685,France,1908.0,12,5,23,40
4686,France,1920.0,13,71,57,141
4687,France,1920.0,13,71,57,141
4688,France,1924.0,37,51,32,120
4689,France,1908.0,12,5,23,40
4690,France-1,2012.0,30,30,22,82
4691,France,2012.0,30,30,22,82
4692,France,1992.0,14,11,44,69
4693,France,1992.0,14,11,44,69
4694,France,1996.0,21,10,20,51
4695,France,1996.0,21,10,20,51
4696,France,2000.0,22,30,14,66
4697,France,2008.0,25,24,28,77
4698,France,2008.0,25,24,28,77
4699,France,1920.0,13,71,57,141
4700,France,1924.0,37,51,32,120
4701,France,2016.0,20,55,21,96
4702,France,1906.0,20,16,28,64
4703,Club Nautique de Lyon-2,1900.0,52,101,82,235
4704,France,1948.0,28,23,26,77
4705,France,1992.0,14,11,44,69
4706,France,2004.0,21,10,22,53
4707,France,1920.0,13,71,57,141
4708,France,1920.0,13,71,57,141
4709,France,1920.0,13,71,57,141
4710,USFSA,1900.0,52,101,82,235
4711,France,1964.0,4,17,17,38
4712,France,1964.0,4,17,17,38
4713,France,1968.0,16,8,12,36
4714,France,1972.0,2,6,17,25
4715,France,2016.0,20,55,21,96
4716,France,1992.0,14,11,44,69
4717,France,1984.0,20,17,33,70
4718,France,1952.0,14,9,18,41
4719,France,2008.0,25,24,28,77
4720,France,2012.0,30,30,22,82
4721,France,2012.0,30,30,22,82
4722,France,2016.0,20,55,21,96
4723,France,2016.0,20,55,21,96
4724,France,2004.0,21,10,22,53
4725,France,2004.0,21,10,22,53
4726,France,2004.0,21,10,22,53
4727,France,1924.0,37,51,32,120
4728,France,1924.0,37,51,32,120
4729,France,2004.0,21,10,22,53
4730,France,2014.0,4,4,10,18
4731,Nina Claire-2,1900.0,52,101,82,235
4732,France,2000.0,22,30,14,66
4733,Pupilles de Neptune de Lille #2-1,1900.0,52,101,82,235
4734,France,1928.0,14,24,14,52
4735,France,1928.0,14,24,14,52
4736,France,1924.0,37,51,32,120
4737,Crabe II-1,1900.0,52,101,82,235
4738,Crabe II-4,1900.0,52,101,82,235
4739,France,2016.0,20,55,21,96
4740,France,1920.0,13,71,57,141
4741,France,2002.0,5,5,5,15
4742,France,1988.0,13,4,14,31
4743,France,1928.0,14,24,14,52
4744,France,1932.0,28,8,6,42
4745,France,1932.0,28,8,6,42
4746,France,1920.0,13,71,57,141
4747,France,1960.0,1,6,8,15
4748,France,1906.0,20,16,28,64
4749,Pupilles de Neptune de Lille #2-1,1900.0,52,101,82,235
4750,France,1900.0,52,101,82,235
4751,Pupilles de Neptune de Lille-1,1900.0,52,101,82,235
4752,Crabe II-1,1900.0,52,101,82,235
4753,Crabe II-4,1900.0,52,101,82,235
4754,Societ Nautique de la Marne-1,1900.0,52,101,82,235
4755,France,1996.0,21,10,20,51
4756,France,2000.0,22,30,14,66
4757,France,2014.0,4,4,10,18
4758,France,1924.0,37,51,32,120
4759,France,1992.0,14,11,44,69
4760,France,1998.0,2,1,12,15
4761,France,1906.0,20,16,28,64
4762,France,1920.0,13,71,57,141
4763,France,1920.0,13,71,57,141
4764,France,1928.0,14,24,14,52
4765,France,1900.0,52,101,82,235
4766,France,1896.0,5,4,2,11
4767,France,1896.0,5,4,2,11
4768,France,1896.0,5,4,2,11
4769,Socit Nautique de Bayonne-1,1906.0,20,16,28,64
4770,Socit Nautique de Bayonne-2,1906.0,20,16,28,64
4771,France,1936.0,13,13,19,45
4772,France,2014.0,4,4,10,18
4773,France,2004.0,21,10,22,53
4774,France,1972.0,2,6,17,25
4775,France,1924.0,37,51,32,120
4776,France,2016.0,20,55,21,96
4777,France,1948.0,28,23,26,77
4778,France,1992.0,14,11,44,69
4779,France,1992.0,14,11,44,69
4780,France,2008.0,25,24,28,77
4781,France,2012.0,30,30,22,82
4782,France,2016.0,20,55,21,96
4783,France,1928.0,14,24,14,52
4784,France,1906.0,20,16,28,64
4785,France,1912.0,10,11,5,26
4786,Scamasaxe-2,1900.0,52,101,82,235
4787,Scamasaxe-3,1900.0,52,101,82,235
4788,Pupilles de Neptune de Lille #2-1,1900.0,52,101,82,235
4789,Pupilles de Neptune de Lille-1,1900.0,52,101,82,235
4790,France,1900.0,52,101,82,235
4791,France,1952.0,14,9,18,41
4792,France,1956.0,7,13,13,33
4793,France,1900.0,52,101,82,235
4794,France,1992.0,14,11,44,69
4795,France,2004.0,21,10,22,53
4796,France,2004.0,21,10,22,53
4797,France,2016.0,20,55,21,96
4798,France,1912.0,10,11,5,26
4799,France,1984.0,20,17,33,70
4800,France,2016.0,20,55,21,96
4801,Favorite-1,1900.0,52,101,82,235
4802,Favorite-1,1900.0,52,101,82,235
4803,France,1924.0,37,51,32,120
4804,Turquoise-1,1900.0,52,101,82,235
4805,Scamasaxe-2,1900.0,52,101,82,235
4806,Scamasaxe-3,1900.0,52,101,82,235
4807,France,1936.0,13,13,19,45
4808,France,2014.0,4,4,10,18
4809,France,2016.0,20,55,21,96
4810,France,1900.0,52,101,82,235
4811,France,1948.0,28,23,26,77
4812,France,1952.0,14,9,18,41
4813,France,1952.0,14,9,18,41
4814,France,1956.0,7,13,13,33
4815,France,1998.0,2,1,12,15
4816,France,1968.0,16,8,12,36
4817,France,2014.0,4,4,10,18
4818,France,2012.0,30,30,22,82
4819,France,1984.0,20,17,33,70
4820,France,1906.0,20,16,28,64
4821,France,1948.0,28,23,26,77
4822,Namoussa,1924.0,37,51,32,120
4823,France,1996.0,21,10,20,51
4824,Rose Pompon,1920.0,13,71,57,141
4825,France,1996.0,21,10,20,51
4826,France,1920.0,13,71,57,141
4827,France,1924.0,37,51,32,120
4828,Sarcelle-3,1900.0,52,101,82,235
4829,France,1932.0,28,8,6,42
4830,France,1992.0,14,11,44,69
4831,France,2002.0,5,5,5,15
4832,France,1996.0,21,10,20,51
4833,France,1920.0,13,71,57,141
4834,France,1952.0,14,9,18,41
4835,France,1900.0,52,101,82,235
4836,France,1900.0,52,101,82,235
4837,France,1906.0,20,16,28,64
4838,France,1906.0,20,16,28,64
4839,France,1906.0,20,16,28,64
4840,France,1906.0,20,16,28,64
4841,France,1906.0,20,16,28,64
4842,France,1952.0,14,9,18,41
4843,France,1964.0,4,17,17,38
4844,France,1960.0,1,6,8,15
4845,France,1964.0,4,17,17,38
4846,France,1964.0,4,17,17,38
4847,France,1968.0,16,8,12,36
4848,France,1968.0,16,8,12,36
4849,France,1972.0,2,6,17,25
4850,France,1976.0,5,7,9,21
4851,France,1996.0,21,10,20,51
4852,France,1988.0,13,4,14,31
4853,France,2008.0,25,24,28,77
4854,France,2012.0,30,30,22,82
4855,France,1968.0,16,8,12,36
4856,France,2016.0,20,55,21,96
4857,France,1956.0,7,13,13,33
4858,France,1900.0,52,101,82,235
4859,France,1932.0,28,8,6,42
4860,France,1972.0,2,6,17,25
4861,France,1920.0,13,71,57,141
4862,France,1956.0,7,13,13,33
4863,France,2012.0,30,30,22,82
4864,France,2012.0,30,30,22,82
4865,France,2012.0,30,30,22,82
4866,France,1992.0,14,11,44,69
4867,France,1900.0,52,101,82,235
4868,France,1976.0,5,7,9,21
4869,France,1980.0,18,5,7,30
4870,France,2008.0,25,24,28,77
4871,France,2012.0,30,30,22,82
4872,France,2016.0,20,55,21,96
4873,France,1992.0,14,11,44,69
4874,France,2012.0,30,30,22,82
4875,France,1952.0,14,9,18,41
4876,France,1956.0,7,13,13,33
4877,France,2016.0,20,55,21,96
4878,France,2016.0,20,55,21,96
4879,France,2016.0,20,55,21,96
4880,France,2016.0,20,55,21,96
4881,France,1956.0,7,13,13,33
4882,France,1992.0,14,11,44,69
4883,France,1994.0,0,1,10,11
4884,France,2016.0,20,55,21,96
4885,France,2004.0,21,10,22,53
4886,France,2004.0,21,10,22,53
4887,France,1964.0,4,17,17,38
4888,France,1968.0,16,8,12,36
4889,France,1972.0,2,6,17,25
4890,France,1972.0,2,6,17,25
4891,France,1976.0,5,7,9,21
4892,France,1952.0,14,9,18,41
4893,France,1924.0,37,51,32,120
4894,France,1960.0,1,6,8,15
4895,France,1992.0,14,11,44,69
4896,France,1984.0,20,17,33,70
4897,France,2016.0,20,55,21,96
4898,France,2016.0,20,55,21,96
4899,France,2000.0,22,30,14,66
4900,France,2000.0,22,30,14,66
4901,France,2004.0,21,10,22,53
4902,France,1948.0,28,23,26,77
4903,France,1908.0,12,5,23,40
4904,France,1908.0,12,5,23,40
4905,Union des Socits Franais de Sports Athletiques,1900.0,52,101,82,235
4906,France,2016.0,20,55,21,96
4907,France,1972.0,2,6,17,25
4908,France,1972.0,2,6,17,25
4909,France,2008.0,25,24,28,77
4910,France,2012.0,30,30,22,82
4911,France,2016.0,20,55,21,96
4912,France,1984.0,20,17,33,70
4913,France,1992.0,14,11,44,69
4914,France,1948.0,28,23,26,77
4915,France,1948.0,28,23,26,77
4916,France,1948.0,28,23,26,77
4917,France,1948.0,28,23,26,77
4918,France,1948.0,28,23,26,77
4919,France,1948.0,28,23,26,77
4920,France,1988.0,13,4,14,31
4921,France,2016.0,20,55,21,96
4922,France,2016.0,20,55,21,96
4923,France,1928.0,14,24,14,52
4924,France,1932.0,28,8,6,42
4925,France,1948.0,28,23,26,77
4926,France,1924.0,37,51,32,120
4927,France,1928.0,14,24,14,52
4928,France,1972.0,2,6,17,25
4929,France,1972.0,2,6,17,25
4930,France,2000.0,22,30,14,66
4931,France,1980.0,18,5,7,30
4932,Rowing Club Castillon-3,1900.0,52,101,82,235
4933,France,1980.0,18,5,7,30
4934,France,1980.0,18,5,7,30
4935,France,1984.0,20,17,33,70
4936,France,1908.0,12,5,23,40
4937,France,1920.0,13,71,57,141
4938,France,1900.0,52,101,82,235
4939,France,1900.0,52,101,82,235
4940,France,1900.0,52,101,82,235
4941,France,1900.0,52,101,82,235
4942,France,1920.0,13,71,57,141
4943,France,1976.0,5,7,9,21
4944,France,2008.0,25,24,28,77
4945,France,2012.0,30,30,22,82
4946,France,1906.0,20,16,28,64
4947,France,1906.0,20,16,28,64
4948,France,2016.0,20,55,21,96
4949,France,1936.0,13,13,19,45
4950,France,1948.0,28,23,26,77
4951,France-1,1998.0,2,1,12,15
4952,France-1,2002.0,5,5,5,15
4953,France,1980.0,18,5,7,30
4954,France,1984.0,20,17,33,70
4955,France,1984.0,20,17,33,70
4956,USFSA,1900.0,52,101,82,235
4957,France,2008.0,25,24,28,77
4958,France,1984.0,20,17,33,70
4959,France,1988.0,13,4,14,31
4960,France,2002.0,5,5,5,15
4961,France,1968.0,16,8,12,36
4962,France,1972.0,2,6,17,25
4963,France,2008.0,25,24,28,77
4964,France,1992.0,14,11,44,69
4965,France,1996.0,21,10,20,51
4966,France,1996.0,21,10,20,51
4967,France,2006.0,3,2,10,15
4968,France,1992.0,14,11,44,69
4969,France,1960.0,1,6,8,15
4970,France,1968.0,16,8,12,36
4971,France,1924.0,37,51,32,120
4972,Esterel-1,1900.0,52,101,82,235
4973,France,1900.0,52,101,82,235
4974,France,1992.0,14,11,44,69
4975,France,1948.0,28,23,26,77
4976,France,2014.0,4,4,10,18
4977,Club Nautique de Lyon-2,1900.0,52,101,82,235
4978,France,1932.0,28,8,6,42
4979,France,1920.0,13,71,57,141
4980,France,1896.0,5,4,2,11
4981,France,1920.0,13,71,57,141
4982,France,2016.0,20,55,21,96
4983,France,2004.0,21,10,22,53
4984,Libellule de Paris,1900.0,52,101,82,235
4985,Libellule de Paris,1900.0,52,101,82,235
4986,France,2012.0,30,30,22,82
4987,France,1900.0,52,101,82,235
4988,France,1900.0,52,101,82,235
4989,France,1920.0,13,71,57,141
4990,Union des Socits Franais de Sports Athletiques,1900.0,52,101,82,235
4991,France,1988.0,13,4,14,31
4992,France,1988.0,13,4,14,31
4993,France,1992.0,14,11,44,69
4994,France,2016.0,20,55,21,96
4995,Rose Pompon,1920.0,13,71,57,141
4996,France,1980.0,18,5,7,30
4997,France,1976.0,5,7,9,21
4998,France,1980.0,18,5,7,30
4999,France,1984.0,20,17,33,70
5000,France,2000.0,22,30,14,66
5001,France,2004.0,21,10,22,53
5002,France,2008.0,25,24,28,77
5003,France,1984.0,20,17,33,70
5004,France,1988.0,13,4,14,31
5005,France,2016.0,20,55,21,96
5006,France,2014.0,4,4,10,18
5007,France,1924.0,37,51,32,120
5008,France,1932.0,28,8,6,42
5009,France,1932.0,28,8,6,42
5010,France,1952.0,14,9,18,41
5011,France,1964.0,4,17,17,38
5012,France,1968.0,16,8,12,36
5013,France,1924.0,37,51,32,120
5014,France,1920.0,13,71,57,141
5015,France,1920.0,13,71,57,141
5016,France,1988.0,13,4,14,31
5017,France,1992.0,14,11,44,69
5018,France,1996.0,21,10,20,51
5019,France,2000.0,22,30,14,66
5020,France,2012.0,30,30,22,82
5021,France,1936.0,13,13,19,45
5022,France,2002.0,5,5,5,15
5023,France,2002.0,5,5,5,15
5024,France,2006.0,3,2,10,15
5025,France,1984.0,20,17,33,70
5026,France,1920.0,13,71,57,141
5027,France,1920.0,13,71,57,141
5028,France,2000.0,22,30,14,66
5029,France,2016.0,20,55,21,96
5030,France,1992.0,14,11,44,69
5031,France,2008.0,25,24,28,77
5032,Guyoni,1908.0,12,5,23,40
5033,France,2000.0,22,30,14,66
5034,France,1912.0,10,11,5,26
5035,France,1928.0,14,24,14,52
5036,France-1,1900.0,52,101,82,235
5037,France,1900.0,52,101,82,235
5038,France/Great Britain,1900.0,52,101,82,235
5039,France,1948.0,28,23,26,77
5040,France,2016.0,20,55,21,96
5041,France,1988.0,13,4,14,31
5042,France,1948.0,28,23,26,77
5043,France,1920.0,13,71,57,141
5044,France,1920.0,13,71,57,141
5045,France,1920.0,13,71,57,141
5046,France,1920.0,13,71,57,141
5047,France,1956.0,7,13,13,33
5048,France,1984.0,20,17,33,70
5049,France,1992.0,14,11,44,69
5050,France,2016.0,20,55,21,96
5051,Guyoni,1908.0,12,5,23,40
5052,France,2000.0,22,30,14,66
5053,France,2012.0,30,30,22,82
5054,Racing Club de France,1900.0,52,101,82,235
5055,France,2016.0,20,55,21,96
5056,France,2004.0,21,10,22,53
5057,France,2010.0,2,6,6,14
5058,France,1932.0,28,8,6,42
5059,"Bagatelle Polo Club, Paris",1900.0,52,101,82,235
5060,France,2016.0,20,55,21,96
5061,France,1968.0,16,8,12,36
5062,France,1948.0,28,23,26,77
5063,France,1908.0,12,5,23,40
5064,Union des Socits Franais de Sports Athletiques,1900.0,52,101,82,235
5065,France,1984.0,20,17,33,70
5066,France,1956.0,7,13,13,33
5067,France,1988.0,13,4,14,31
5068,France,1996.0,21,10,20,51
5069,France,1964.0,4,17,17,38
5070,France,1964.0,4,17,17,38
5071,France,1968.0,16,8,12,36
5072,France,1968.0,16,8,12,36
5073,France,1972.0,2,6,17,25
5074,France,1976.0,5,7,9,21
5075,France,1980.0,18,5,7,30
5076,France,1980.0,18,5,7,30
5077,France,1980.0,18,5,7,30
5078,France,1984.0,20,17,33,70
5079,France,1984.0,20,17,33,70
5080,France,1988.0,13,4,14,31
5081,France,1988.0,13,4,14,31
5082,France,1980.0,18,5,7,30
5083,France,1992.0,14,11,44,69
5084,France,1920.0,13,71,57,141
5085,France,1920.0,13,71,57,141
5086,France,1920.0,13,71,57,141
5087,France,1924.0,37,51,32,120
5088,France,2000.0,22,30,14,66
5089,France,1924.0,37,51,32,120
5090,France,2008.0,25,24,28,77
5091,France,2012.0,30,30,22,82
5092,France,2016.0,20,55,21,96
5093,France,2000.0,22,30,14,66
5094,Union des Socits Franais de Sports Athletiques,1900.0,52,101,82,235
5095,France,2008.0,25,24,28,77
5096,France,2002.0,5,5,5,15
5097,France,2006.0,3,2,10,15
5098,France,1998.0,2,1,12,15
5099,France,1988.0,13,4,14,31
5100,France,1992.0,14,11,44,69
5101,France,2016.0,20,55,21,96
5102,France,1968.0,16,8,12,36
5103,France,1968.0,16,8,12,36
5104,France,1976.0,5,7,9,21
5105,France,1964.0,4,17,17,38
5106,France,1920.0,13,71,57,141
5107,France,1924.0,37,51,32,120
5108,Racing Club de France,1900.0,52,101,82,235
5109,France,1928.0,14,24,14,52
5110,France,1976.0,5,7,9,21
5111,France,2004.0,21,10,22,53
5112,France,1984.0,20,17,33,70
5113,France,1996.0,21,10,20,51
5114,France,2000.0,22,30,14,66
5115,France,2014.0,4,4,10,18
5116,France,1948.0,28,23,26,77
5117,France,1952.0,14,9,18,41
5118,France,2008.0,25,24,28,77
5119,Union des Socits Franais de Sports Athletiques,1900.0,52,101,82,235
5120,France,1952.0,14,9,18,41
5121,France,1948.0,28,23,26,77
5122,France,1996.0,21,10,20,51
5123,France,2000.0,22,30,14,66
5124,France,2000.0,22,30,14,66
5125,France,2000.0,22,30,14,66
5126,France,1956.0,7,13,13,33
5127,France,1998.0,2,1,12,15
5128,France,1968.0,16,8,12,36
5129,France,1976.0,5,7,9,21
5130,France,2016.0,20,55,21,96
5131,France,1998.0,2,1,12,15
5132,France,2002.0,5,5,5,15
5133,France,1920.0,13,71,57,141
5134,France,1924.0,37,51,32,120
5135,France,1984.0,20,17,33,70
5136,France,1932.0,28,8,6,42
5137,France,2012.0,30,30,22,82
5138,Fantlet-7,1900.0,52,101,82,235
5139,France,1948.0,28,23,26,77
5140,France,1980.0,18,5,7,30
5141,France,1984.0,20,17,33,70
5142,France,1920.0,13,71,57,141
5143,France,1952.0,14,9,18,41
5144,France,1900.0,52,101,82,235
5145,France,1988.0,13,4,14,31
5146,France,2008.0,25,24,28,77
5147,France,1900.0,52,101,82,235
5148,Racing Club de France,1900.0,52,101,82,235
5149,Union des Socits Franais de Sports Athletiques,1900.0,52,101,82,235
5150,France,1900.0,52,101,82,235
5151,France,1948.0,28,23,26,77
5152,France,1960.0,1,6,8,15
5153,France,1908.0,12,5,23,40
5154,France,1908.0,12,5,23,40
5155,Gwendoline-2,1900.0,52,101,82,235
5156,France,1928.0,14,24,14,52
5157,France,1932.0,28,8,6,42
5158,France,1936.0,13,13,19,45
5159,France,2008.0,25,24,28,77
5160,France,1912.0,10,11,5,26
5161,France,2000.0,22,30,14,66
5162,France,1900.0,52,101,82,235
5163,France,1900.0,52,101,82,235
5164,France,1924.0,37,51,32,120
5165,France,1924.0,37,51,32,120
5166,France,1924.0,37,51,32,120
5167,France,2000.0,22,30,14,66
5168,France,1908.0,12,5,23,40
5169,France,1912.0,10,11,5,26
5170,France,1912.0,10,11,5,26
5171,France,1984.0,20,17,33,70
5172,France,1976.0,5,7,9,21
5173,France,1900.0,52,101,82,235
5174,France,1900.0,52,101,82,235
5175,France,1960.0,1,6,8,15
5176,France,2008.0,25,24,28,77
5177,France,2012.0,30,30,22,82
5178,France,1900.0,52,101,82,235
5179,France,2016.0,20,55,21,96
5180,France,2000.0,22,30,14,66
5181,France,2012.0,30,30,22,82
5182,France,2016.0,20,55,21,96
5183,Club Nautique de Lyon-2,1900.0,52,101,82,235
5184,France,1920.0,13,71,57,141
5185,Socit Nautique de Bayonne-2,1906.0,20,16,28,64
5186,France,2008.0,25,24,28,77
5187,France,1988.0,13,4,14,31
5188,France,1992.0,14,11,44,69
5189,France,1996.0,21,10,20,51
5190,France,2000.0,22,30,14,66
5191,France,2016.0,20,55,21,96
5192,France,2008.0,25,24,28,77
5193,France,1908.0,12,5,23,40
5194,France,1972.0,2,6,17,25
5195,France,1924.0,37,51,32,120
5196,France,1992.0,14,11,44,69
5197,France,2012.0,30,30,22,82
5198,France,2012.0,30,30,22,82
5199,France,2016.0,20,55,21,96
5200,Favorite-1,1900.0,52,101,82,235
5201,Favorite-1,1900.0,52,101,82,235
5202,France,1932.0,28,8,6,42
5203,France,1900.0,52,101,82,235
5204,France,1924.0,37,51,32,120
5205,France,1932.0,28,8,6,42
5206,France,1924.0,37,51,32,120
5207,France,1972.0,2,6,17,25
5208,France,1976.0,5,7,9,21
5209,France,1976.0,5,7,9,21
5210,France,1936.0,13,13,19,45
5211,France,1932.0,28,8,6,42
5212,Pupilles de Neptune de Lille-1,1900.0,52,101,82,235
5213,France,1900.0,52,101,82,235
5214,France,1992.0,14,11,44,69
5215,France,2012.0,30,30,22,82
5216,France,2016.0,20,55,21,96
5217,France,1980.0,18,5,7,30
5218,Sarcelle-3,1900.0,52,101,82,235
5219,France,2008.0,25,24,28,77
5220,France,2004.0,21,10,22,53
5221,Quand-Mme-2,1900.0,52,101,82,235
5222,Quand-Mme-2,1900.0,52,101,82,235
5223,Quand-Mme-2,1900.0,52,101,82,235
5224,Quand-Mme-2,1900.0,52,101,82,235
5225,France,1928.0,14,24,14,52
5226,France,1900.0,52,101,82,235
5227,France,1900.0,52,101,82,235
5228,France,1992.0,14,11,44,69
5229,France,1900.0,52,101,82,235
5230,France,1920.0,13,71,57,141
5231,France,1948.0,28,23,26,77
5232,France,2000.0,22,30,14,66
5233,France,2004.0,21,10,22,53
5234,France,1900.0,52,101,82,235
5235,France-1,1900.0,52,101,82,235
5236,France,1984.0,20,17,33,70
5237,Mac Miche,1912.0,10,11,5,26
5238,Mac Miche,1912.0,10,11,5,26
5239,Mac Miche,1912.0,10,11,5,26
5240,Camille,1908.0,12,5,23,40
5241,France,1920.0,13,71,57,141
5242,France,1984.0,20,17,33,70
5243,France,1920.0,13,71,57,141
5244,Union des Socits Franais de Sports Athletiques,1900.0,52,101,82,235
5245,France,1952.0,14,9,18,41
5246,France,2016.0,20,55,21,96
5247,France,1900.0,52,101,82,235
5248,France,1920.0,13,71,57,141
5249,France,1920.0,13,71,57,141
5250,France,1984.0,20,17,33,70
5251,France,2000.0,22,30,14,66
5252,France,2004.0,21,10,22,53
5253,France,2004.0,21,10,22,53
5254,France,2008.0,25,24,28,77
5255,France,1952.0,14,9,18,41
5256,France,2000.0,22,30,14,66
5257,France,2004.0,21,10,22,53
5258,France,1996.0,21,10,20,51
5259,France,2000.0,22,30,14,66
5260,France,2004.0,21,10,22,53
5261,France,2004.0,21,10,22,53
5262,France,2004.0,21,10,22,53
5263,France,1996.0,21,10,20,51
5264,France,2000.0,22,30,14,66
5265,France,1964.0,4,17,17,38
5266,France,1968.0,16,8,12,36
5267,France,1968.0,16,8,12,36
5268,France,1968.0,16,8,12,36
5269,France,2014.0,4,4,10,18
5270,France,1928.0,14,24,14,52
5271,France,1900.0,52,101,82,235
5272,France,1976.0,5,7,9,21
5273,France,1980.0,18,5,7,30
5274,France,1980.0,18,5,7,30
5275,France,1984.0,20,17,33,70
5276,France,1992.0,14,11,44,69
5277,France,1920.0,13,71,57,141
5278,France,1920.0,13,71,57,141
5279,France,1920.0,13,71,57,141
5280,France,1900.0,52,101,82,235
5281,France-1,2012.0,30,30,22,82
5282,France,1896.0,5,4,2,11
5283,France,1952.0,14,9,18,41
5284,France,2016.0,20,55,21,96
5285,France,1948.0,28,23,26,77
5286,France,2016.0,20,55,21,96
5287,Crabe II-1,1900.0,52,101,82,235
5288,Crabe II-4,1900.0,52,101,82,235
5289,France,1924.0,37,51,32,120
5290,France,2000.0,22,30,14,66
5291,France,1928.0,14,24,14,52
5292,France,1936.0,13,13,19,45
5293,France,1936.0,13,13,19,45
5294,France,1936.0,13,13,19,45
5295,France,1936.0,13,13,19,45
5296,France,2000.0,22,30,14,66
5297,Libellule de Paris,1900.0,52,101,82,235
5298,France,1906.0,20,16,28,64
5299,France,1906.0,20,16,28,64
5300,France,1906.0,20,16,28,64
5301,France,2008.0,25,24,28,77
5302,France,1984.0,20,17,33,70
5303,France,2014.0,4,4,10,18
5304,France,1984.0,20,17,33,70
5305,France,1924.0,37,51,32,120
5306,France,1996.0,21,10,20,51
5307,Rowing Club Castillon-3,1900.0,52,101,82,235
5308,France,1972.0,2,6,17,25
5309,France,1952.0,14,9,18,41
5310,Tritons Lillois-2,1900.0,52,101,82,235
5311,France,1956.0,7,13,13,33
5312,France,1956.0,7,13,13,33
5313,France,1908.0,12,5,23,40
5314,France,1976.0,5,7,9,21
5315,France,2008.0,25,24,28,77
5316,France,2012.0,30,30,22,82
5317,France,2002.0,5,5,5,15
5318,France,2002.0,5,5,5,15
5319,France,2004.0,21,10,22,53
5320,France,1984.0,20,17,33,70
5321,France,1900.0,52,101,82,235
5322,Martha-1,1900.0,52,101,82,235
5323,Martha-1,1900.0,52,101,82,235
5324,France,1928.0,14,24,14,52
5325,France,1924.0,37,51,32,120
5326,France,1992.0,14,11,44,69
5327,France,1960.0,1,6,8,15
5328,Societ Nautique de la Marne-1,1900.0,52,101,82,235
5329,France,1920.0,13,71,57,141
5330,France,1924.0,37,51,32,120
5331,France,1920.0,13,71,57,141
5332,France,1920.0,13,71,57,141
5333,France,1900.0,52,101,82,235
5334,France,1900.0,52,101,82,235
5335,Club Nautique de Lyon-2,1900.0,52,101,82,235
5336,Rose Pompon,1920.0,13,71,57,141
5337,France,2000.0,22,30,14,66
5338,France,1932.0,28,8,6,42
5339,France,1936.0,13,13,19,45
5340,France,1984.0,20,17,33,70
5341,France,2012.0,30,30,22,82
5342,France,1996.0,21,10,20,51
5343,France,1948.0,28,23,26,77
5344,France,2016.0,20,55,21,96
5345,France,2016.0,20,55,21,96
5346,France,1984.0,20,17,33,70
5347,Italy,2016.0,8,40,24,72
5348,Italy,1936.0,37,34,5,76
5349,Italy,1988.0,13,11,13,37
5350,Italy,1996.0,19,24,28,71
5351,Italy,2000.0,22,14,29,65
5352,Italy,1984.0,31,6,28,65
5353,Italy,1988.0,13,11,13,37
5354,Italy,1992.0,25,19,22,66
5355,Italy,1984.0,31,6,28,65
5356,Italy,1988.0,13,11,13,37
5357,Italy,1992.0,25,19,22,66
5358,Italy,2004.0,24,41,39,104
5359,Italy,2008.0,8,14,20,42
5360,Italy,1928.0,24,22,26,72
5361,Italy,1932.0,21,38,18,77
5362,Italy,1932.0,21,38,18,77
5363,Italy,1948.0,22,32,14,68
5364,Italy,2012.0,16,22,30,68
5365,Italy,2016.0,8,40,24,72
5366,Italy,2016.0,8,40,24,72
5367,Italy,1968.0,13,8,20,41
5368,Italy,1992.0,25,19,22,66
5369,Italy,1992.0,25,19,22,66
5370,Italy,1994.0,14,6,12,32
5371,Italy,1994.0,14,6,12,32
5372,Italy,1998.0,3,9,5,17
5373,Italy,1976.0,3,27,5,35
5374,Italy,1968.0,13,8,20,41
5375,Italy,1920.0,67,9,8,84
5376,Italy,2004.0,24,41,39,104
5377,Italy,1912.0,22,1,2,25
5378,Italy-2,1956.0,28,17,10,55
5379,Italy-2,1956.0,28,17,10,55
5380,Italy,1920.0,67,9,8,84
5381,Italy,1924.0,25,5,21,51
5382,Italy,2004.0,24,41,39,104
5383,Italy,1960.0,36,18,35,89
5384,Italy,1928.0,24,22,26,72
5385,Italy,1920.0,67,9,8,84
5386,Italy,2004.0,24,41,39,104
5387,Italy,1992.0,25,19,22,66
5388,Italy,1984.0,31,6,28,65
5389,Italy,1920.0,67,9,8,84
5390,Italy,1964.0,14,30,17,61
5391,Italy,2006.0,11,0,14,25
5392,Italy,1996.0,19,24,28,71
5393,Italy,1964.0,14,30,17,61
5394,Italy,1956.0,28,17,10,55
5395,Italy,1920.0,67,9,8,84
5396,Italy,1924.0,25,5,21,51
5397,Italy,1928.0,24,22,26,72
5398,Italy,1932.0,21,38,18,77
5399,Italy,1988.0,13,11,13,37
5400,Italy,2002.0,4,11,6,21
5401,Italy,2016.0,8,40,24,72
5402,Italy,2004.0,24,41,39,104
5403,Italy,1976.0,3,27,5,35
5404,Italy,1984.0,31,6,28,65
5405,Italy,1948.0,22,32,14,68
5406,Italy,1952.0,18,22,16,56
5407,Italy,1964.0,14,30,17,61
5408,Italy,1972.0,12,8,14,34
5409,Italy,1960.0,36,18,35,89
5410,Italy-1,1968.0,13,8,20,41
5411,Italy,1920.0,67,9,8,84
5412,Italy,1920.0,67,9,8,84
5413,Italy,2012.0,16,22,30,68
5414,Italy,1992.0,25,19,22,66
5415,Italy,1996.0,19,24,28,71
5416,Italy,1964.0,14,30,17,61
5417,Italy,1960.0,36,18,35,89
5418,Italy-1,1964.0,14,30,17,61
5419,Italy,2012.0,16,22,30,68
5420,Italy,2016.0,8,40,24,72
5421,Italy,1960.0,36,18,35,89
5422,Italy,1960.0,36,18,35,89
5423,Italy,1920.0,67,9,8,84
5424,Italy,1920.0,67,9,8,84
5425,Italy,1976.0,3,27,5,35
5426,Italy,2012.0,16,22,30,68
5427,Italy,1956.0,28,17,10,55
5428,Italy,2004.0,24,41,39,104
5429,Italy,1936.0,37,34,5,76
5430,Italy,1932.0,21,38,18,77
5431,Italy,1928.0,24,22,26,72
5432,Italy,1924.0,25,5,21,51
5433,Italy,1968.0,13,8,20,41
5434,Italy,1928.0,24,22,26,72
5435,Italy,1948.0,22,32,14,68
5436,Italy,1976.0,3,27,5,35
5437,Italy,1960.0,36,18,35,89
5438,Italy,1968.0,13,8,20,41
5439,Italy,1968.0,13,8,20,41
5440,Italy,1932.0,21,38,18,77
5441,Italy,1960.0,36,18,35,89
5442,Italy,2012.0,16,22,30,68
5443,Italy,1932.0,21,38,18,77
5444,Italy,1936.0,37,34,5,76
5445,Italy,1984.0,31,6,28,65
5446,Italy,1912.0,22,1,2,25
5447,Italy,1936.0,37,34,5,76
5448,Italy,2004.0,24,41,39,104
5449,Italy,1972.0,12,8,14,34
5450,Italy,2016.0,8,40,24,72
5451,Italy,2004.0,24,41,39,104
5452,Italy,1924.0,25,5,21,51
5453,Italy,1928.0,24,22,26,72
5454,Italy,1952.0,18,22,16,56
5455,Italy,1988.0,13,11,13,37
5456,Italy,1992.0,25,19,22,66
5457,Italy,2012.0,16,22,30,68
5458,Italy,1932.0,21,38,18,77
5459,Italy,1936.0,37,34,5,76
5460,Italy,1960.0,36,18,35,89
5461,Italy,1928.0,24,22,26,72
5462,Italy,1984.0,31,6,28,65
5463,"Marinai della nave da guerra ""Varese""",1906.0,21,8,27,56
5464,Italy,1920.0,67,9,8,84
5465,Italy,1984.0,31,6,28,65
5466,Italy,1996.0,19,24,28,71
5467,Italy,2000.0,22,14,29,65
5468,Italy,1992.0,25,19,22,66
5469,Italy,1992.0,25,19,22,66
5470,Italy,1992.0,25,19,22,66
5471,Italy,1994.0,14,6,12,32
5472,Italy,1994.0,14,6,12,32
5473,Italy,1998.0,3,9,5,17
5474,Italy,1998.0,3,9,5,17
5475,Italy,2002.0,4,11,6,21
5476,Italy,2002.0,4,11,6,21
5477,Italy,2002.0,4,11,6,21
5478,Italy,1996.0,19,24,28,71
5479,Italy,1996.0,19,24,28,71
5480,Italy,2004.0,24,41,39,104
5481,Italy,1948.0,22,32,14,68
5482,Italy,1960.0,36,18,35,89
5483,Italy,1952.0,18,22,16,56
5484,Italy,1956.0,28,17,10,55
5485,Italy,1956.0,28,17,10,55
5486,Italy,1936.0,37,34,5,76
5487,Italy,1948.0,22,32,14,68
5488,Italy,1996.0,19,24,28,71
5489,Italy,1928.0,24,22,26,72
5490,Italy,1960.0,36,18,35,89
5491,Italy,1952.0,18,22,16,56
5492,Italy,1956.0,28,17,10,55
5493,Italy,1908.0,2,6,0,8
5494,Italy,1924.0,25,5,21,51
5495,Italy,1924.0,25,5,21,51
5496,Italy,1928.0,24,22,26,72
5497,Italy,2004.0,24,41,39,104
5498,Italy,1924.0,25,5,21,51
5499,Italy,1964.0,14,30,17,61
5500,Pistoja/Firenze,1906.0,21,8,27,56
5501,Italy,1984.0,31,6,28,65
5502,Italy,1936.0,37,34,5,76
5503,Italy,2004.0,24,41,39,104
5504,Italy,1936.0,37,34,5,76
5505,Italy,1992.0,25,19,22,66
5506,Italy,2000.0,22,14,29,65
5507,Italy,1960.0,36,18,35,89
5508,Italy,1964.0,14,30,17,61
5509,Italy,1964.0,14,30,17,61
5510,Italy,1936.0,37,34,5,76
5511,Italia,1936.0,37,34,5,76
5512,Italy,1948.0,22,32,14,68
5513,Italy,1920.0,67,9,8,84
5514,Italy,1912.0,22,1,2,25
5515,Italy,1920.0,67,9,8,84
5516,Italy,2016.0,8,40,24,72
5517,Italy,1948.0,22,32,14,68
5518,Italy,1924.0,25,5,21,51
5519,Italy,1928.0,24,22,26,72
5520,Italy,1928.0,24,22,26,72
5521,Italy,2012.0,16,22,30,68
5522,Italy,2016.0,8,40,24,72
5523,Italy,1996.0,19,24,28,71
5524,Italy,2000.0,22,14,29,65
5525,Italy,2004.0,24,41,39,104
5526,Italy,2012.0,16,22,30,68
5527,Italy,1936.0,37,34,5,76
5528,Italy,1936.0,37,34,5,76
5529,Italy,2016.0,8,40,24,72
5530,Italy,1972.0,12,8,14,34
5531,Italy,1952.0,18,22,16,56
5532,Italy,1992.0,25,19,22,66
5533,Italy,1928.0,24,22,26,72
5534,Italy-2,1964.0,14,30,17,61
5535,Italy,1980.0,8,24,8,40
5536,Italy,1920.0,67,9,8,84
5537,Italy,2004.0,24,41,39,104
5538,Italy,1948.0,22,32,14,68
5539,Italy,1912.0,22,1,2,25
5540,Italy-1,1972.0,12,8,14,34
5541,Italy,2012.0,16,22,30,68
5542,Italy,1932.0,21,38,18,77
5543,Italy,1996.0,19,24,28,71
5544,Italy,1996.0,19,24,28,71
5545,Italy,2000.0,22,14,29,65
5546,Italy,2004.0,24,41,39,104
5547,Italy,1988.0,13,11,13,37
5548,Italy,1984.0,31,6,28,65
5549,Italy,1932.0,21,38,18,77
5550,Italy,1988.0,13,11,13,37
5551,Italy,1992.0,25,19,22,66
5552,Italy,1996.0,19,24,28,71
5553,Italy,1960.0,36,18,35,89
5554,Italy,1964.0,14,30,17,61
5555,Italy,1968.0,13,8,20,41
5556,Italy,1968.0,13,8,20,41
5557,Italy,1960.0,36,18,35,89
5558,Italy,2004.0,24,41,39,104
5559,Italy,1920.0,67,9,8,84
5560,Italy,1992.0,25,19,22,66
5561,Italy,1996.0,19,24,28,71
5562,Italy,2004.0,24,41,39,104
5563,Italy,1996.0,19,24,28,71
5564,Italy,1920.0,67,9,8,84
5565,Italy,1956.0,28,17,10,55
5566,Italy,1996.0,19,24,28,71
5567,Italy,2000.0,22,14,29,65
5568,Italy,1932.0,21,38,18,77
5569,Italy,1906.0,21,8,27,56
5570,Italy,1906.0,21,8,27,56
5571,Italy,1908.0,2,6,0,8
5572,Italy,1912.0,22,1,2,25
5573,Italy,1912.0,22,1,2,25
5574,Italy,1968.0,13,8,20,41
5575,Italy,1964.0,14,30,17,61
5576,Italy,2004.0,24,41,39,104
5577,Italy-1,1994.0,14,6,12,32
5578,Italy,2004.0,24,41,39,104
5579,Bucintoro Venezia-1,1906.0,21,8,27,56
5580,Bucintoro Venezia,1906.0,21,8,27,56
5581,Bucintoro Venezia,1906.0,21,8,27,56
5582,Italy,1980.0,8,24,8,40
5583,Italy,1996.0,19,24,28,71
5584,Italy,1952.0,18,22,16,56
5585,Italy,2016.0,8,40,24,72
5586,Italy-1,1980.0,8,24,8,40
5587,Italy,1984.0,31,6,28,65
5588,Italy,1936.0,37,34,5,76
5589,Italy,1900.0,3,2,0,5
5590,Italy,1956.0,28,17,10,55
5591,Italy,1948.0,22,32,14,68
5592,Italy,2004.0,24,41,39,104
5593,"Marinai della nave da guerra ""Varese""",1906.0,21,8,27,56
5594,Italy,1948.0,22,32,14,68
5595,Italy,2016.0,8,40,24,72
5596,Italy,1920.0,67,9,8,84
5597,Italy,1920.0,67,9,8,84
5598,Italy,1920.0,67,9,8,84
5599,Italy,1920.0,67,9,8,84
5600,Italy,1920.0,67,9,8,84
5601,Italy,1972.0,12,8,14,34
5602,Italy,1972.0,12,8,14,34
5603,Italy,1976.0,3,27,5,35
5604,Italy,1980.0,8,24,8,40
5605,Italy,2016.0,8,40,24,72
5606,Italy,2016.0,8,40,24,72
5607,Italy,2008.0,8,14,20,42
5608,Italy,2016.0,8,40,24,72
5609,Italy,2000.0,22,14,29,65
5610,Italy,1960.0,36,18,35,89
5611,Italy,1964.0,14,30,17,61
5612,Italy,1960.0,36,18,35,89
5613,Italy,1960.0,36,18,35,89
5614,Italy,1964.0,14,30,17,61
5615,Italy,1968.0,13,8,20,41
5616,Italy,1976.0,3,27,5,35
5617,Italy,1996.0,19,24,28,71
5618,Italy,1996.0,19,24,28,71
5619,Italy,1936.0,37,34,5,76
5620,Italy,1992.0,25,19,22,66
5621,Italy,1928.0,24,22,26,72
5622,Italy,1972.0,12,8,14,34
5623,Italy,1972.0,12,8,14,34
5624,Italy,1972.0,12,8,14,34
5625,Italy,1952.0,18,22,16,56
5626,Italy,1960.0,36,18,35,89
5627,Italy,1920.0,67,9,8,84
5628,Italy,1924.0,25,5,21,51
5629,Italy,1906.0,21,8,27,56
5630,Italy,2004.0,24,41,39,104
5631,Italy,2008.0,8,14,20,42
5632,Italy,2012.0,16,22,30,68
5633,Italy,1992.0,25,19,22,66
5634,Italy,1952.0,18,22,16,56
5635,Italy,2012.0,16,22,30,68
5636,Italy,2012.0,16,22,30,68
5637,Italy,2016.0,8,40,24,72
5638,Italy,2016.0,8,40,24,72
5639,Italy,1920.0,67,9,8,84
5640,Italy,1924.0,25,5,21,51
5641,Italy,1996.0,19,24,28,71
5642,Italy,1948.0,22,32,14,68
5643,Italy,1948.0,22,32,14,68
5644,Italy,2004.0,24,41,39,104
5645,Italy,1936.0,37,34,5,76
5646,Italy,1952.0,18,22,16,56
5647,Italy,2006.0,11,0,14,25
5648,Italy,1932.0,21,38,18,77
5649,Italy,2000.0,22,14,29,65
5650,Italy,1920.0,67,9,8,84
5651,Italy,1960.0,36,18,35,89
5652,Italy,1960.0,36,18,35,89
5653,Italy,1960.0,36,18,35,89
5654,Italy,1994.0,14,6,12,32
5655,Italy,2002.0,4,11,6,21
5656,Italy,2008.0,8,14,20,42
5657,Italy,1956.0,28,17,10,55
5658,Italy,1960.0,36,18,35,89
5659,Italy,1998.0,3,9,5,17
5660,Italy,2002.0,4,11,6,21
5661,Italy,1980.0,8,24,8,40
5662,Italy,1992.0,25,19,22,66
5663,Italy,1996.0,19,24,28,71
5664,Italy,2004.0,24,41,39,104
5665,Italy,2004.0,24,41,39,104
5666,Italy,2012.0,16,22,30,68
5667,Italy,2004.0,24,41,39,104
5668,Italy,1976.0,3,27,5,35
5669,Italy,2016.0,8,40,24,72
5670,Italy,1932.0,21,38,18,77
5671,Italy,1948.0,22,32,14,68
5672,Italy,1924.0,25,5,21,51
5673,Italy,1924.0,25,5,21,51
5674,Italy,1924.0,25,5,21,51
5675,Italy,1928.0,24,22,26,72
5676,Italy,1988.0,13,11,13,37
5677,Italy,1968.0,13,8,20,41
5678,Italy,2002.0,4,11,6,21
5679,Italy,1952.0,18,22,16,56
5680,Italy,1908.0,2,6,0,8
5681,Italy,2004.0,24,41,39,104
5682,Italy,1984.0,31,6,28,65
5683,Italy,1984.0,31,6,28,65
5684,Italy,1988.0,13,11,13,37
5685,Italy,2004.0,24,41,39,104
5686,Bucintoro Venezia-1,1906.0,21,8,27,56
5687,Bucintoro Venezia,1906.0,21,8,27,56
5688,Bucintoro Venezia,1906.0,21,8,27,56
5689,Barion/Bari-2,1906.0,21,8,27,56
5690,Italy,1906.0,21,8,27,56
5691,Italy,1960.0,36,18,35,89
5692,Italy,2016.0,8,40,24,72
5693,Italy,1936.0,37,34,5,76
5694,Italy,1964.0,14,30,17,61
5695,Italy,1964.0,14,30,17,61
5696,Italy,1996.0,19,24,28,71
5697,Italy,2004.0,24,41,39,104
5698,Italy,1968.0,13,8,20,41
5699,Italy,1952.0,18,22,16,56
5700,Italy,1960.0,36,18,35,89
5701,Italy,2004.0,24,41,39,104
5702,Italy,1996.0,19,24,28,71
5703,Italy,1928.0,24,22,26,72
5704,Italy,1960.0,36,18,35,89
5705,Italy,1964.0,14,30,17,61
5706,Italy,1968.0,13,8,20,41
5707,Italy,2004.0,24,41,39,104
5708,Italy,1996.0,19,24,28,71
5709,Italy,1956.0,28,17,10,55
5710,Venilia,1960.0,36,18,35,89
5711,Italy,1932.0,21,38,18,77
5712,"Marinai della nave da guerra ""Varese""",1906.0,21,8,27,56
5713,Italy,1932.0,21,38,18,77
5714,Italy,1968.0,13,8,20,41
5715,Italy,1984.0,31,6,28,65
5716,Italy,2004.0,24,41,39,104
5717,Italy,1948.0,22,32,14,68
5718,Barion/Bari-2,1906.0,21,8,27,56
5719,Pistoja/Firenze,1906.0,21,8,27,56
5720,Italy,1960.0,36,18,35,89
5721,Italy,2016.0,8,40,24,72
5722,Italy,1976.0,3,27,5,35
5723,Italy,1996.0,19,24,28,71
5724,Italy,1976.0,3,27,5,35
5725,Italy,1952.0,18,22,16,56
5726,Italy,1960.0,36,18,35,89
5727,Italy,1992.0,25,19,22,66
5728,Italy,1928.0,24,22,26,72
5729,Italy,1992.0,25,19,22,66
5730,Italy,1994.0,14,6,12,32
5731,Italy,1998.0,3,9,5,17
5732,Italy,1998.0,3,9,5,17
5733,Italy,2008.0,8,14,20,42
5734,Italy,2006.0,11,0,14,25
5735,Italy,1948.0,22,32,14,68
5736,Italy,1952.0,18,22,16,56
5737,Italy,1900.0,3,2,0,5
5738,Italy,1920.0,67,9,8,84
5739,Italy,2004.0,24,41,39,104
5740,Italy-1,1956.0,28,17,10,55
5741,Italy,1968.0,13,8,20,41
5742,Italy,1992.0,25,19,22,66
5743,Italy,1948.0,22,32,14,68
5744,Italy,1928.0,24,22,26,72
5745,Italy,1932.0,21,38,18,77
5746,Italy,1932.0,21,38,18,77
5747,Italy,1936.0,37,34,5,76
5748,Italy,1936.0,37,34,5,76
5749,Italy,1992.0,25,19,22,66
5750,Italy,2000.0,22,14,29,65
5751,Venilia,1960.0,36,18,35,89
5752,Italy,1932.0,21,38,18,77
5753,Italy,1920.0,67,9,8,84
5754,Italy,1920.0,67,9,8,84
5755,Italy,1920.0,67,9,8,84
5756,Italy,1920.0,67,9,8,84
5757,Italy,2016.0,8,40,24,72
5758,Italy,1984.0,31,6,28,65
5759,Italy,2004.0,24,41,39,104
5760,Italy,1984.0,31,6,28,65
5761,Italy,1924.0,25,5,21,51
5762,Italy,2000.0,22,14,29,65
5763,Italy,1960.0,36,18,35,89
5764,Italy,1924.0,25,5,21,51
5765,Italy,1924.0,25,5,21,51
5766,Italy,1984.0,31,6,28,65
5767,Italy,1996.0,19,24,28,71
5768,Italy,1960.0,36,18,35,89
5769,Italy,1960.0,36,18,35,89
5770,Italy,1992.0,25,19,22,66
5771,Italy,1976.0,3,27,5,35
5772,Italy,2008.0,8,14,20,42
5773,Italy-1,1972.0,12,8,14,34
5774,Italy,1976.0,3,27,5,35
5775,Italy,1976.0,3,27,5,35
5776,Italy,1984.0,31,6,28,65
5777,Italy,1984.0,31,6,28,65
5778,Italy,1988.0,13,11,13,37
5779,Italy,1964.0,14,30,17,61
5780,Italy-1,1956.0,28,17,10,55
5781,Italy,2016.0,8,40,24,72
5782,Italy,1984.0,31,6,28,65
5783,Italy,1984.0,31,6,28,65
5784,Italy,1964.0,14,30,17,61
5785,Italy,1980.0,8,24,8,40
5786,Italy,1984.0,31,6,28,65
5787,Italy,1988.0,13,11,13,37
5788,Italy,1948.0,22,32,14,68
5789,Italy,1952.0,18,22,16,56
5790,Italy,1936.0,37,34,5,76
5791,Italy,1928.0,24,22,26,72
5792,Italy,1932.0,21,38,18,77
5793,Italy,1992.0,25,19,22,66
5794,Italy,1928.0,24,22,26,72
5795,Italy,1920.0,67,9,8,84
5796,Italy,1984.0,31,6,28,65
5797,Italy,1976.0,3,27,5,35
5798,Italy,1976.0,3,27,5,35
5799,Italia,1936.0,37,34,5,76
5800,Italy,1924.0,25,5,21,51
5801,Italy,1924.0,25,5,21,51
5802,Italy-1,1968.0,13,8,20,41
5803,Italy-1,1968.0,13,8,20,41
5804,Italy,1964.0,14,30,17,61
5805,Italy,1960.0,36,18,35,89
5806,Italy,1928.0,24,22,26,72
5807,Italy,2004.0,24,41,39,104
5808,Italy,1952.0,18,22,16,56
5809,Italy,1952.0,18,22,16,56
5810,Venilia,1960.0,36,18,35,89
5811,Italy,1932.0,21,38,18,77
5812,Italy,1988.0,13,11,13,37
5813,Italy,1992.0,25,19,22,66
5814,Italy,1994.0,14,6,12,32
5815,Italy-1,1972.0,12,8,14,34
5816,Italy,2000.0,22,14,29,65
5817,Italy,1932.0,21,38,18,77
5818,Italy,1936.0,37,34,5,76
5819,Italy,1976.0,3,27,5,35
5820,Italy,2016.0,8,40,24,72
5821,Italy,2004.0,24,41,39,104
5822,Italy,1952.0,18,22,16,56
5823,Italy,1956.0,28,17,10,55
5824,Italy,1956.0,28,17,10,55
5825,Italy,1960.0,36,18,35,89
5826,Italy,1960.0,36,18,35,89
5827,Italy,1964.0,14,30,17,61
5828,Italy,1928.0,24,22,26,72
5829,Italy,1980.0,8,24,8,40
5830,Italy,2004.0,24,41,39,104
5831,Italy,2016.0,8,40,24,72
5832,Italy,2016.0,8,40,24,72
5833,Italy,2000.0,22,14,29,65
5834,Italy,1960.0,36,18,35,89
5835,Italy,1956.0,28,17,10,55
5836,Italy,1956.0,28,17,10,55
5837,Italy,1960.0,36,18,35,89
5838,Italy,1960.0,36,18,35,89
5839,Italy,1964.0,14,30,17,61
5840,Italy,1972.0,12,8,14,34
5841,Italy,1956.0,28,17,10,55
5842,Italy,1956.0,28,17,10,55
5843,Italy,1960.0,36,18,35,89
5844,Italy,1960.0,36,18,35,89
5845,Italy,1964.0,14,30,17,61
5846,Italy,1972.0,12,8,14,34
5847,Italy,2000.0,22,14,29,65
5848,Italy,2008.0,8,14,20,42
5849,Italy,1984.0,31,6,28,65
5850,Italy,1988.0,13,11,13,37
5851,Italy,1992.0,25,19,22,66
5852,Italy,2002.0,4,11,6,21
5853,Italy,2006.0,11,0,14,25
5854,Italy,2006.0,11,0,14,25
5855,Italy,1992.0,25,19,22,66
5856,Italy,1994.0,14,6,12,32
5857,Italy,1994.0,14,6,12,32
5858,Italy,1994.0,14,6,12,32
5859,Italy,1994.0,14,6,12,32
5860,Italy,1994.0,14,6,12,32
5861,Italy,1998.0,3,9,5,17
5862,Italy,2016.0,8,40,24,72
5863,Italy,1996.0,19,24,28,71
5864,Italy,1996.0,19,24,28,71
5865,Italy,2012.0,16,22,30,68
5866,Italy,2012.0,16,22,30,68
5867,Italy,2016.0,8,40,24,72
5868,Italy,2016.0,8,40,24,72
5869,Italy,2004.0,24,41,39,104
5870,Italy,2016.0,8,40,24,72
5871,Italy,1924.0,25,5,21,51
5872,Italy,1936.0,37,34,5,76
5873,Italy,1948.0,22,32,14,68
5874,Italy,1952.0,18,22,16,56
5875,Italy,1952.0,18,22,16,56
5876,Italy,1956.0,28,17,10,55
5877,Barion/Bari-2,1906.0,21,8,27,56
5878,Italy,1964.0,14,30,17,61
5879,Italy,1968.0,13,8,20,41
5880,Italy,1968.0,13,8,20,41
5881,Italy,1972.0,12,8,14,34
5882,Italy,1976.0,3,27,5,35
5883,Italy,1924.0,25,5,21,51
5884,Italy,1932.0,21,38,18,77
5885,Italy,1948.0,22,32,14,68
5886,Italy,2004.0,24,41,39,104
5887,Italy,1956.0,28,17,10,55
5888,Italy,1912.0,22,1,2,25
5889,Italy,1920.0,67,9,8,84
5890,Italy,2004.0,24,41,39,104
5891,Italy,2006.0,11,0,14,25
5892,Italy,2012.0,16,22,30,68
5893,Italy,1920.0,67,9,8,84
5894,Italy,1952.0,18,22,16,56
5895,Italy,1984.0,31,6,28,65
5896,Italy,1992.0,25,19,22,66
5897,Italy,2016.0,8,40,24,72
5898,Italy,1984.0,31,6,28,65
5899,Italy,2012.0,16,22,30,68
5900,Italy,2012.0,16,22,30,68
5901,Italy,1984.0,31,6,28,65
5902,Italy,2012.0,16,22,30,68
5903,Italy,1952.0,18,22,16,56
5904,Italy,1956.0,28,17,10,55
5905,Italy,2006.0,11,0,14,25
5906,Italy,2006.0,11,0,14,25
5907,Italy,2006.0,11,0,14,25
5908,Italy,2008.0,8,14,20,42
5909,Italy,1928.0,24,22,26,72
5910,Italy,1948.0,22,32,14,68
5911,Italy,1956.0,28,17,10,55
5912,Italy,1956.0,28,17,10,55
5913,Italy,1994.0,14,6,12,32
5914,Italy,2004.0,24,41,39,104
5915,Italy,1996.0,19,24,28,71
5916,Italy,1948.0,22,32,14,68
5917,Italy,1948.0,22,32,14,68
5918,Italy,1988.0,13,11,13,37
5919,Italy,1992.0,25,19,22,66
5920,Italy,1936.0,37,34,5,76
5921,Italy,1992.0,25,19,22,66
5922,Italy,1994.0,14,6,12,32
5923,Italy,1994.0,14,6,12,32
5924,Italy,1998.0,3,9,5,17
5925,Italy,1998.0,3,9,5,17
5926,Italy,2000.0,22,14,29,65
5927,Italy,2004.0,24,41,39,104
5928,Italy,2012.0,16,22,30,68
5929,Italy,2012.0,16,22,30,68
5930,Italy,1976.0,3,27,5,35
5931,Italy,1980.0,8,24,8,40
5932,Italy,2004.0,24,41,39,104
5933,Italy,1920.0,67,9,8,84
5934,Italy,1952.0,18,22,16,56
5935,Italy,1960.0,36,18,35,89
5936,Italy,1920.0,67,9,8,84
5937,Italy,1976.0,3,27,5,35
5938,Italy,1992.0,25,19,22,66
5939,Italy,2000.0,22,14,29,65
5940,Italy,1992.0,25,19,22,66
5941,Italy,1984.0,31,6,28,65
5942,Italy,2016.0,8,40,24,72
5943,Italy,2016.0,8,40,24,72
5944,Italy,2012.0,16,22,30,68
5945,Italy,2016.0,8,40,24,72
5946,Italy,2008.0,8,14,20,42
5947,Italy,2000.0,22,14,29,65
5948,Italy,2000.0,22,14,29,65
5949,Italy,2012.0,16,22,30,68
5950,Italy,1992.0,25,19,22,66
5951,Italy,2006.0,11,0,14,25
5952,Italy,2016.0,8,40,24,72
5953,Italy,1936.0,37,34,5,76
5954,Italy,2006.0,11,0,14,25
5955,Italy,2010.0,1,1,3,5
5956,Italy,2014.0,0,2,12,14
5957,Italy,2014.0,0,2,12,14
5958,Italy,2014.0,0,2,12,14
5959,Italy,1948.0,22,32,14,68
5960,Italy,2012.0,16,22,30,68
5961,Bucintoro Venezia-1,1906.0,21,8,27,56
5962,Bucintoro Venezia,1906.0,21,8,27,56
5963,Bucintoro Venezia,1906.0,21,8,27,56
5964,Italy,2012.0,16,22,30,68
5965,Italy,1948.0,22,32,14,68
5966,"Marinai della nave da guerra ""Varese""",1906.0,21,8,27,56
5967,Italy,1960.0,36,18,35,89
5968,Italy,2002.0,4,11,6,21
5969,Italy,1996.0,19,24,28,71
5970,Italy,2000.0,22,14,29,65
5971,Italy,2012.0,16,22,30,68
5972,Italy-1,1972.0,12,8,14,34
5973,Italy,2016.0,8,40,24,72
5974,"Marinai della nave da guerra ""Varese""",1906.0,21,8,27,56
5975,Italy,1912.0,22,1,2,25
5976,Italy,1920.0,67,9,8,84
5977,Italy,1928.0,24,22,26,72
5978,Italy,1920.0,67,9,8,84
5979,Italy,1920.0,67,9,8,84
5980,Italy,1924.0,25,5,21,51
5981,Italy,1932.0,21,38,18,77
5982,Italy,1936.0,37,34,5,76
5983,Italy-1,2002.0,4,11,6,21
5984,Italy,1924.0,25,5,21,51
5985,Italy,1928.0,24,22,26,72
5986,Italy,1936.0,37,34,5,76
5987,Italy,1960.0,36,18,35,89
5988,Italy,1960.0,36,18,35,89
5989,Italy,1928.0,24,22,26,72
5990,Italy,2004.0,24,41,39,104
5991,Italy,1960.0,36,18,35,89
5992,Italy,1964.0,14,30,17,61
5993,Italy,1924.0,25,5,21,51
5994,Italy,2004.0,24,41,39,104
5995,Italy,2008.0,8,14,20,42
5996,Italy,2012.0,16,22,30,68
5997,Italy,1924.0,25,5,21,51
5998,Italy,1928.0,24,22,26,72
5999,Italy,1932.0,21,38,18,77
6000,Italy,1932.0,21,38,18,77
6001,Italy,1948.0,22,32,14,68
6002,Italy,2012.0,16,22,30,68
6003,Italy,2016.0,8,40,24,72
6004,Italy,1992.0,25,19,22,66
6005,Italy,2000.0,22,14,29,65
6006,Italy,2004.0,24,41,39,104
6007,Italy,2008.0,8,14,20,42
6008,Italy,1980.0,8,24,8,40
6009,Italy,1984.0,31,6,28,65
6010,Italy,1952.0,18,22,16,56
6011,Italy,1906.0,21,8,27,56
6012,Italy,1956.0,28,17,10,55
6013,Italy,1988.0,13,11,13,37
6014,Italy,1992.0,25,19,22,66
6015,Italy,1968.0,13,8,20,41
6016,Italy,1996.0,19,24,28,71
6017,Italy,2000.0,22,14,29,65
6018,Italy,1968.0,13,8,20,41
6019,Italy,1920.0,67,9,8,84
6020,Italy,2016.0,8,40,24,72
6021,Italy,2016.0,8,40,24,72
6022,Italy,2016.0,8,40,24,72
6023,Italy,2004.0,24,41,39,104
6024,Italy,1932.0,21,38,18,77
6025,Italy,1936.0,37,34,5,76
6026,Italy,1920.0,67,9,8,84
6027,Italy,2004.0,24,41,39,104
6028,Italy,1956.0,28,17,10,55
6029,Italy,1960.0,36,18,35,89
6030,Italy,1928.0,24,22,26,72
6031,Italy,1928.0,24,22,26,72
6032,Italy,1932.0,21,38,18,77
6033,Italy,1932.0,21,38,18,77
6034,Italy,1932.0,21,38,18,77
6035,Italy,1932.0,21,38,18,77
6036,Italy,1936.0,37,34,5,76
6037,Italy,1936.0,37,34,5,76
6038,Italy,1936.0,37,34,5,76
6039,Italy,2000.0,22,14,29,65
6040,Italy,1980.0,8,24,8,40
6041,Italy,1928.0,24,22,26,72
6042,Italy,1928.0,24,22,26,72
6043,Italy,1968.0,13,8,20,41
6044,Italy,1936.0,37,34,5,76
6045,Italy,1996.0,19,24,28,71
6046,"Marinai della nave da guerra ""Varese""",1906.0,21,8,27,56
6047,Italy,1948.0,22,32,14,68
6048,Italy,1932.0,21,38,18,77
6049,Italy,1996.0,19,24,28,71
6050,Italy,1976.0,3,27,5,35
6051,Italy,1952.0,18,22,16,56
6052,Italy,1920.0,67,9,8,84
6053,Italy,1932.0,21,38,18,77
6054,Italy,1948.0,22,32,14,68
6055,Italy,2012.0,16,22,30,68
6056,Italy,1996.0,19,24,28,71
6057,Italy,2000.0,22,14,29,65
6058,Italy,2004.0,24,41,39,104
6059,Italy,2016.0,8,40,24,72
6060,Pistoja/Firenze,1906.0,21,8,27,56
6061,Italy,1928.0,24,22,26,72
6062,Italy,1928.0,24,22,26,72
6063,Italy,2004.0,24,41,39,104
6064,Italy,2004.0,24,41,39,104
6065,Italy,1980.0,8,24,8,40
6066,Italy,2004.0,24,41,39,104
6067,Italy,1952.0,18,22,16,56
6068,Italy,1960.0,36,18,35,89
6069,Italy,1976.0,3,27,5,35
6070,Italy,2012.0,16,22,30,68
6071,Italy,1920.0,67,9,8,84
6072,Italy,1928.0,24,22,26,72
6073,Italy,1980.0,8,24,8,40
6074,Italy,1984.0,31,6,28,65
6075,Italy,1984.0,31,6,28,65
6076,Italy,2012.0,16,22,30,68
6077,Italy,1996.0,19,24,28,71
6078,Italy,2000.0,22,14,29,65
6079,Italy-2,1956.0,28,17,10,55
6080,Italy,2012.0,16,22,30,68
6081,Italy,2016.0,8,40,24,72
6082,Italy,2016.0,8,40,24,72
6083,Italy,1996.0,19,24,28,71
6084,Italy,1924.0,25,5,21,51
6085,Italy,1912.0,22,1,2,25
6086,Italy,1936.0,37,34,5,76
6087,Italy,1980.0,8,24,8,40
6088,Italy,1984.0,31,6,28,65
6089,Italy,2016.0,8,40,24,72
6090,Italy,1928.0,24,22,26,72
6091,Italy,1932.0,21,38,18,77
6092,"Marinai della nave da guerra ""Varese""",1906.0,21,8,27,56
6093,Italy,2008.0,8,14,20,42
6094,Italy,2008.0,8,14,20,42
6095,Italy,1996.0,19,24,28,71
6096,Italy,2000.0,22,14,29,65
6097,Italy,2004.0,24,41,39,104
6098,Italy,2012.0,16,22,30,68
6099,Italy,1976.0,3,27,5,35
6100,Italy,1936.0,37,34,5,76
6101,Italy,1932.0,21,38,18,77
6102,Italy-1,1980.0,8,24,8,40
6103,Italy,1928.0,24,22,26,72
6104,Italy,1932.0,21,38,18,77
6105,Italy,1936.0,37,34,5,76
6106,Italy,2008.0,8,14,20,42
6107,Italy,1964.0,14,30,17,61
6108,Italy,1960.0,36,18,35,89
6109,Italy,1984.0,31,6,28,65
6110,Italy,1932.0,21,38,18,77
6111,Italy,1932.0,21,38,18,77
6112,Italy-1,2006.0,11,0,14,25
6113,Italy,1994.0,14,6,12,32
6114,Italy-1,1972.0,12,8,14,34
6115,Italy,1980.0,8,24,8,40
6116,Italy,1984.0,31,6,28,65
6117,Italy,2014.0,0,2,12,14
6118,Italy-1,1994.0,14,6,12,32
6119,Italy-1,1998.0,3,9,5,17
6120,Italy-1,1992.0,25,19,22,66
6121,Italy-2,1994.0,14,6,12,32
6122,Italy-1,1994.0,14,6,12,32
6123,Italy,1996.0,19,24,28,71
6124,Italy,2000.0,22,14,29,65
6125,Italy,2004.0,24,41,39,104
6126,Italy,2008.0,8,14,20,42
6127,Italy,2014.0,0,2,12,14
6128,Italy,2014.0,0,2,12,14
6129,Pistoja/Firenze,1906.0,21,8,27,56
6130,Pistoja/Firenze,1906.0,21,8,27,56
6131,Italy,2016.0,8,40,24,72
6132,Italy,1948.0,22,32,14,68
6133,Italy-1,2006.0,11,0,14,25
6134,Italy,1924.0,25,5,21,51
6135,Italy,1928.0,24,22,26,72
6136,Italy,2016.0,8,40,24,72
6137,Italy,1988.0,13,11,13,37
6138,Italy,2014.0,0,2,12,14
6139,Italy,1994.0,14,6,12,32
6140,Italy,1994.0,14,6,12,32
6141,Italy,2002.0,4,11,6,21
6142,Italy,1960.0,36,18,35,89
6143,Italy,1996.0,19,24,28,71
6144,Italy,1984.0,31,6,28,65
6145,Italy,2016.0,8,40,24,72
6146,Italy,1936.0,37,34,5,76
6147,Italy,2012.0,16,22,30,68
6148,Italy,1936.0,37,34,5,76
6149,Italy,1932.0,21,38,18,77
6150,Italy,1948.0,22,32,14,68
6151,Italy,2012.0,16,22,30,68
6152,Italy,1960.0,36,18,35,89
6153,Italy,1968.0,13,8,20,41
6154,Italy,2004.0,24,41,39,104
6155,Italy,1960.0,36,18,35,89
6156,Italy,1920.0,67,9,8,84
6157,Italy,1924.0,25,5,21,51
6158,Italy,1924.0,25,5,21,51
6159,Italy,1924.0,25,5,21,51
6160,Italy,1932.0,21,38,18,77
6161,Italy,1932.0,21,38,18,77
6162,Italy,1920.0,67,9,8,84
6163,Italy,1928.0,24,22,26,72
6164,Italy,1906.0,21,8,27,56
6165,Italy,1936.0,37,34,5,76
6166,Italy,1936.0,37,34,5,76
6167,Italy,2016.0,8,40,24,72
6168,Italy,1924.0,25,5,21,51
6169,Italy,1992.0,25,19,22,66
6170,Italy,1948.0,22,32,14,68
6171,Italy,2016.0,8,40,24,72
6172,Italy,1960.0,36,18,35,89
6173,Italy,1960.0,36,18,35,89
6174,Italy,1912.0,22,1,2,25
6175,Italy,1920.0,67,9,8,84
6176,Italy,1956.0,28,17,10,55
6177,Italy,1984.0,31,6,28,65
6178,Italy,1984.0,31,6,28,65
6179,Italy,1920.0,67,9,8,84
6180,Italy,1924.0,25,5,21,51
6181,Italy,2000.0,22,14,29,65
6182,Italy,1908.0,2,6,0,8
6183,Italy-1,2016.0,8,40,24,72
6184,Italy,1928.0,24,22,26,72
6185,Italy,2000.0,22,14,29,65
6186,Italy,1984.0,31,6,28,65
6187,Italy,1988.0,13,11,13,37
6188,Italy,1992.0,25,19,22,66
6189,Italy,1968.0,13,8,20,41
6190,Italy,1972.0,12,8,14,34
6191,Italy,1976.0,3,27,5,35
6192,Italy,1980.0,8,24,8,40
6193,Italy,1920.0,67,9,8,84
6194,Italy,2000.0,22,14,29,65
6195,Italy,2004.0,24,41,39,104
6196,Italy,1928.0,24,22,26,72
6197,Italy,1984.0,31,6,28,65
6198,Italy,1912.0,22,1,2,25
6199,Italy,1920.0,67,9,8,84
6200,Italy,1924.0,25,5,21,51
6201,Italy-1,1964.0,14,30,17,61
6202,Italy,1998.0,3,9,5,17
6203,Italy,2002.0,4,11,6,21
6204,Italy,1948.0,22,32,14,68
6205,Italy,1928.0,24,22,26,72
6206,Italy,2004.0,24,41,39,104
6207,Italy,1980.0,8,24,8,40
6208,Italy,1964.0,14,30,17,61
6209,Italy,1972.0,12,8,14,34
6210,Italy,1972.0,12,8,14,34
6211,Italy,1920.0,67,9,8,84
6212,Italy,1924.0,25,5,21,51
6213,Italy,1948.0,22,32,14,68
6214,Italy,2012.0,16,22,30,68
6215,Italy,1912.0,22,1,2,25
6216,Italy,1912.0,22,1,2,25
6217,Italy,1920.0,67,9,8,84
6218,Italy,1948.0,22,32,14,68
6219,Italy,1952.0,18,22,16,56
6220,Italy,1952.0,18,22,16,56
6221,Italy,1936.0,37,34,5,76
6222,Italy,1948.0,22,32,14,68
6223,Italy,1948.0,22,32,14,68
6224,Italy,1948.0,22,32,14,68
6225,Italy,1952.0,18,22,16,56
6226,Italy,1952.0,18,22,16,56
6227,Italy,1952.0,18,22,16,56
6228,Italy,1952.0,18,22,16,56
6229,Italy,1956.0,28,17,10,55
6230,Italy,1956.0,28,17,10,55
6231,Italy,1956.0,28,17,10,55
6232,Italy,1960.0,36,18,35,89
6233,Italy,1960.0,36,18,35,89
6234,Italy,1960.0,36,18,35,89
6235,Italy,1952.0,18,22,16,56
6236,Italy,1960.0,36,18,35,89
6237,Italy,1924.0,25,5,21,51
6238,Italy,1964.0,14,30,17,61
6239,Italy,1964.0,14,30,17,61
6240,Italy,1984.0,31,6,28,65
6241,Italy,1928.0,24,22,26,72
6242,Italy,1968.0,13,8,20,41
6243,Italy,1936.0,37,34,5,76
6244,Italy,2004.0,24,41,39,104
6245,Italy,1932.0,21,38,18,77
6246,Italy-1,2002.0,4,11,6,21
6247,Italy,1976.0,3,27,5,35
6248,Italy,1936.0,37,34,5,76
6249,Italy,1984.0,31,6,28,65
6250,Italy,1984.0,31,6,28,65
6251,Italy,1988.0,13,11,13,37
6252,Italy,1992.0,25,19,22,66
6253,Italy,1948.0,22,32,14,68
6254,Italy,1960.0,36,18,35,89
6255,Italy,1920.0,67,9,8,84
6256,Italy,1920.0,67,9,8,84
6257,Italy,1976.0,3,27,5,35
6258,Italy,1992.0,25,19,22,66
6259,Italy,1976.0,3,27,5,35
6260,Italy,1996.0,19,24,28,71
6261,Italy,2000.0,22,14,29,65
6262,Italy,1924.0,25,5,21,51
6263,Italy,1924.0,25,5,21,51
6264,Italy,1928.0,24,22,26,72
6265,Italy,1932.0,21,38,18,77
6266,Italy,1932.0,21,38,18,77
6267,Italy,1932.0,21,38,18,77
6268,Italy,1936.0,37,34,5,76
6269,Italy,1936.0,37,34,5,76
6270,Italy,1936.0,37,34,5,76
6271,Italy,1960.0,36,18,35,89
6272,Italy,1980.0,8,24,8,40
6273,Italy,1984.0,31,6,28,65
6274,Italy,1984.0,31,6,28,65
6275,Italy,1988.0,13,11,13,37
6276,Italy,2004.0,24,41,39,104
6277,Italy,1936.0,37,34,5,76
6278,Pistoja/Firenze,1906.0,21,8,27,56
6279,Pistoja/Firenze,1906.0,21,8,27,56
6280,Italy,1952.0,18,22,16,56
6281,Italy,2004.0,24,41,39,104
6282,Italy,1984.0,31,6,28,65
6283,Italy,1984.0,31,6,28,65
6284,Italy,1988.0,13,11,13,37
6285,Italy,1988.0,13,11,13,37
6286,Italy,1992.0,25,19,22,66
6287,Italy,2000.0,22,14,29,65
6288,Italy,2004.0,24,41,39,104
6289,Italy,2012.0,16,22,30,68
6290,Italy,1920.0,67,9,8,84
6291,Italy,1936.0,37,34,5,76
6292,Italy,1964.0,14,30,17,61
6293,Italy,1932.0,21,38,18,77
6294,"Marinai della nave da guerra ""Varese""",1906.0,21,8,27,56
6295,Italy,1996.0,19,24,28,71
6296,Italy,2000.0,22,14,29,65
6297,Italy,1912.0,22,1,2,25
6298,Italy,1912.0,22,1,2,25
6299,Pistoja/Firenze,1906.0,21,8,27,56
6300,Italy,1984.0,31,6,28,65
6301,Italy,1996.0,19,24,28,71
6302,Italy,2000.0,22,14,29,65
6303,Italy,1980.0,8,24,8,40
6304,Italy,1984.0,31,6,28,65
6305,Italy,1988.0,13,11,13,37
6306,Italy,1924.0,25,5,21,51
6307,Italy,1980.0,8,24,8,40
6308,Italy,1960.0,36,18,35,89
6309,Italy,1960.0,36,18,35,89
6310,Italy,1964.0,14,30,17,61
6311,Italy,1964.0,14,30,17,61
6312,Italy,1964.0,14,30,17,61
6313,Italy,1972.0,12,8,14,34
6314,Italy,1980.0,8,24,8,40
6315,Italy,1980.0,8,24,8,40
6316,"Marinai della nave da guerra ""Varese""",1906.0,21,8,27,56
6317,Italy,1996.0,19,24,28,71
6318,Italy,2000.0,22,14,29,65
6319,Italy,1936.0,37,34,5,76
6320,Italy,1996.0,19,24,28,71
6321,Italy,1952.0,18,22,16,56
6322,"Marinai della nave da guerra ""Varese""",1906.0,21,8,27,56
6323,Italy,2004.0,24,41,39,104
6324,Italy,2004.0,24,41,39,104
6325,Italy,2004.0,24,41,39,104
6326,Italy,1932.0,21,38,18,77
6327,Italy,1936.0,37,34,5,76
6328,Italy,2000.0,22,14,29,65
6329,Italy,2008.0,8,14,20,42
6330,Italy,1928.0,24,22,26,72
6331,Italy,1932.0,21,38,18,77
6332,Italy-2,1956.0,28,17,10,55
6333,Italy,1948.0,22,32,14,68
6334,Italy,2000.0,22,14,29,65
6335,Italy,2012.0,16,22,30,68
6336,Italy,2012.0,16,22,30,68
6337,Italy,1936.0,37,34,5,76
6338,Italy,1948.0,22,32,14,68
6339,Italy,2004.0,24,41,39,104
6340,Italy,2004.0,24,41,39,104
6341,Italy,2008.0,8,14,20,42
6342,Italy,2012.0,16,22,30,68
6343,Italy,1976.0,3,27,5,35
6344,Italy,1972.0,12,8,14,34
6345,Italy,1976.0,3,27,5,35
6346,Italy,1980.0,8,24,8,40
6347,Italy,1972.0,12,8,14,34
6348,Italy,1976.0,3,27,5,35
6349,Italy,1976.0,3,27,5,35
6350,Italy,1952.0,18,22,16,56
6351,Italy,1948.0,22,32,14,68
6352,Italy-2,1956.0,28,17,10,55
6353,Italy-2,1956.0,28,17,10,55
6354,Italy-1,1964.0,14,30,17,61
6355,Italy-2,1964.0,14,30,17,61
6356,Italy-1,1968.0,13,8,20,41
6357,Italy-1,1968.0,13,8,20,41
6358,Italy,2016.0,8,40,24,72
6359,Italy,1964.0,14,30,17,61
6360,Italy,2012.0,16,22,30,68
6361,Italy,1968.0,13,8,20,41
6362,Italia,1936.0,37,34,5,76
6363,Italy,2004.0,24,41,39,104
6364,Italy,1952.0,18,22,16,56
6365,Italy,1952.0,18,22,16,56
6366,Italy,1924.0,25,5,21,51
6367,Italy,1924.0,25,5,21,51
6368,Italy,2004.0,24,41,39,104
6369,Italy,1932.0,21,38,18,77
6370,Italy,1948.0,22,32,14,68
6371,Italy,2000.0,22,14,29,65
6372,Italy,1998.0,3,9,5,17
6373,Italy,1984.0,31,6,28,65
6374,Italy,1960.0,36,18,35,89
6375,Italy,2004.0,24,41,39,104
6376,Italy,1920.0,67,9,8,84
6377,Italy,1920.0,67,9,8,84
6378,Italy,1920.0,67,9,8,84
6379,Italy,1920.0,67,9,8,84
6380,Italy,1912.0,22,1,2,25
6381,Italy,1920.0,67,9,8,84
6382,Italy,1920.0,67,9,8,84
6383,Italy,1920.0,67,9,8,84
6384,Italy,1920.0,67,9,8,84
6385,Italy,1920.0,67,9,8,84
6386,Italy,1984.0,31,6,28,65
6387,Italy,1936.0,37,34,5,76
6388,Italy,1936.0,37,34,5,76
6389,Italy,1956.0,28,17,10,55
6390,Italy,1928.0,24,22,26,72
6391,Italy,1932.0,21,38,18,77
6392,Italy,1932.0,21,38,18,77
6393,Italy,1932.0,21,38,18,77
6394,Pistoja/Firenze,1906.0,21,8,27,56
6395,Italy,2008.0,8,14,20,42
6396,Italy,2012.0,16,22,30,68
6397,Italy-1,2016.0,8,40,24,72
6398,Italy,1920.0,67,9,8,84
6399,Italy,1932.0,21,38,18,77
6400,Italy,1968.0,13,8,20,41
6401,Italy,2016.0,8,40,24,72
6402,"Marinai della nave da guerra ""Varese""",1906.0,21,8,27,56
6403,Italy,1948.0,22,32,14,68
6404,Italy,1948.0,22,32,14,68
6405,Italy,1948.0,22,32,14,68
6406,Italy,1952.0,18,22,16,56
6407,Italy,1952.0,18,22,16,56
6408,Italy,1908.0,2,6,0,8
6409,Italy,1984.0,31,6,28,65
6410,Italy,1984.0,31,6,28,65
6411,Italy,1984.0,31,6,28,65
6412,Italy,2014.0,0,2,12,14
6413,Italy,1936.0,37,34,5,76
6414,Italy,2008.0,8,14,20,42
6415,Italy,2012.0,16,22,30,68
6416,Italy,2012.0,16,22,30,68
6417,"Marinai della nave da guerra ""Varese""",1906.0,21,8,27,56
6418,Italy,1956.0,28,17,10,55
6419,Italy,1948.0,22,32,14,68
6420,Italy,1952.0,18,22,16,56
6421,Italy,1920.0,67,9,8,84
6422,Italy,1924.0,25,5,21,51
6423,Italy,1980.0,8,24,8,40
6424,Italy,1908.0,2,6,0,8
6425,Italy,1920.0,67,9,8,84
6426,Italy,1920.0,67,9,8,84
6427,Italy,1932.0,21,38,18,77
6428,Italy,1960.0,36,18,35,89
6429,Italy,1956.0,28,17,10,55
6430,Italy,1928.0,24,22,26,72
6431,Italy,1972.0,12,8,14,34
6432,Italy,1968.0,13,8,20,41
6433,Italy,2012.0,16,22,30,68
6434,Italy,2004.0,24,41,39,104
6435,Italy,2016.0,8,40,24,72
6436,Italy,1960.0,36,18,35,89
6437,Italy,1964.0,14,30,17,61
6438,Italy,1968.0,13,8,20,41
6439,Italy,1948.0,22,32,14,68
6440,Italy,1948.0,22,32,14,68
6441,Italy,1976.0,3,27,5,35
6442,Italy,1964.0,14,30,17,61
6443,Italy,1996.0,19,24,28,71
6444,Italy,2000.0,22,14,29,65
6445,Italy,2004.0,24,41,39,104
6446,Italy,2012.0,16,22,30,68
6447,Italy,1996.0,19,24,28,71
6448,Italy,1920.0,67,9,8,84
6449,Italy,1924.0,25,5,21,51
6450,Italy,1988.0,13,11,13,37
6451,Italy,1960.0,36,18,35,89
6452,Italy,2012.0,16,22,30,68
6453,Italy,1932.0,21,38,18,77
6454,Italy,1992.0,25,19,22,66
6455,Italy,1994.0,14,6,12,32
6456,Italy,1998.0,3,9,5,17
6457,Italy,2002.0,4,11,6,21
6458,Italy,2006.0,11,0,14,25
6459,Italy,1960.0,36,18,35,89
6460,Italy,1988.0,13,11,13,37
6461,Italy,1988.0,13,11,13,37
6462,Italy,2004.0,24,41,39,104
6463,Italy,2008.0,8,14,20,42
6464,Italy,1920.0,67,9,8,84
6465,Italy,2012.0,16,22,30,68
6466,Italy,1932.0,21,38,18,77
6467,Italy,1932.0,21,38,18,77
6468,Italy,1952.0,18,22,16,56
6469,Italy,1956.0,28,17,10,55
6470,Italy,1956.0,28,17,10,55
6471,Italy,1960.0,36,18,35,89
6472,Italy,1932.0,21,38,18,77
6473,Italy,2004.0,24,41,39,104
6474,Italy,1912.0,22,1,2,25
6475,Italy,2004.0,24,41,39,104
6476,Italy,2008.0,8,14,20,42
6477,Italy,1956.0,28,17,10,55
6478,Italy,1960.0,36,18,35,89
6479,Italy,1960.0,36,18,35,89
6480,Italy,1964.0,14,30,17,61
6481,Italy,2004.0,24,41,39,104
6482,Italy,2000.0,22,14,29,65
6483,Italy,2004.0,24,41,39,104
6484,Italy,2008.0,8,14,20,42
6485,Italy,2016.0,8,40,24,72
6486,Italy,1948.0,22,32,14,68
6487,Italy,1952.0,18,22,16,56
6488,Italy,1952.0,18,22,16,56
6489,Italy,1932.0,21,38,18,77
6490,Italy,1996.0,19,24,28,71
6491,Italy,1980.0,8,24,8,40
6492,Italy,1984.0,31,6,28,65
6493,Italy,1928.0,24,22,26,72
6494,Italy,1952.0,18,22,16,56
6495,Italy,2014.0,0,2,12,14
6496,Italy,2012.0,16,22,30,68
6497,Italy,1992.0,25,19,22,66
6498,Italy,1948.0,22,32,14,68
6499,Italy,1996.0,19,24,28,71
6500,Italy,1948.0,22,32,14,68
6501,Italy,1928.0,24,22,26,72
6502,Italy,1956.0,28,17,10,55
6503,Italy,1928.0,24,22,26,72
6504,Italy,1932.0,21,38,18,77
6505,Italy,1928.0,24,22,26,72
6506,Italy,1964.0,14,30,17,61
6507,Italy,1964.0,14,30,17,61
6508,Italy,2000.0,22,14,29,65
6509,Italy,1936.0,37,34,5,76
6510,Italy,1996.0,19,24,28,71
6511,Italy,2000.0,22,14,29,65
6512,Italy,2016.0,8,40,24,72
6513,Italy,2008.0,8,14,20,42
6514,Italy,1936.0,37,34,5,76
6515,Italy,1948.0,22,32,14,68
6516,"Marinai della nave da guerra ""Varese""",1906.0,21,8,27,56
6517,Italy,1992.0,25,19,22,66
6518,Italy,2000.0,22,14,29,65
6519,Italy,1932.0,21,38,18,77
6520,Italy,1928.0,24,22,26,72
6521,Italy,1956.0,28,17,10,55
6522,Italy,1956.0,28,17,10,55
6523,Italy,1972.0,12,8,14,34
6524,Italy,1928.0,24,22,26,72
6525,Italy,1932.0,21,38,18,77
6526,Italy,1932.0,21,38,18,77
6527,Italy,2002.0,4,11,6,21
6528,Italy,2006.0,11,0,14,25
6529,Italy,2006.0,11,0,14,25
6530,Italy,2010.0,1,1,3,5
6531,Italy,1952.0,18,22,16,56
6532,Italy,1956.0,28,17,10,55
6533,Italy,1964.0,14,30,17,61
6534,Italy,1936.0,37,34,5,76
6535,Italy,1948.0,22,32,14,68
6536,Italy,1948.0,22,32,14,68
6537,Italy,1952.0,18,22,16,56
6538,Italy,2004.0,24,41,39,104
6539,Italy,2004.0,24,41,39,104
6540,Italy,2004.0,24,41,39,104
6541,Italy,1908.0,2,6,0,8
6542,Italy,2010.0,1,1,3,5
6543,Italy,1928.0,24,22,26,72
6544,Italy,1956.0,28,17,10,55
6545,Italy,1928.0,24,22,26,72
6546,Italy,1960.0,36,18,35,89
6547,"Marinai della nave da guerra ""Varese""",1906.0,21,8,27,56
6548,Italy,2016.0,8,40,24,72
6549,Italy-1,1972.0,12,8,14,34
6550,Italy,1976.0,3,27,5,35
6551,Italy-1,2006.0,11,0,14,25
6552,Italy,1932.0,21,38,18,77
6553,Italia,1936.0,37,34,5,76
6554,Italia,1936.0,37,34,5,76
6555,Italy,1984.0,31,6,28,65
6556,Bucintoro Venezia,1906.0,21,8,27,56
6557,Italy,1988.0,13,11,13,37
6558,Italy,1992.0,25,19,22,66
6559,Italy,1952.0,18,22,16,56
6560,Italy,1980.0,8,24,8,40
6561,Italy,1960.0,36,18,35,89
6562,Italy,2016.0,8,40,24,72
6563,Italy,1992.0,25,19,22,66
6564,Italy,1996.0,19,24,28,71
6565,Italy,1908.0,2,6,0,8
6566,Italy,1992.0,25,19,22,66
6567,Italy,1992.0,25,19,22,66
6568,Italy,2004.0,24,41,39,104
6569,Italy,1996.0,19,24,28,71
6570,Italy,2004.0,24,41,39,104
6571,Italy,2012.0,16,22,30,68
6572,Italy,2012.0,16,22,30,68
6573,Italy,2016.0,8,40,24,72
6574,Italy,2016.0,8,40,24,72
6575,Italy,1932.0,21,38,18,77
6576,Italy,1998.0,3,9,5,17
6577,Italy,1948.0,22,32,14,68
6578,Italy,1996.0,19,24,28,71
6579,Italy,1992.0,25,19,22,66
6580,Italy,1920.0,67,9,8,84
6581,Italy,1920.0,67,9,8,84
6582,Italy,1924.0,25,5,21,51
6583,Italy,1928.0,24,22,26,72
6584,Italy,1928.0,24,22,26,72
6585,Italy,2002.0,4,11,6,21
6586,Italy,1928.0,24,22,26,72
6587,Italy,1936.0,37,34,5,76
6588,Italy,2016.0,8,40,24,72
6589,Italy,2008.0,8,14,20,42
6590,Italy,1948.0,22,32,14,68
6591,Italy,1952.0,18,22,16,56
6592,Italy,1948.0,22,32,14,68
6593,Italy,2016.0,8,40,24,72
6594,Italy,2004.0,24,41,39,104
6595,Italy-1,1992.0,25,19,22,66
6596,Italy-2,1994.0,14,6,12,32
6597,Italy,1936.0,37,34,5,76
6598,Italy,1932.0,21,38,18,77
6599,Italy,1936.0,37,34,5,76
6600,Italy,1936.0,37,34,5,76
6601,Italy,1948.0,22,32,14,68
6602,Italy,1960.0,36,18,35,89
6603,Italy,1964.0,14,30,17,61
6604,Italy,1972.0,12,8,14,34
6605,Italy,2004.0,24,41,39,104
6606,Italy,2000.0,22,14,29,65
6607,Italy,2008.0,8,14,20,42
6608,Italy,1964.0,14,30,17,61
6609,Italy,1996.0,19,24,28,71
6610,Italy,2000.0,22,14,29,65
6611,"Marinai della nave da guerra ""Varese""",1906.0,21,8,27,56
6612,Italy,1972.0,12,8,14,34
6613,Italy,1936.0,37,34,5,76
6614,Italy,1960.0,36,18,35,89
6615,Italy,1964.0,14,30,17,61
6616,Italy,1964.0,14,30,17,61
6617,Italy,2010.0,1,1,3,5
6618,Italy,1984.0,31,6,28,65
6619,Italia,1936.0,37,34,5,76
6620,Italy,1928.0,24,22,26,72
6621,Italy,1932.0,21,38,18,77
6622,Italy,1936.0,37,34,5,76
6623,Italy,1936.0,37,34,5,76
6624,Italy,2008.0,8,14,20,42
6625,Italy,2004.0,24,41,39,104
6626,Italy,1968.0,13,8,20,41
6627,Italy,1972.0,12,8,14,34
6628,Italy-2,1964.0,14,30,17,61
6629,Italy,1936.0,37,34,5,76
6630,Italy,1920.0,67,9,8,84
6631,Italy,1928.0,24,22,26,72
6632,Merope,1952.0,18,22,16,56
6633,Merope III,1956.0,28,17,10,55
6634,Italy,2002.0,4,11,6,21
6635,Italy,1980.0,8,24,8,40
6636,Italy,1980.0,8,24,8,40
6637,Italy,1980.0,8,24,8,40
6638,Italy,1912.0,22,1,2,25
6639,Italy,1980.0,8,24,8,40
6640,Italy,2004.0,24,41,39,104
6641,Italy,2008.0,8,14,20,42
6642,Italy,1964.0,14,30,17,61
6643,Italy,1968.0,13,8,20,41
6644,Italy,1964.0,14,30,17,61
6645,Italy,2000.0,22,14,29,65
6646,Italy,1920.0,67,9,8,84
6647,Italy,1928.0,24,22,26,72
6648,Italy,2000.0,22,14,29,65
6649,Italy,2000.0,22,14,29,65
6650,Italy,2000.0,22,14,29,65
6651,Italy,2004.0,24,41,39,104
6652,Italy,1992.0,25,19,22,66
6653,Italy,2016.0,8,40,24,72
6654,Italy,1928.0,24,22,26,72
6655,Italy,1992.0,25,19,22,66
6656,Italy,1996.0,19,24,28,71
6657,Italy,1996.0,19,24,28,71
6658,Italy,2000.0,22,14,29,65
6659,Italy,2004.0,24,41,39,104
6660,Italy,1928.0,24,22,26,72
6661,Italy,1960.0,36,18,35,89
6662,"Marinai della nave da guerra ""Varese""",1906.0,21,8,27,56
6663,Italy,1932.0,21,38,18,77
6664,Italy,2012.0,16,22,30,68
6665,Italy,1956.0,28,17,10,55
6666,Italy,1960.0,36,18,35,89
6667,Italy,2016.0,8,40,24,72
6668,Italy,2000.0,22,14,29,65
6669,Italy,2008.0,8,14,20,42
6670,Italy,1932.0,21,38,18,77
6671,Italy,1948.0,22,32,14,68
6672,Italy,1952.0,18,22,16,56
6673,"Marinai della nave da guerra ""Varese""",1906.0,21,8,27,56
6674,Italy,2000.0,22,14,29,65
6675,Italy,2008.0,8,14,20,42
6676,Italy,2012.0,16,22,30,68
6677,"Marinai della nave da guerra ""Varese""",1906.0,21,8,27,56
6678,Italy,1960.0,36,18,35,89
6679,Italy,1964.0,14,30,17,61
6680,Italy,1968.0,13,8,20,41
6681,Italy,1980.0,8,24,8,40
6682,Italy,1952.0,18,22,16,56
6683,Italy,1992.0,25,19,22,66
6684,Italy,1928.0,24,22,26,72
6685,Italy,1932.0,21,38,18,77
6686,Italy,1964.0,14,30,17,61
6687,Italy,1968.0,13,8,20,41
6688,Italy,1972.0,12,8,14,34
6689,Italy,2008.0,8,14,20,42
6690,Italy,2012.0,16,22,30,68
6691,Italy,1912.0,22,1,2,25
6692,Italy,1920.0,67,9,8,84
6693,Italy,1932.0,21,38,18,77
6694,Italy,1968.0,13,8,20,41
6695,Italy,2012.0,16,22,30,68
6696,Italy,2006.0,11,0,14,25
6697,Italy,2016.0,8,40,24,72
6698,Italy,1920.0,67,9,8,84
6699,Italy,1900.0,3,2,0,5
6700,Italy,1936.0,37,34,5,76
6701,Italy,2004.0,24,41,39,104
6702,Italy,2012.0,16,22,30,68
6703,Italy,2000.0,22,14,29,65
6704,Italy,2004.0,24,41,39,104
6705,Italy,2004.0,24,41,39,104
6706,Italy,2008.0,8,14,20,42
6707,Italy,1960.0,36,18,35,89
6708,Italy,2008.0,8,14,20,42
6709,Italy,2012.0,16,22,30,68
6710,Italy,1924.0,25,5,21,51
6711,Italy,1928.0,24,22,26,72
6712,"Marinai della nave da guerra ""Varese""",1906.0,21,8,27,56
6713,Italy,1996.0,19,24,28,71
6714,Italy,2000.0,22,14,29,65
6715,Italy,2004.0,24,41,39,104
6716,Italy,2000.0,22,14,29,65
6717,Italy,2004.0,24,41,39,104
6718,Italy,2012.0,16,22,30,68
6719,Italy,2000.0,22,14,29,65
6720,Italy,2012.0,16,22,30,68
6721,Italy,1912.0,22,1,2,25
6722,Italy,2012.0,16,22,30,68
6723,Italy,2008.0,8,14,20,42
6724,Italy,1980.0,8,24,8,40
6725,Italy,1984.0,31,6,28,65
6726,Italy,1988.0,13,11,13,37
6727,Italy,1988.0,13,11,13,37
6728,Italy,1972.0,12,8,14,34
6729,Italy,1996.0,19,24,28,71
6730,Italy,2000.0,22,14,29,65
6731,Italy,1936.0,37,34,5,76
6732,Italy,1996.0,19,24,28,71
6733,Italy,1996.0,19,24,28,71
6734,Italy,1920.0,67,9,8,84
6735,Italy,1924.0,25,5,21,51
6736,Italy,1932.0,21,38,18,77
6737,Italy,1928.0,24,22,26,72
6738,Italy,2008.0,8,14,20,42
6739,Italy,1980.0,8,24,8,40
6740,Italy,1984.0,31,6,28,65
6741,Italy,2004.0,24,41,39,104
6742,Italy,1984.0,31,6,28,65
6743,Italy,1936.0,37,34,5,76
6744,Italy,1932.0,21,38,18,77
6745,Italy,1932.0,21,38,18,77
6746,Italy,1996.0,19,24,28,71
6747,Italy,2000.0,22,14,29,65
6748,Italy,2004.0,24,41,39,104
6749,Italy,2008.0,8,14,20,42
6750,Italy,1936.0,37,34,5,76
6751,Italy,1956.0,28,17,10,55
6752,Italy,1960.0,36,18,35,89
6753,Italy,1948.0,22,32,14,68
6754,Italy,1992.0,25,19,22,66
6755,Italy,1996.0,19,24,28,71
6756,Italy,1972.0,12,8,14,34
6757,Italy,1976.0,3,27,5,35
6758,Italy,1976.0,3,27,5,35
6759,Italy,1980.0,8,24,8,40
6760,Italy,1984.0,31,6,28,65
6761,Italy,2004.0,24,41,39,104
6762,Italy,1976.0,3,27,5,35
6763,Italy,1968.0,13,8,20,41
6764,Italy-2,1964.0,14,30,17,61
6765,Italy-1,1964.0,14,30,17,61
6766,Italy-2,1964.0,14,30,17,61
6767,Italy,1992.0,25,19,22,66
6768,Italy,1980.0,8,24,8,40
6769,Italy,1924.0,25,5,21,51
6770,Italy,2004.0,24,41,39,104
6771,Italy,1924.0,25,5,21,51
6772,Italy,1996.0,19,24,28,71
6773,Italy,2016.0,8,40,24,72
6774,Italy,1952.0,18,22,16,56
6775,Italy,1956.0,28,17,10,55
6776,Italy,1956.0,28,17,10,55
6777,Italy,1912.0,22,1,2,25
6778,Italy,1920.0,67,9,8,84
6779,Italy,1920.0,67,9,8,84
6780,Italy,1960.0,36,18,35,89
6781,Italy,1964.0,14,30,17,61
6782,Italy,1984.0,31,6,28,65
6783,Italy,2012.0,16,22,30,68
6784,Italy,1956.0,28,17,10,55
6785,Italy,1960.0,36,18,35,89
6786,Italy,1948.0,22,32,14,68
6787,Italy,1948.0,22,32,14,68
6788,Merope,1952.0,18,22,16,56
6789,Merope III,1956.0,28,17,10,55
6790,Italy,1948.0,22,32,14,68
6791,Italy,1980.0,8,24,8,40
6792,Italy,2016.0,8,40,24,72
6793,Italy,2008.0,8,14,20,42
6794,Italy,2008.0,8,14,20,42
6795,Italy,1928.0,24,22,26,72
6796,"Marinai della nave da guerra ""Varese""",1906.0,21,8,27,56
6797,Italy,1928.0,24,22,26,72
6798,Italy,1936.0,37,34,5,76
6799,"Marinai della nave da guerra ""Varese""",1906.0,21,8,27,56
6800,"Marinai della nave da guerra ""Varese""",1906.0,21,8,27,56
6801,Italy,1996.0,19,24,28,71
6802,Italy,2004.0,24,41,39,104
6803,Italy,2008.0,8,14,20,42
6804,Italy,2012.0,16,22,30,68
6805,Italy,1948.0,22,32,14,68
6806,Italy-1,1998.0,3,9,5,17
6807,Italy,1988.0,13,11,13,37
6808,Italy,1928.0,24,22,26,72
6809,Italy,2016.0,8,40,24,72
6810,Italy,2012.0,16,22,30,68
6811,Italy,2016.0,8,40,24,72
6812,Italy,1996.0,19,24,28,71
6813,Italy,1920.0,67,9,8,84
6814,Italy,1932.0,21,38,18,77
6815,Italy,1948.0,22,32,14,68
6816,Italy,2012.0,16,22,30,68
6817,Italy,1960.0,36,18,35,89
6818,Italy,1964.0,14,30,17,61
6819,Italy,1920.0,67,9,8,84
6820,Italy,1972.0,12,8,14,34
6821,Italy,1972.0,12,8,14,34
6822,Italy,1976.0,3,27,5,35
6823,Italy,1972.0,12,8,14,34
6824,Italy,1988.0,13,11,13,37
6825,Italy,1992.0,25,19,22,66
6826,Italy-1,1994.0,14,6,12,32
6827,Italy,1948.0,22,32,14,68
6828,Italy,1988.0,13,11,13,37
6829,Italy,1996.0,19,24,28,71
6830,Italy,1984.0,31,6,28,65
6831,Italy,1932.0,21,38,18,77
6832,Italy,1996.0,19,24,28,71
6833,Italy,2000.0,22,14,29,65
6834,Italy,2004.0,24,41,39,104
6835,Italy,1932.0,21,38,18,77
6836,"Marinai della nave da guerra ""Varese""",1906.0,21,8,27,56
6837,Italy,1988.0,13,11,13,37
6838,Italy,1988.0,13,11,13,37
6839,Italy,1992.0,25,19,22,66
6840,Italy,1992.0,25,19,22,66
6841,Italy,1994.0,14,6,12,32
6842,Italy,1924.0,25,5,21,51
6843,Italy,1924.0,25,5,21,51
6844,Italy,1928.0,24,22,26,72
6845,Italy,1948.0,22,32,14,68
6846,Italy,2004.0,24,41,39,104
6847,Italy,1980.0,8,24,8,40
6848,Italy,1952.0,18,22,16,56
6849,Italy,1960.0,36,18,35,89
6850,Italy,1960.0,36,18,35,89
6851,Italy,1988.0,13,11,13,37
6852,Italy,2012.0,16,22,30,68
6853,Italy,2002.0,4,11,6,21
6854,Italy,1992.0,25,19,22,66
6855,Italy,1992.0,25,19,22,66
6856,Italy,1996.0,19,24,28,71
6857,Italy,1996.0,19,24,28,71
6858,Italy,2000.0,22,14,29,65
6859,Italy,2000.0,22,14,29,65
6860,Italy,2004.0,24,41,39,104
6861,Italy,2008.0,8,14,20,42
6862,Italy,1956.0,28,17,10,55
6863,Italy,1960.0,36,18,35,89
6864,Italy,1900.0,3,2,0,5
6865,Italy,1900.0,3,2,0,5
6866,Italy,1964.0,14,30,17,61
6867,Italy,1928.0,24,22,26,72
6868,Italy,1920.0,67,9,8,84
6869,Italy,1912.0,22,1,2,25
6870,Italy,1948.0,22,32,14,68
6871,Italy,2004.0,24,41,39,104
6872,Italy,1968.0,13,8,20,41
6873,Italy,1996.0,19,24,28,71
6874,Italy,1920.0,67,9,8,84
6875,Italy,1920.0,67,9,8,84
6876,Italy,1964.0,14,30,17,61
6877,Italy,1984.0,31,6,28,65
6878,Italy,1988.0,13,11,13,37
6879,Italy,1992.0,25,19,22,66
6880,Italy,1998.0,3,9,5,17
6881,Italy,2006.0,11,0,14,25
6882,Italy,2006.0,11,0,14,25
6883,Italy,2014.0,0,2,12,14
6884,Italy,1920.0,67,9,8,84
6885,Italy,1936.0,37,34,5,76
6886,Italy,1964.0,14,30,17,61
6887,Italy,1960.0,36,18,35,89
6888,Italy,1984.0,31,6,28,65
6889,Italy,2004.0,24,41,39,104
6890,Italy,1992.0,25,19,22,66
6891,Italy,1994.0,14,6,12,32
6892,Italy,1992.0,25,19,22,66
6893,Italy,1992.0,25,19,22,66
6894,Italy,1992.0,25,19,22,66
6895,Italy,1994.0,14,6,12,32
6896,Italy,1956.0,28,17,10,55
6897,Italy,1932.0,21,38,18,77
6898,Italy,1984.0,31,6,28,65
6899,Italy,1980.0,8,24,8,40
6900,Italy,2016.0,8,40,24,72
6901,Italy,2008.0,8,14,20,42
6902,Italy,1936.0,37,34,5,76
6903,Italy,1992.0,25,19,22,66
6904,Italy,1928.0,24,22,26,72
6905,Italy,2004.0,24,41,39,104
6906,Italy,2004.0,24,41,39,104
6907,Italy,1936.0,37,34,5,76
6908,Italy,1906.0,21,8,27,56
6909,Italy,1906.0,21,8,27,56
6910,Italy,1906.0,21,8,27,56
6911,Italy,1932.0,21,38,18,77
6912,Italy,2016.0,8,40,24,72
6913,Italy,1996.0,19,24,28,71
6914,Italy,1996.0,19,24,28,71
6915,Italy,2000.0,22,14,29,65
6916,Italy,2000.0,22,14,29,65
6917,Italy,2004.0,24,41,39,104
6918,Italy,2008.0,8,14,20,42
6919,Italy,2008.0,8,14,20,42
6920,Italy,2012.0,16,22,30,68
6921,Italy,2012.0,16,22,30,68
6922,Italy,1968.0,13,8,20,41
6923,Italy,1968.0,13,8,20,41
6924,Italy,1960.0,36,18,35,89
6925,Italy,2016.0,8,40,24,72
6926,Italy,2000.0,22,14,29,65
6927,Italy,1960.0,36,18,35,89
6928,Italy,1936.0,37,34,5,76
6929,Italy,2000.0,22,14,29,65
6930,Italy,1980.0,8,24,8,40
6931,Italy,1952.0,18,22,16,56
6932,Italy,1928.0,24,22,26,72
6933,Italy,1928.0,24,22,26,72
6934,Italy,2014.0,0,2,12,14
6935,Italy,2016.0,8,40,24,72
6936,Italy,2000.0,22,14,29,65
6937,Italy,1994.0,14,6,12,32
6938,Italy,1994.0,14,6,12,32
6939,Italy,1984.0,31,6,28,65
6940,Italy,1994.0,14,6,12,32
6941,Italy-1,2006.0,11,0,14,25
6942,Italy,2014.0,0,2,12,14
6943,Italy,2014.0,0,2,12,14
6944,Italy,1956.0,28,17,10,55
6945,Italy,1988.0,13,11,13,37
6946,Italy,1992.0,25,19,22,66
6947,Italy,1996.0,19,24,28,71
6948,Italy,1960.0,36,18,35,89
6949,Italy,1912.0,22,1,2,25
6950,Italy,1920.0,67,9,8,84
6951,Italy,1920.0,67,9,8,84
6952,Italy,1924.0,25,5,21,51
6953,Italy,1924.0,25,5,21,51
6954,Italy,2004.0,24,41,39,104
6955,Italy-1,1968.0,13,8,20,41
6956,Italy,1964.0,14,30,17,61
6957,"Marinai della nave da guerra ""Varese""",1906.0,21,8,27,56
6958,Italy,1912.0,22,1,2,25
6959,Italy-2,1964.0,14,30,17,61
6960,Bucintoro Venezia,1906.0,21,8,27,56
6961,Italy,2012.0,16,22,30,68
6962,Italy,2016.0,8,40,24,72
6963,Italy,2000.0,22,14,29,65
6964,Italy,1988.0,13,11,13,37
6965,Italy,2006.0,11,0,14,25
6966,Italy,2006.0,11,0,14,25
6967,Italy,1994.0,14,6,12,32
6968,Italy,1998.0,3,9,5,17
6969,Italy,2002.0,4,11,6,21
6970,Italy,2006.0,11,0,14,25
6971,Italy,2010.0,1,1,3,5
6972,Italy,2014.0,0,2,12,14
6973,Italy,1996.0,19,24,28,71
6974,Italy,1912.0,22,1,2,25
6975,Italy,1920.0,67,9,8,84
6976,Italy,2002.0,4,11,6,21
6977,Italy,2002.0,4,11,6,21
6978,Italy,2006.0,11,0,14,25
6979,Italy,1924.0,25,5,21,51
6980,Italy,1960.0,36,18,35,89
6981,Italy,1952.0,18,22,16,56
6982,Italy,1948.0,22,32,14,68
6983,Italy,1980.0,8,24,8,40
6984,Spain,2008.0,7,47,16,70
6985,Spain,1996.0,23,21,22,66
6986,Spain,1980.0,2,19,3,24
6987,Spain,1984.0,2,14,3,19
6988,Spain,1992.0,48,19,3,70
6989,Spain,2016.0,9,19,17,45
6990,Spain,1920.0,0,23,0,23
6991,Spain,2012.0,5,33,25,63
6992,Spain,2016.0,9,19,17,45
6993,Spain,2012.0,5,33,25,63
6994,Spain,2000.0,3,19,20,42
6995,Spain,2012.0,5,33,25,63
6996,Spain,2008.0,7,47,16,70
6997,Spain,2008.0,7,47,16,70
6998,Spain,1992.0,48,19,3,70
6999,Spain,2012.0,5,33,25,63
7000,Spain,1928.0,3,0,0,3
7001,Spain,1996.0,23,21,22,66
7002,Spain,1980.0,2,19,3,24
7003,Spain,1960.0,0,0,14,14
7004,Spain,1996.0,23,21,22,66
7005,Spain,2008.0,7,47,16,70
7006,Spain,1932.0,0,0,1,1
7007,Spain,1992.0,48,19,3,70
7008,Spain,2000.0,3,19,20,42
7009,Spain,2012.0,5,33,25,63
7010,Spain,2000.0,3,19,20,42
7011,Spain,1920.0,0,23,0,23
7012,Spain,2000.0,3,19,20,42
7013,Spain,2008.0,7,47,16,70
7014,Spain,1980.0,2,19,3,24
7015,Spain,1980.0,2,19,3,24
7016,Spain,1984.0,2,14,3,19
7017,Spain,1996.0,23,21,22,66
7018,Spain,1996.0,23,21,22,66
7019,Spain,1920.0,0,23,0,23
7020,Spain,1992.0,48,19,3,70
7021,Spain,1920.0,0,23,0,23
7022,Spain,2004.0,4,17,9,30
7023,Spain,2012.0,5,33,25,63
7024,Spain,1996.0,23,21,22,66
7025,Spain,1992.0,48,19,3,70
7026,Spain,1996.0,23,21,22,66
7027,Spain,1996.0,23,21,22,66
7028,Spain,1992.0,48,19,3,70
7029,Spain,2012.0,5,33,25,63
7030,Spain,1996.0,23,21,22,66
7031,Spain,1992.0,48,19,3,70
7032,Spain,2000.0,3,19,20,42
7033,Spain,2008.0,7,47,16,70
7034,Spain,2012.0,5,33,25,63
7035,Spain,1984.0,2,14,3,19
7036,Spain,2016.0,9,19,17,45
7037,Spain,1920.0,0,23,0,23
7038,Spain,2008.0,7,47,16,70
7039,Spain,2012.0,5,33,25,63
7040,Spain,2012.0,5,33,25,63
7041,Spain,2016.0,9,19,17,45
7042,Spain,2016.0,9,19,17,45
7043,Spain,1992.0,48,19,3,70
7044,Spain,2012.0,5,33,25,63
7045,Spain,1992.0,48,19,3,70
7046,Spain,2004.0,4,17,9,30
7047,Spain,1996.0,23,21,22,66
7048,Spain,1960.0,0,0,14,14
7049,Spain,1996.0,23,21,22,66
7050,Spain,2008.0,7,47,16,70
7051,Spain,2012.0,5,33,25,63
7052,Spain,1980.0,2,19,3,24
7053,Spain,1980.0,2,19,3,24
7054,Spain,1992.0,48,19,3,70
7055,Spain,1996.0,23,21,22,66
7056,Spain,2004.0,4,17,9,30
7057,Spain,2004.0,4,17,9,30
7058,Spain,2008.0,7,47,16,70
7059,Spain,2008.0,7,47,16,70
7060,Spain,2012.0,5,33,25,63
7061,Spain,1992.0,48,19,3,70
7062,Spain,2008.0,7,47,16,70
7063,Spain,2012.0,5,33,25,63
7064,Spain,2016.0,9,19,17,45
7065,Spain,2016.0,9,19,17,45
7066,Spain,1960.0,0,0,14,14
7067,Spain,2000.0,3,19,20,42
7068,Spain,2012.0,5,33,25,63
7069,Spain,2012.0,5,33,25,63
7070,Spain,1988.0,1,2,2,5
7071,Spain,2004.0,4,17,9,30
7072,Spain,1980.0,2,19,3,24
7073,Spain,2012.0,5,33,25,63
7074,Spain,2016.0,9,19,17,45
7075,Spain,2012.0,5,33,25,63
7076,Spain,2012.0,5,33,25,63
7077,Spain,2016.0,9,19,17,45
7078,Spain,1984.0,2,14,3,19
7079,Spain,1996.0,23,21,22,66
7080,Spain,1980.0,2,19,3,24
7081,Spain,1992.0,48,19,3,70
7082,Spain,2016.0,9,19,17,45
7083,Spain,1960.0,0,0,14,14
7084,Spain,1984.0,2,14,3,19
7085,Spain,2008.0,7,47,16,70
7086,Spain,2000.0,3,19,20,42
7087,Spain,2008.0,7,47,16,70
7088,Spain,2000.0,3,19,20,42
7089,Spain,2008.0,7,47,16,70
7090,Spain,2012.0,5,33,25,63
7091,Spain,2016.0,9,19,17,45
7092,Spain,2016.0,9,19,17,45
7093,Spain,2012.0,5,33,25,63
7094,Spain,2016.0,9,19,17,45
7095,Spain,2012.0,5,33,25,63
7096,Spain,2008.0,7,47,16,70
7097,Spain,1900.0,2,0,0,2
7098,Spain,1920.0,0,23,0,23
7099,Spain,1920.0,0,23,0,23
7100,Spain,1984.0,2,14,3,19
7101,Spain,1980.0,2,19,3,24
7102,Spain,2000.0,3,19,20,42
7103,Spain,2004.0,4,17,9,30
7104,Spain,2008.0,7,47,16,70
7105,Spain,1960.0,0,0,14,14
7106,Spain,1980.0,2,19,3,24
7107,Spain,1960.0,0,0,14,14
7108,Spain,1996.0,23,21,22,66
7109,Spain,2016.0,9,19,17,45
7110,Spain,1992.0,48,19,3,70
7111,Spain,1988.0,1,2,2,5
7112,Spain,1984.0,2,14,3,19
7113,Spain,1992.0,48,19,3,70
7114,Spain,1960.0,0,0,14,14
7115,Spain,1960.0,0,0,14,14
7116,Spain,1996.0,23,21,22,66
7117,Spain,2000.0,3,19,20,42
7118,Spain,2008.0,7,47,16,70
7119,Spain,2012.0,5,33,25,63
7120,Spain,1920.0,0,23,0,23
7121,Spain,1960.0,0,0,14,14
7122,Spain,2012.0,5,33,25,63
7123,Spain,2008.0,7,47,16,70
7124,Spain,2008.0,7,47,16,70
7125,Spain,2008.0,7,47,16,70
7126,Spain,1996.0,23,21,22,66
7127,Spain,2004.0,4,17,9,30
7128,Spain,2004.0,4,17,9,30
7129,Spain,1996.0,23,21,22,66
7130,Spain,2004.0,4,17,9,30
7131,Spain,2012.0,5,33,25,63
7132,Spain,2000.0,3,19,20,42
7133,Spain,1996.0,23,21,22,66
7134,Spain,1976.0,0,6,0,6
7135,Spain,2012.0,5,33,25,63
7136,Spain,1992.0,48,19,3,70
7137,Spain,1996.0,23,21,22,66
7138,Spain,1996.0,23,21,22,66
7139,Spain,2008.0,7,47,16,70
7140,Spain,1980.0,2,19,3,24
7141,Spain,2008.0,7,47,16,70
7142,Spain,2012.0,5,33,25,63
7143,Spain,2012.0,5,33,25,63
7144,Spain,2004.0,4,17,9,30
7145,Spain,1996.0,23,21,22,66
7146,Spain,2000.0,3,19,20,42
7147,Spain,1996.0,23,21,22,66
7148,Spain,2008.0,7,47,16,70
7149,Spain,2008.0,7,47,16,70
7150,Spain,2012.0,5,33,25,63
7151,Spain,2016.0,9,19,17,45
7152,Spain,2004.0,4,17,9,30
7153,Spain,2008.0,7,47,16,70
7154,Spain,1992.0,48,19,3,70
7155,Spain,1972.0,1,0,1,2
7156,Spain,1992.0,48,19,3,70
7157,Spain,2004.0,4,17,9,30
7158,Spain,2004.0,4,17,9,30
7159,Spain,2000.0,3,19,20,42
7160,Spain,1920.0,0,23,0,23
7161,Spain,1920.0,0,23,0,23
7162,Spain,1996.0,23,21,22,66
7163,Spain,2008.0,7,47,16,70
7164,Spain,2008.0,7,47,16,70
7165,Spain,2008.0,7,47,16,70
7166,Spain,2012.0,5,33,25,63
7167,Spain,2012.0,5,33,25,63
7168,Spain,2000.0,3,19,20,42
7169,Spain,1992.0,48,19,3,70
7170,Spain,2000.0,3,19,20,42
7171,Spain,2008.0,7,47,16,70
7172,Spain,2008.0,7,47,16,70
7173,Spain,1948.0,0,3,0,3
7174,Spain,1992.0,48,19,3,70
7175,Spain,1980.0,2,19,3,24
7176,Spain,2008.0,7,47,16,70
7177,Spain,1928.0,3,0,0,3
7178,Spain,2012.0,5,33,25,63
7179,Spain,2012.0,5,33,25,63
7180,Spain,1992.0,48,19,3,70
7181,Spain,1996.0,23,21,22,66
7182,Spain,1996.0,23,21,22,66
7183,Spain,1996.0,23,21,22,66
7184,Spain,2000.0,3,19,20,42
7185,Spain,1980.0,2,19,3,24
7186,Spain,2008.0,7,47,16,70
7187,Spain,2008.0,7,47,16,70
7188,Spain,2012.0,5,33,25,63
7189,Spain,2008.0,7,47,16,70
7190,Spain,2012.0,5,33,25,63
7191,Spain,2016.0,9,19,17,45
7192,Spain,2016.0,9,19,17,45
7193,Spain,1948.0,0,3,0,3
7194,Spain,2016.0,9,19,17,45
7195,Spain,1920.0,0,23,0,23
7196,Spain,1996.0,23,21,22,66
7197,Spain,2012.0,5,33,25,63
7198,Spain,1992.0,48,19,3,70
7199,Spain,1996.0,23,21,22,66
7200,Spain,1996.0,23,21,22,66
7201,Spain,2012.0,5,33,25,63
7202,Spain,2016.0,9,19,17,45
7203,Spain,1992.0,48,19,3,70
7204,Spain,1992.0,48,19,3,70
7205,Spain,1996.0,23,21,22,66
7206,Spain,1976.0,0,6,0,6
7207,Spain,1988.0,1,2,2,5
7208,Spain,1992.0,48,19,3,70
7209,Spain,1992.0,48,19,3,70
7210,Spain,1996.0,23,21,22,66
7211,Spain,2000.0,3,19,20,42
7212,Spain,1996.0,23,21,22,66
7213,Spain,2008.0,7,47,16,70
7214,Spain,2012.0,5,33,25,63
7215,Spain,2004.0,4,17,9,30
7216,Spain,1996.0,23,21,22,66
7217,Spain,1992.0,48,19,3,70
7218,Spain,2016.0,9,19,17,45
7219,Spain,2004.0,4,17,9,30
7220,Spain,1992.0,48,19,3,70
7221,Spain,1996.0,23,21,22,66
7222,Spain,2008.0,7,47,16,70
7223,Spain,2012.0,5,33,25,63
7224,Spain,1996.0,23,21,22,66
7225,Spain,1984.0,2,14,3,19
7226,Spain,2008.0,7,47,16,70
7227,Spain,2004.0,4,17,9,30
7228,Spain,2000.0,3,19,20,42
7229,Spain,1996.0,23,21,22,66
7230,Spain,1992.0,48,19,3,70
7231,Spain,2012.0,5,33,25,63
7232,Spain,2000.0,3,19,20,42
7233,Spain,1996.0,23,21,22,66
7234,Spain,1992.0,48,19,3,70
7235,Spain,1984.0,2,14,3,19
7236,Spain,1952.0,0,1,0,1
7237,Spain,1996.0,23,21,22,66
7238,Spain,2000.0,3,19,20,42
7239,Spain,2004.0,4,17,9,30
7240,Spain,2008.0,7,47,16,70
7241,Spain,2008.0,7,47,16,70
7242,Spain,1980.0,2,19,3,24
7243,Spain,1984.0,2,14,3,19
7244,Spain,2012.0,5,33,25,63
7245,Spain,2016.0,9,19,17,45
7246,Spain,2016.0,9,19,17,45
7247,Spain,1976.0,0,6,0,6
7248,Spain,1984.0,2,14,3,19
7249,Spain,1992.0,48,19,3,70
7250,Spain,2008.0,7,47,16,70
7251,Spain,2012.0,5,33,25,63
7252,Spain-2,2016.0,9,19,17,45
7253,Spain,2012.0,5,33,25,63
7254,Spain,2008.0,7,47,16,70
7255,Spain,1988.0,1,2,2,5
7256,Spain,1980.0,2,19,3,24
7257,Spain,1992.0,48,19,3,70
7258,Spain,1996.0,23,21,22,66
7259,Spain,2000.0,3,19,20,42
7260,Spain,2008.0,7,47,16,70
7261,Spain,1996.0,23,21,22,66
7262,Spain,2000.0,3,19,20,42
7263,Spain,1992.0,48,19,3,70
7264,Spain,2000.0,3,19,20,42
7265,Spain,1960.0,0,0,14,14
7266,Spain,2004.0,4,17,9,30
7267,Spain,1992.0,48,19,3,70
7268,Spain,1996.0,23,21,22,66
7269,Spain,1980.0,2,19,3,24
7270,Spain,2008.0,7,47,16,70
7271,Spain,2012.0,5,33,25,63
7272,Spain,1992.0,48,19,3,70
7273,Spain,1992.0,48,19,3,70
7274,Spain,1992.0,48,19,3,70
7275,Spain,2000.0,3,19,20,42
7276,Spain,1984.0,2,14,3,19
7277,Spain,2016.0,9,19,17,45
7278,Spain,2012.0,5,33,25,63
7279,Spain,1984.0,2,14,3,19
7280,Spain,1992.0,48,19,3,70
7281,Spain,1996.0,23,21,22,66
7282,Spain-2,2004.0,4,17,9,30
7283,Spain,1996.0,23,21,22,66
7284,Spain,2004.0,4,17,9,30
7285,Spain,2008.0,7,47,16,70
7286,Spain,2004.0,4,17,9,30
7287,Spain,2004.0,4,17,9,30
7288,Spain,1992.0,48,19,3,70
7289,Spain,1996.0,23,21,22,66
7290,Spain,2000.0,3,19,20,42
7291,Spain-1,2008.0,7,47,16,70
7292,Spain,1992.0,48,19,3,70
7293,Spain,1976.0,0,6,0,6
7294,Spain,1980.0,2,19,3,24
7295,Spain,1980.0,2,19,3,24
7296,Spain,2008.0,7,47,16,70
7297,Spain,2008.0,7,47,16,70
7298,Spain,2012.0,5,33,25,63
7299,Spain,1992.0,48,19,3,70
7300,Spain,1984.0,2,14,3,19
7301,Spain,1976.0,0,6,0,6
7302,Spain,2012.0,5,33,25,63
7303,Spain,2016.0,9,19,17,45
7304,Spain,2016.0,9,19,17,45
7305,Spain,1984.0,2,14,3,19
7306,Spain,1980.0,2,19,3,24
7307,Spain,1992.0,48,19,3,70
7308,Spain,2004.0,4,17,9,30
7309,Spain,1996.0,23,21,22,66
7310,Spain,1992.0,48,19,3,70
7311,Spain,2008.0,7,47,16,70
7312,Spain,1992.0,48,19,3,70
7313,Spain,1960.0,0,0,14,14
7314,Spain,2008.0,7,47,16,70
7315,Spain-2,2016.0,9,19,17,45
7316,Spain,1928.0,3,0,0,3
7317,Spain,1948.0,0,3,0,3
7318,Spain,2008.0,7,47,16,70
7319,Spain,2012.0,5,33,25,63
7320,Spain,2016.0,9,19,17,45
7321,Spain,2012.0,5,33,25,63
7322,Spain,2016.0,9,19,17,45
7323,Spain,2016.0,9,19,17,45
7324,Spain,1980.0,2,19,3,24
7325,Spain,1996.0,23,21,22,66
7326,Spain,2000.0,3,19,20,42
7327,Spain,2000.0,3,19,20,42
7328,Spain,1992.0,48,19,3,70
7329,Spain,1996.0,23,21,22,66
7330,Spain,2008.0,7,47,16,70
7331,Spain,1996.0,23,21,22,66
7332,Spain,2000.0,3,19,20,42
7333,Spain,1996.0,23,21,22,66
7334,Spain,2008.0,7,47,16,70
7335,Spain,1992.0,48,19,3,70
7336,Spain,2000.0,3,19,20,42
7337,Spain,2016.0,9,19,17,45
7338,Spain,2012.0,5,33,25,63
7339,Spain,1920.0,0,23,0,23
7340,Spain,1920.0,0,23,0,23
7341,Spain,2016.0,9,19,17,45
7342,Spain,2012.0,5,33,25,63
7343,Spain,2016.0,9,19,17,45
7344,Spain,1992.0,48,19,3,70
7345,Spain,1996.0,23,21,22,66
7346,Spain,2008.0,7,47,16,70
7347,Spain,1992.0,48,19,3,70
7348,Spain,1996.0,23,21,22,66
7349,Spain,1980.0,2,19,3,24
7350,Spain,2012.0,5,33,25,63
7351,Spain,1992.0,48,19,3,70
7352,Spain,2008.0,7,47,16,70
7353,Spain,1996.0,23,21,22,66
7354,Spain,1996.0,23,21,22,66
7355,Spain,2000.0,3,19,20,42
7356,Spain,1920.0,0,23,0,23
7357,Spain,1992.0,48,19,3,70
7358,Spain,2012.0,5,33,25,63
7359,Spain,1992.0,48,19,3,70
7360,Spain,1992.0,48,19,3,70
7361,Spain,2012.0,5,33,25,63
7362,Spain,2008.0,7,47,16,70
7363,Spain,1996.0,23,21,22,66
7364,Spain,2012.0,5,33,25,63
7365,Spain,2000.0,3,19,20,42
7366,Spain,2016.0,9,19,17,45
7367,Spain,2016.0,9,19,17,45
7368,Spain,2004.0,4,17,9,30
7369,Spain,2004.0,4,17,9,30
7370,Spain,1992.0,48,19,3,70
7371,Spain,1976.0,0,6,0,6
7372,Spain,1980.0,2,19,3,24
7373,Spain,1992.0,48,19,3,70
7374,Spain,2008.0,7,47,16,70
7375,Spain,2012.0,5,33,25,63
7376,Spain,2016.0,9,19,17,45
7377,Spain,2008.0,7,47,16,70
7378,Spain,1980.0,2,19,3,24
7379,Spain,2008.0,7,47,16,70
7380,Spain,2008.0,7,47,16,70
7381,Spain,1972.0,1,0,1,2
7382,Spain,2008.0,7,47,16,70
7383,Spain,2016.0,9,19,17,45
7384,Spain,1992.0,48,19,3,70
7385,Spain,2012.0,5,33,25,63
7386,Spain,2016.0,9,19,17,45
7387,Spain,1960.0,0,0,14,14
7388,Spain,1992.0,48,19,3,70
7389,Spain,1996.0,23,21,22,66
7390,Spain,1984.0,2,14,3,19
7391,Spain,2008.0,7,47,16,70
7392,Spain,2016.0,9,19,17,45
7393,Spain-2,2004.0,4,17,9,30
7394,Spain-1,2008.0,7,47,16,70
7395,Spain,2008.0,7,47,16,70
7396,Spain,2016.0,9,19,17,45
7397,Spain,2000.0,3,19,20,42
7398,Spain,1920.0,0,23,0,23
7399,Spain,2012.0,5,33,25,63
7400,Spain,1920.0,0,23,0,23
7401,Spain,2008.0,7,47,16,70
7402,Spain,1996.0,23,21,22,66
7403,Spain,1920.0,0,23,0,23
7404,Spain,2012.0,5,33,25,63
7405,Spain,1984.0,2,14,3,19
7406,Spain,1992.0,48,19,3,70
7407,Spain,1992.0,48,19,3,70
7408,Spain,2008.0,7,47,16,70
7409,Spain,1992.0,48,19,3,70
7410,Spain,1992.0,48,19,3,70
7411,Spain,1996.0,23,21,22,66
7412,Spain,1996.0,23,21,22,66
7413,Spain,1988.0,1,2,2,5
7414,Spain,1920.0,0,23,0,23
7415,Spain,1992.0,48,19,3,70
7416,Spain,1996.0,23,21,22,66
7417,Spain,1996.0,23,21,22,66
7418,Spain,1920.0,0,23,0,23
7419,Spain,1920.0,0,23,0,23
7420,Spain,2008.0,7,47,16,70
7421,Spain,1992.0,48,19,3,70
7422,Spain,1996.0,23,21,22,66
7423,Spain,1984.0,2,14,3,19
7424,Spain,1992.0,48,19,3,70
7425,Spain,2004.0,4,17,9,30
7426,Spain,1984.0,2,14,3,19
7427,Spain,2000.0,3,19,20,42
7428,Spain,2012.0,5,33,25,63
7429,Spain,2008.0,7,47,16,70
7430,Spain,1992.0,48,19,3,70
7431,Spain,2008.0,7,47,16,70
7432,Spain,2008.0,7,47,16,70
7433,Spain,1992.0,48,19,3,70
7434,Spain,2000.0,3,19,20,42
7435,Spain,2016.0,9,19,17,45
7436,Spain,2012.0,5,33,25,63
7437,Spain,2016.0,9,19,17,45
7438,Spain,2004.0,4,17,9,30
7439,Spain,2004.0,4,17,9,30
7440,Spain,2008.0,7,47,16,70
7441,Spain,2000.0,3,19,20,42
7442,Spain,2000.0,3,19,20,42
7443,Spain,2012.0,5,33,25,63
7444,Spain,1996.0,23,21,22,66
7445,Spain,2000.0,3,19,20,42
7446,Spain,1996.0,23,21,22,66
7447,Spain,2000.0,3,19,20,42
7448,Spain,1960.0,0,0,14,14
7449,Spain,1996.0,23,21,22,66
7450,Spain,2016.0,9,19,17,45
7451,Spain,1920.0,0,23,0,23
7452,Spain,1992.0,48,19,3,70
7453,Spain,2000.0,3,19,20,42
7454,Spain,1992.0,48,19,3,70
7455,Spain,1920.0,0,23,0,23
7456,Spain,1960.0,0,0,14,14
7457,Spain,1996.0,23,21,22,66
7458,Spain,1992.0,48,19,3,70
7459,Spain,2004.0,4,17,9,30
7460,Spain,1992.0,48,19,3,70
7461,Spain,1992.0,48,19,3,70
7462,Spain,1900.0,2,0,0,2
7463,Spain,2016.0,9,19,17,45
7464,Spain,2016.0,9,19,17,45
7465,Spain,2000.0,3,19,20,42
7466,Spain,2000.0,3,19,20,42
7467,Spain,2012.0,5,33,25,63
7468,Spain,1992.0,48,19,3,70
7469,Spain,1996.0,23,21,22,66
7470,Spain,1920.0,0,23,0,23
7471,Spain,2000.0,3,19,20,42
7472,Spain,1980.0,2,19,3,24
7473,Azerbaijan,2016.0,1,7,10,18
7474,Azerbaijan,1996.0,0,1,0,1
7475,Azerbaijan,2000.0,2,0,1,3
7476,Azerbaijan,2004.0,1,0,4,5
7477,Azerbaijan,2004.0,1,0,4,5
7478,Azerbaijan,2008.0,1,2,4,7
7479,Azerbaijan,2012.0,2,2,6,10
7480,Azerbaijan,2016.0,1,7,10,18
7481,Azerbaijan,2016.0,1,7,10,18
7482,Azerbaijan,2016.0,1,7,10,18
7483,Azerbaijan,2012.0,2,2,6,10
7484,Azerbaijan,2016.0,1,7,10,18
7485,Azerbaijan,2008.0,1,2,4,7
7486,Azerbaijan,2016.0,1,7,10,18
7487,Azerbaijan,2016.0,1,7,10,18
7488,Azerbaijan,2000.0,2,0,1,3
7489,Azerbaijan,2012.0,2,2,6,10
7490,Azerbaijan,2000.0,2,0,1,3
7491,Azerbaijan,2004.0,1,0,4,5
7492,Azerbaijan,2008.0,1,2,4,7
7493,Azerbaijan,2008.0,1,2,4,7
7494,Azerbaijan,2004.0,1,0,4,5
7495,Azerbaijan,2012.0,2,2,6,10
7496,Azerbaijan,2004.0,1,0,4,5
7497,Azerbaijan,2016.0,1,7,10,18
7498,Azerbaijan,2016.0,1,7,10,18
7499,Azerbaijan,2016.0,1,7,10,18
7500,Azerbaijan,2008.0,1,2,4,7
7501,Azerbaijan,2012.0,2,2,6,10
7502,Azerbaijan,2016.0,1,7,10,18
7503,Azerbaijan,2012.0,2,2,6,10
7504,Azerbaijan,2008.0,1,2,4,7
7505,Azerbaijan,2016.0,1,7,10,18
7506,Azerbaijan,2012.0,2,2,6,10
7507,Azerbaijan,2016.0,1,7,10,18
7508,Azerbaijan,2016.0,1,7,10,18
7509,Azerbaijan,2016.0,1,7,10,18
7510,Azerbaijan,2012.0,2,2,6,10
7511,Azerbaijan,2016.0,1,7,10,18
7512,Azerbaijan,2016.0,1,7,10,18
7513,Azerbaijan,2008.0,1,2,4,7
7514,Azerbaijan,2012.0,2,2,6,10
7515,Azerbaijan,2016.0,1,7,10,18
7516,Azerbaijan,2012.0,2,2,6,10
7517,Russia,2008.0,43,46,53,142
7518,Russia,2004.0,48,46,95,189
7519,Russia,2012.0,50,39,51,140
7520,Russia,2012.0,50,39,51,140
7521,Russia,2016.0,52,28,35,115
7522,Russia,2016.0,52,28,35,115
7523,Russia,2016.0,52,28,35,115
7524,Russia,2004.0,48,46,95,189
7525,Russia,2006.0,16,12,13,41
7526,Russia,2008.0,43,46,53,142
7527,Russia,2012.0,50,39,51,140
7528,Russia,2002.0,6,5,27,38
7529,Russia,1998.0,14,32,6,52
7530,Russia,2002.0,6,5,27,38
7531,Russia,2006.0,16,12,13,41
7532,Russia,2006.0,16,12,13,41
7533,Russia,2006.0,16,12,13,41
7534,Russia,2016.0,52,28,35,115
7535,Russia,2008.0,43,46,53,142
7536,Russia,2004.0,48,46,95,189
7537,Russia,2008.0,43,46,53,142
7538,Russia,2000.0,66,67,54,187
7539,Russia,1996.0,36,45,34,115
7540,Russia,2012.0,50,39,51,140
7541,Russia,2008.0,43,46,53,142
7542,Russia,2000.0,66,67,54,187
7543,Russia,2000.0,66,67,54,187
7544,Russia,2004.0,48,46,95,189
7545,Russia,2004.0,48,46,95,189
7546,Russia,2008.0,43,46,53,142
7547,Russia,2008.0,43,46,53,142
7548,Russia,2012.0,50,39,51,140
7549,Russia,2000.0,66,67,54,187
7550,Russia,2006.0,16,12,13,41
7551,Russia,2014.0,33,22,13,68
7552,Russia,2014.0,33,22,13,68
7553,Russia,2014.0,33,22,13,68
7554,Russia,2014.0,33,22,13,68
7555,Russia,2000.0,66,67,54,187
7556,Russia,2008.0,43,46,53,142
7557,Russia,2000.0,66,67,54,187
7558,Russia,2016.0,52,28,35,115
7559,Russia,2012.0,50,39,51,140
7560,Russia,2014.0,33,22,13,68
7561,Russia,2004.0,48,46,95,189
7562,Russia,2004.0,48,46,95,189
7563,Russia,2012.0,50,39,51,140
7564,Russia,2012.0,50,39,51,140
7565,Russia,2012.0,50,39,51,140
7566,Russia,2004.0,48,46,95,189
7567,Russia,2000.0,66,67,54,187
7568,Russia,2004.0,48,46,95,189
7569,Russia,2004.0,48,46,95,189
7570,Russia,2012.0,50,39,51,140
7571,Russia-1,2002.0,6,5,27,38
7572,Russia,2012.0,50,39,51,140
7573,Russia,2000.0,66,67,54,187
7574,Russia,2004.0,48,46,95,189
7575,Russia,1996.0,36,45,34,115
7576,Russia,2000.0,66,67,54,187
7577,Russia,2004.0,48,46,95,189
7578,Russia,2008.0,43,46,53,142
7579,Russia,2008.0,43,46,53,142
7580,Russia,2000.0,66,67,54,187
7581,Russia,2004.0,48,46,95,189
7582,Russia,2004.0,48,46,95,189
7583,Russia,2006.0,16,12,13,41
7584,Russia,2004.0,48,46,95,189
7585,Russia,2004.0,48,46,95,189
7586,Russia,2008.0,43,46,53,142
7587,Russia,2000.0,66,67,54,187
7588,Russia,2006.0,16,12,13,41
7589,Russia,2012.0,50,39,51,140
7590,Russia,2016.0,52,28,35,115
7591,Russia,2000.0,66,67,54,187
7592,Russia,2004.0,48,46,95,189
7593,Russia,2004.0,48,46,95,189
7594,Russia,2008.0,43,46,53,142
7595,Russia,1996.0,36,45,34,115
7596,Russia,1994.0,19,13,4,36
7597,Russia,1996.0,36,45,34,115
7598,Russia,1996.0,36,45,34,115
7599,Russia,2000.0,66,67,54,187
7600,Gallia II,1912.0,0,5,9,14
7601,Russia,2000.0,66,67,54,187
7602,Russia,2016.0,52,28,35,115
7603,Russia,2004.0,48,46,95,189
7604,Russia,2016.0,52,28,35,115
7605,Russia,2016.0,52,28,35,115
7606,Russia,2016.0,52,28,35,115
7607,Russia,2004.0,48,46,95,189
7608,Russia,2008.0,43,46,53,142
7609,Russia,2012.0,50,39,51,140
7610,Russia-2,1998.0,14,32,6,52
7611,Russia-1,2002.0,6,5,27,38
7612,Russia,2014.0,33,22,13,68
7613,Russia,2016.0,52,28,35,115
7614,Russia,1912.0,0,5,9,14
7615,Russia,2004.0,48,46,95,189
7616,Russia,2008.0,43,46,53,142
7617,Russia,2016.0,52,28,35,115
7618,Russia,2012.0,50,39,51,140
7619,Russia,2016.0,52,28,35,115
7620,Russia,2014.0,33,22,13,68
7621,Russia,2016.0,52,28,35,115
7622,Russia,1996.0,36,45,34,115
7623,Russia,2006.0,16,12,13,41
7624,Russia,2010.0,6,5,14,25
7625,Russia,1996.0,36,45,34,115
7626,Russia,2000.0,66,67,54,187
7627,Russia,2000.0,66,67,54,187
7628,Russia,2008.0,43,46,53,142
7629,Russia,2016.0,52,28,35,115
7630,Russia,2004.0,48,46,95,189
7631,Russia,2006.0,16,12,13,41
7632,Russia,2008.0,43,46,53,142
7633,Gallia II,1912.0,0,5,9,14
7634,Russia,2000.0,66,67,54,187
7635,Russia,2000.0,66,67,54,187
7636,Russia,2000.0,66,67,54,187
7637,Russia,2004.0,48,46,95,189
7638,Russia,2016.0,52,28,35,115
7639,Russia,1998.0,14,32,6,52
7640,Russia,2002.0,6,5,27,38
7641,Russia,1998.0,14,32,6,52
7642,Russia,2002.0,6,5,27,38
7643,Russia,2004.0,48,46,95,189
7644,Russia,2012.0,50,39,51,140
7645,Russia,2008.0,43,46,53,142
7646,Russia,2016.0,52,28,35,115
7647,Russia,2004.0,48,46,95,189
7648,Russia,1996.0,36,45,34,115
7649,Russia,2000.0,66,67,54,187
7650,Russia,1998.0,14,32,6,52
7651,Russia,2002.0,6,5,27,38
7652,Russia,2002.0,6,5,27,38
7653,Russia,2002.0,6,5,27,38
7654,Russia,2006.0,16,12,13,41
7655,Russia,2006.0,16,12,13,41
7656,Russia,2000.0,66,67,54,187
7657,Russia,1994.0,19,13,4,36
7658,Russia,1994.0,19,13,4,36
7659,Russia,2006.0,16,12,13,41
7660,Russia,2016.0,52,28,35,115
7661,Russia,2006.0,16,12,13,41
7662,Russia,2010.0,6,5,14,25
7663,Russia,1996.0,36,45,34,115
7664,Russia,2008.0,43,46,53,142
7665,Russia,2014.0,33,22,13,68
7666,Russia,2008.0,43,46,53,142
7667,Russia,2012.0,50,39,51,140
7668,Russia,2008.0,43,46,53,142
7669,Russia,2012.0,50,39,51,140
7670,Russia,2016.0,52,28,35,115
7671,Russia,2008.0,43,46,53,142
7672,Russia,2004.0,48,46,95,189
7673,Russia,2000.0,66,67,54,187
7674,Russia,2004.0,48,46,95,189
7675,Russia,2010.0,6,5,14,25
7676,Russia,2004.0,48,46,95,189
7677,Russia,2016.0,52,28,35,115
7678,Russia,1998.0,14,32,6,52
7679,Russia,1998.0,14,32,6,52
7680,Russia,1998.0,14,32,6,52
7681,Russia,2016.0,52,28,35,115
7682,Russia,2002.0,6,5,27,38
7683,Russia,2004.0,48,46,95,189
7684,Russia,2004.0,48,46,95,189
7685,Russia,2008.0,43,46,53,142
7686,Russia,2008.0,43,46,53,142
7687,Russia,2012.0,50,39,51,140
7688,Russia,2006.0,16,12,13,41
7689,Russia,2014.0,33,22,13,68
7690,Russia,2014.0,33,22,13,68
7691,Russia,2006.0,16,12,13,41
7692,Russia,2006.0,16,12,13,41
7693,Russia,2000.0,66,67,54,187
7694,Russia,2008.0,43,46,53,142
7695,Russia,2012.0,50,39,51,140
7696,Russia,2016.0,52,28,35,115
7697,Russia,2014.0,33,22,13,68
7698,Russia,2012.0,50,39,51,140
7699,Russia,2016.0,52,28,35,115
7700,Russia,2004.0,48,46,95,189
7701,Russia-2,1994.0,19,13,4,36
7702,Russia-1,1998.0,14,32,6,52
7703,Russia,2016.0,52,28,35,115
7704,Russia,2016.0,52,28,35,115
7705,Russia,2012.0,50,39,51,140
7706,Russia,2008.0,43,46,53,142
7707,Russia,1996.0,36,45,34,115
7708,Russia,1996.0,36,45,34,115
7709,Russia,2000.0,66,67,54,187
7710,Russia,2008.0,43,46,53,142
7711,Russia,1996.0,36,45,34,115
7712,Russia-1,2010.0,6,5,14,25
7713,Russia,2004.0,48,46,95,189
7714,Russia,2012.0,50,39,51,140
7715,Russia,2000.0,66,67,54,187
7716,Russia,2006.0,16,12,13,41
7717,Russia,1994.0,19,13,4,36
7718,Russia,1998.0,14,32,6,52
7719,Russia,2000.0,66,67,54,187
7720,Russia,2012.0,50,39,51,140
7721,Russia,2000.0,66,67,54,187
7722,Russia,2016.0,52,28,35,115
7723,Russia,2012.0,50,39,51,140
7724,Russia,2004.0,48,46,95,189
7725,Russia,2016.0,52,28,35,115
7726,Russia,2000.0,66,67,54,187
7727,Russia,2000.0,66,67,54,187
7728,Russia,1996.0,36,45,34,115
7729,Russia,2016.0,52,28,35,115
7730,Russia,2014.0,33,22,13,68
7731,Russia,2008.0,43,46,53,142
7732,Russia,2004.0,48,46,95,189
7733,Russia,2004.0,48,46,95,189
7734,Russia,1994.0,19,13,4,36
7735,Russia,2000.0,66,67,54,187
7736,Russia,2000.0,66,67,54,187
7737,Russia,2004.0,48,46,95,189
7738,Russia,2008.0,43,46,53,142
7739,Russia,2012.0,50,39,51,140
7740,Russia,2000.0,66,67,54,187
7741,Russia,2004.0,48,46,95,189
7742,Russia,2008.0,43,46,53,142
7743,Russia,2012.0,50,39,51,140
7744,Russia,2012.0,50,39,51,140
7745,Russia,2000.0,66,67,54,187
7746,Russia,1998.0,14,32,6,52
7747,Russia,2002.0,6,5,27,38
7748,Russia,2004.0,48,46,95,189
7749,Russia,2012.0,50,39,51,140
7750,Russia,1996.0,36,45,34,115
7751,Russia,2004.0,48,46,95,189
7752,Russia,2004.0,48,46,95,189
7753,Russia,2008.0,43,46,53,142
7754,Russia,2008.0,43,46,53,142
7755,Russia,2008.0,43,46,53,142
7756,Russia,2012.0,50,39,51,140
7757,Russia,2000.0,66,67,54,187
7758,Russia,2004.0,48,46,95,189
7759,Russia,2004.0,48,46,95,189
7760,Russia,2014.0,33,22,13,68
7761,Russia,1996.0,36,45,34,115
7762,Russia,2000.0,66,67,54,187
7763,Russia,2004.0,48,46,95,189
7764,Russia,2004.0,48,46,95,189
7765,Russia,2008.0,43,46,53,142
7766,Russia,2016.0,52,28,35,115
7767,Russia,1994.0,19,13,4,36
7768,Russia,1994.0,19,13,4,36
7769,Russia,1998.0,14,32,6,52
7770,Russia,2000.0,66,67,54,187
7771,Russia,2004.0,48,46,95,189
7772,Russia,2016.0,52,28,35,115
7773,Russia,2000.0,66,67,54,187
7774,Russia,1996.0,36,45,34,115
7775,Russia,2000.0,66,67,54,187
7776,Russia,1994.0,19,13,4,36
7777,Russia,2004.0,48,46,95,189
7778,Russia,1996.0,36,45,34,115
7779,Russia,2000.0,66,67,54,187
7780,Russia,2016.0,52,28,35,115
7781,Russia,2000.0,66,67,54,187
7782,Russia,2000.0,66,67,54,187
7783,Russia,2008.0,43,46,53,142
7784,Russia,2008.0,43,46,53,142
7785,Russia,1994.0,19,13,4,36
7786,Russia,1998.0,14,32,6,52
7787,Russia,2002.0,6,5,27,38
7788,Russia,2000.0,66,67,54,187
7789,Russia,2004.0,48,46,95,189
7790,Russia,2004.0,48,46,95,189
7791,Russia,2008.0,43,46,53,142
7792,Russia-1,1994.0,19,13,4,36
7793,Russia,1996.0,36,45,34,115
7794,Russia,2000.0,66,67,54,187
7795,Russia,2004.0,48,46,95,189
7796,Russia,2000.0,66,67,54,187
7797,Russia,2004.0,48,46,95,189
7798,Russia,2000.0,66,67,54,187
7799,Russia,2000.0,66,67,54,187
7800,Russia,2014.0,33,22,13,68
7801,Russia,2014.0,33,22,13,68
7802,Russia,2008.0,43,46,53,142
7803,Russia,2012.0,50,39,51,140
7804,Russia,2012.0,50,39,51,140
7805,Russia,2016.0,52,28,35,115
7806,Russia,2014.0,33,22,13,68
7807,Russia,2014.0,33,22,13,68
7808,Russia-1,1994.0,19,13,4,36
7809,Russia,2016.0,52,28,35,115
7810,Russia-1,1994.0,19,13,4,36
7811,Russia-1,1998.0,14,32,6,52
7812,Russia,2012.0,50,39,51,140
7813,Russia,2000.0,66,67,54,187
7814,Russia,1996.0,36,45,34,115
7815,Russia,2004.0,48,46,95,189
7816,Russia,2008.0,43,46,53,142
7817,Russia,2012.0,50,39,51,140
7818,Russia,1996.0,36,45,34,115
7819,Russia,1996.0,36,45,34,115
7820,Russia,1998.0,14,32,6,52
7821,Russia,2008.0,43,46,53,142
7822,Russia,2008.0,43,46,53,142
7823,Russia,2012.0,50,39,51,140
7824,Russia,2004.0,48,46,95,189
7825,Russia,2008.0,43,46,53,142
7826,Russia,2000.0,66,67,54,187
7827,Russia,2004.0,48,46,95,189
7828,Russia,2008.0,43,46,53,142
7829,Russia,2008.0,43,46,53,142
7830,Russia,2000.0,66,67,54,187
7831,Russia,2004.0,48,46,95,189
7832,Russia,2016.0,52,28,35,115
7833,Russia,2012.0,50,39,51,140
7834,Russia-1,2014.0,33,22,13,68
7835,Russia,2014.0,33,22,13,68
7836,Russia,2010.0,6,5,14,25
7837,Russia,2004.0,48,46,95,189
7838,Russia,2008.0,43,46,53,142
7839,Russia,2012.0,50,39,51,140
7840,Russia,2008.0,43,46,53,142
7841,Russia,2012.0,50,39,51,140
7842,Russia,2012.0,50,39,51,140
7843,Russia,2016.0,52,28,35,115
7844,Russia,2016.0,52,28,35,115
7845,Russia,2002.0,6,5,27,38
7846,Russia,2006.0,16,12,13,41
7847,Russia,2006.0,16,12,13,41
7848,Russia,2004.0,48,46,95,189
7849,Russia,2008.0,43,46,53,142
7850,Russia,2012.0,50,39,51,140
7851,Russia,2012.0,50,39,51,140
7852,Russia,2002.0,6,5,27,38
7853,Russia,2004.0,48,46,95,189
7854,Russia,2000.0,66,67,54,187
7855,Russia,2004.0,48,46,95,189
7856,Russia,2004.0,48,46,95,189
7857,Russia,2014.0,33,22,13,68
7858,Russia,2016.0,52,28,35,115
7859,Russia,1996.0,36,45,34,115
7860,Russia,1996.0,36,45,34,115
7861,Russia,2008.0,43,46,53,142
7862,Russia,2012.0,50,39,51,140
7863,Russia,2000.0,66,67,54,187
7864,Russia,2004.0,48,46,95,189
7865,Russia,2000.0,66,67,54,187
7866,Russia,2008.0,43,46,53,142
7867,Russia,2016.0,52,28,35,115
7868,Russia,2004.0,48,46,95,189
7869,Russia,2016.0,52,28,35,115
7870,Russia,1998.0,14,32,6,52
7871,Russia,2008.0,43,46,53,142
7872,Russia,2012.0,50,39,51,140
7873,Russia,2008.0,43,46,53,142
7874,Russia,2012.0,50,39,51,140
7875,Russia,2008.0,43,46,53,142
7876,Russia,2012.0,50,39,51,140
7877,Russia,2000.0,66,67,54,187
7878,Russia,2012.0,50,39,51,140
7879,Russia,2000.0,66,67,54,187
7880,Russia,2000.0,66,67,54,187
7881,Russia,1996.0,36,45,34,115
7882,Russia,2000.0,66,67,54,187
7883,Russia,2008.0,43,46,53,142
7884,Russia,2016.0,52,28,35,115
7885,Russia,2016.0,52,28,35,115
7886,Russia,2004.0,48,46,95,189
7887,Russia,2008.0,43,46,53,142
7888,Russia,2008.0,43,46,53,142
7889,Russia,2004.0,48,46,95,189
7890,Russia,1912.0,0,5,9,14
7891,Russia,2012.0,50,39,51,140
7892,Russia,1998.0,14,32,6,52
7893,Russia,2002.0,6,5,27,38
7894,Russia-1,2014.0,33,22,13,68
7895,Russia,2014.0,33,22,13,68
7896,Russia,2012.0,50,39,51,140
7897,Russia,2000.0,66,67,54,187
7898,Russia,2004.0,48,46,95,189
7899,Russia,2004.0,48,46,95,189
7900,Russia-1,1998.0,14,32,6,52
7901,Russia,2008.0,43,46,53,142
7902,Russia,2004.0,48,46,95,189
7903,Russia,2002.0,6,5,27,38
7904,Russia,1996.0,36,45,34,115
7905,Russia,1996.0,36,45,34,115
7906,Russia,2000.0,66,67,54,187
7907,Russia,2016.0,52,28,35,115
7908,Russia,2000.0,66,67,54,187
7909,Russia,2004.0,48,46,95,189
7910,Russia,2008.0,43,46,53,142
7911,Russia,1996.0,36,45,34,115
7912,Russia,2004.0,48,46,95,189
7913,Russia,2008.0,43,46,53,142
7914,Russia,2012.0,50,39,51,140
7915,Russia,2012.0,50,39,51,140
7916,Russia,2010.0,6,5,14,25
7917,Russia,2000.0,66,67,54,187
7918,Russia,1996.0,36,45,34,115
7919,Russia,1996.0,36,45,34,115
7920,Russia,2000.0,66,67,54,187
7921,Russia,2000.0,66,67,54,187
7922,Russia,2000.0,66,67,54,187
7923,Russia,2004.0,48,46,95,189
7924,Russia,2004.0,48,46,95,189
7925,Russia,2004.0,48,46,95,189
7926,Russia,2012.0,50,39,51,140
7927,Russia,2004.0,48,46,95,189
7928,Russia,2012.0,50,39,51,140
7929,Russia,1996.0,36,45,34,115
7930,Russia,2012.0,50,39,51,140
7931,Russia,2008.0,43,46,53,142
7932,Russia,2012.0,50,39,51,140
7933,Russia,2012.0,50,39,51,140
7934,Russia,2012.0,50,39,51,140
7935,Russia-1,2012.0,50,39,51,140
7936,Russia,1996.0,36,45,34,115
7937,Russia,1994.0,19,13,4,36
7938,Russia,2000.0,66,67,54,187
7939,Russia,2000.0,66,67,54,187
7940,Russia,2004.0,48,46,95,189
7941,Russia,1912.0,0,5,9,14
7942,Russia,1994.0,19,13,4,36
7943,Russia,1994.0,19,13,4,36
7944,Russia-2,2014.0,33,22,13,68
7945,Russia,2014.0,33,22,13,68
7946,Russia,1996.0,36,45,34,115
7947,Russia,2008.0,43,46,53,142
7948,Russia,2000.0,66,67,54,187
7949,Russia,1996.0,36,45,34,115
7950,Russia,2016.0,52,28,35,115
7951,Russia,1996.0,36,45,34,115
7952,Russia,2000.0,66,67,54,187
7953,Russia,2004.0,48,46,95,189
7954,Russia,2016.0,52,28,35,115
7955,Russia,2000.0,66,67,54,187
7956,Russia,1996.0,36,45,34,115
7957,Russia,2000.0,66,67,54,187
7958,Russia,2004.0,48,46,95,189
7959,Russia,2008.0,43,46,53,142
7960,Russia,2016.0,52,28,35,115
7961,Russia,2012.0,50,39,51,140
7962,Russia,1908.0,1,2,0,3
7963,Russia,2004.0,48,46,95,189
7964,Russia,2004.0,48,46,95,189
7965,Russia,2012.0,50,39,51,140
7966,Russia,2012.0,50,39,51,140
7967,Russia,2000.0,66,67,54,187
7968,Russia,2008.0,43,46,53,142
7969,Russia,1996.0,36,45,34,115
7970,Russia,2012.0,50,39,51,140
7971,Russia,2012.0,50,39,51,140
7972,Russia,2000.0,66,67,54,187
7973,Russia,2010.0,6,5,14,25
7974,Russia,2012.0,50,39,51,140
7975,Russia,2012.0,50,39,51,140
7976,Russia,2004.0,48,46,95,189
7977,Russia,2008.0,43,46,53,142
7978,Russia,2004.0,48,46,95,189
7979,Russia,2008.0,43,46,53,142
7980,Russia,2004.0,48,46,95,189
7981,Russia,2004.0,48,46,95,189
7982,Russia,2008.0,43,46,53,142
7983,Russia-1,2006.0,16,12,13,41
7984,Russia,2004.0,48,46,95,189
7985,Russia,2000.0,66,67,54,187
7986,Russia,2000.0,66,67,54,187
7987,Russia,2004.0,48,46,95,189
7988,Russia,2002.0,6,5,27,38
7989,Russia,1998.0,14,32,6,52
7990,Russia,2004.0,48,46,95,189
7991,Russia,2004.0,48,46,95,189
7992,Russia,2002.0,6,5,27,38
7993,Russia,2012.0,50,39,51,140
7994,Russia,1994.0,19,13,4,36
7995,Russia,2000.0,66,67,54,187
7996,Russia,2004.0,48,46,95,189
7997,Russia,2004.0,48,46,95,189
7998,Russia,1998.0,14,32,6,52
7999,Russia,2002.0,6,5,27,38
8000,Russia,2004.0,48,46,95,189
8001,Russia,1998.0,14,32,6,52
8002,Russia,2012.0,50,39,51,140
8003,Russia,1996.0,36,45,34,115
8004,Russia,2000.0,66,67,54,187
8005,Russia,2004.0,48,46,95,189
8006,Russia,2006.0,16,12,13,41
8007,Russia,2004.0,48,46,95,189
8008,Russia-2,1998.0,14,32,6,52
8009,Russia,2004.0,48,46,95,189
8010,Russia,2010.0,6,5,14,25
8011,Russia,2014.0,33,22,13,68
8012,Russia,1996.0,36,45,34,115
8013,Russia,2000.0,66,67,54,187
8014,Russia,2000.0,66,67,54,187
8015,Russia,2004.0,48,46,95,189
8016,Russia,2016.0,52,28,35,115
8017,Russia,2008.0,43,46,53,142
8018,Russia,2012.0,50,39,51,140
8019,Russia,1998.0,14,32,6,52
8020,Russia,1998.0,14,32,6,52
8021,Russia,2002.0,6,5,27,38
8022,Russia,2016.0,52,28,35,115
8023,Russia,2000.0,66,67,54,187
8024,Russia,2004.0,48,46,95,189
8025,Russia,2008.0,43,46,53,142
8026,Russia,2004.0,48,46,95,189
8027,Russia,1998.0,14,32,6,52
8028,Russia,1996.0,36,45,34,115
8029,Russia,1996.0,36,45,34,115
8030,Russia,2000.0,66,67,54,187
8031,Russia,2008.0,43,46,53,142
8032,Russia,2012.0,50,39,51,140
8033,Russia,2004.0,48,46,95,189
8034,Russia,2006.0,16,12,13,41
8035,Russia,2000.0,66,67,54,187
8036,Russia,1912.0,0,5,9,14
8037,Russia,2000.0,66,67,54,187
8038,Russia,2000.0,66,67,54,187
8039,Russia,2004.0,48,46,95,189
8040,Russia,2008.0,43,46,53,142
8041,Russia,2008.0,43,46,53,142
8042,Russia,2000.0,66,67,54,187
8043,Russia,2008.0,43,46,53,142
8044,Russia,1996.0,36,45,34,115
8045,Russia,2012.0,50,39,51,140
8046,Russia,2016.0,52,28,35,115
8047,Russia,1996.0,36,45,34,115
8048,Russia,2016.0,52,28,35,115
8049,Russia,2002.0,6,5,27,38
8050,Russia,2008.0,43,46,53,142
8051,Russia,2012.0,50,39,51,140
8052,Russia,2008.0,43,46,53,142
8053,Russia,2008.0,43,46,53,142
8054,Russia,2008.0,43,46,53,142
8055,Russia,2002.0,6,5,27,38
8056,Russia,1996.0,36,45,34,115
8057,Russia,2012.0,50,39,51,140
8058,Russia,1996.0,36,45,34,115
8059,Russia,2000.0,66,67,54,187
8060,Russia,2004.0,48,46,95,189
8061,Russia,2000.0,66,67,54,187
8062,Russia,2000.0,66,67,54,187
8063,Russia,2004.0,48,46,95,189
8064,Russia,1994.0,19,13,4,36
8065,Russia,1998.0,14,32,6,52
8066,Russia,1998.0,14,32,6,52
8067,Russia,1998.0,14,32,6,52
8068,Russia,1998.0,14,32,6,52
8069,Russia,1998.0,14,32,6,52
8070,Russia,2006.0,16,12,13,41
8071,Russia,2000.0,66,67,54,187
8072,Russia,2004.0,48,46,95,189
8073,Russia,2004.0,48,46,95,189
8074,Russia,2008.0,43,46,53,142
8075,Russia,2008.0,43,46,53,142
8076,Russia,2000.0,66,67,54,187
8077,Russia,2014.0,33,22,13,68
8078,Russia,2014.0,33,22,13,68
8079,Russia,2016.0,52,28,35,115
8080,Russia,2000.0,66,67,54,187
8081,Russia,2016.0,52,28,35,115
8082,Russia,2006.0,16,12,13,41
8083,Gallia II,1912.0,0,5,9,14
8084,Russia,2014.0,33,22,13,68
8085,Russia,2008.0,43,46,53,142
8086,Russia,2008.0,43,46,53,142
8087,Russia-1,2002.0,6,5,27,38
8088,Russia,2000.0,66,67,54,187
8089,Russia,2000.0,66,67,54,187
8090,Russia,2000.0,66,67,54,187
8091,Russia,2008.0,43,46,53,142
8092,Russia,2012.0,50,39,51,140
8093,Russia,2006.0,16,12,13,41
8094,Russia,2014.0,33,22,13,68
8095,Russia,2000.0,66,67,54,187
8096,Russia,2004.0,48,46,95,189
8097,Russia,2016.0,52,28,35,115
8098,Russia,1996.0,36,45,34,115
8099,Russia,2000.0,66,67,54,187
8100,Russia,2008.0,43,46,53,142
8101,Russia,1996.0,36,45,34,115
8102,Russia,1996.0,36,45,34,115
8103,Russia,2004.0,48,46,95,189
8104,Russia,1996.0,36,45,34,115
8105,Russia,2012.0,50,39,51,140
8106,Russia,1996.0,36,45,34,115
8107,Russia,2012.0,50,39,51,140
8108,Russia,2000.0,66,67,54,187
8109,Russia,2004.0,48,46,95,189
8110,Russia,2004.0,48,46,95,189
8111,Russia-2,2016.0,52,28,35,115
8112,Russia,2012.0,50,39,51,140
8113,Russia,2000.0,66,67,54,187
8114,Russia,2004.0,48,46,95,189
8115,Russia,2016.0,52,28,35,115
8116,Russia,1996.0,36,45,34,115
8117,Russia,2000.0,66,67,54,187
8118,Russia,2002.0,6,5,27,38
8119,Russia,2000.0,66,67,54,187
8120,Russia,2014.0,33,22,13,68
8121,Russia,2004.0,48,46,95,189
8122,Russia,1996.0,36,45,34,115
8123,Russia,2016.0,52,28,35,115
8124,Russia,2008.0,43,46,53,142
8125,Russia,2004.0,48,46,95,189
8126,Russia,2008.0,43,46,53,142
8127,Russia,2016.0,52,28,35,115
8128,Russia-1,2006.0,16,12,13,41
8129,Russia,1996.0,36,45,34,115
8130,Russia,2000.0,66,67,54,187
8131,Russia,2008.0,43,46,53,142
8132,Russia,2002.0,6,5,27,38
8133,Russia,1996.0,36,45,34,115
8134,Russia,2016.0,52,28,35,115
8135,Russia,1996.0,36,45,34,115
8136,Russia,1996.0,36,45,34,115
8137,Russia,1996.0,36,45,34,115
8138,Russia,1998.0,14,32,6,52
8139,Russia,2002.0,6,5,27,38
8140,Russia,1996.0,36,45,34,115
8141,Russia,2000.0,66,67,54,187
8142,Russia,2006.0,16,12,13,41
8143,Russia,2006.0,16,12,13,41
8144,Russia,2012.0,50,39,51,140
8145,Russia,1998.0,14,32,6,52
8146,Russia,1996.0,36,45,34,115
8147,Russia,2016.0,52,28,35,115
8148,Russia,1912.0,0,5,9,14
8149,Russia,2000.0,66,67,54,187
8150,Russia,2008.0,43,46,53,142
8151,Russia,2012.0,50,39,51,140
8152,Russia,2008.0,43,46,53,142
8153,Russia,2012.0,50,39,51,140
8154,Russia,1998.0,14,32,6,52
8155,Russia,2002.0,6,5,27,38
8156,Russia,1998.0,14,32,6,52
8157,Russia,2004.0,48,46,95,189
8158,Russia-2,1994.0,19,13,4,36
8159,Russia,2000.0,66,67,54,187
8160,Russia,2004.0,48,46,95,189
8161,Russia,2008.0,43,46,53,142
8162,Russia,2004.0,48,46,95,189
8163,Russia,1996.0,36,45,34,115
8164,Russia,2012.0,50,39,51,140
8165,Russia,2010.0,6,5,14,25
8166,Russia,1998.0,14,32,6,52
8167,Russia,2012.0,50,39,51,140
8168,Russia,2000.0,66,67,54,187
8169,Russia,2012.0,50,39,51,140
8170,Russia,2000.0,66,67,54,187
8171,Russia,2004.0,48,46,95,189
8172,Russia,2012.0,50,39,51,140
8173,Russia,2016.0,52,28,35,115
8174,Russia,2008.0,43,46,53,142
8175,Russia,2004.0,48,46,95,189
8176,Russia,2000.0,66,67,54,187
8177,Russia,2004.0,48,46,95,189
8178,Russia,2012.0,50,39,51,140
8179,Russia,1998.0,14,32,6,52
8180,Russia,2012.0,50,39,51,140
8181,Russia,2012.0,50,39,51,140
8182,Russia,2012.0,50,39,51,140
8183,Russia,2012.0,50,39,51,140
8184,Russia,2016.0,52,28,35,115
8185,Russia,2016.0,52,28,35,115
8186,Russia,2016.0,52,28,35,115
8187,Russia,2000.0,66,67,54,187
8188,Russia,2016.0,52,28,35,115
8189,Russia,2004.0,48,46,95,189
8190,Russia-1,2006.0,16,12,13,41
8191,Russia,2012.0,50,39,51,140
8192,Russia,2000.0,66,67,54,187
8193,Russia,2004.0,48,46,95,189
8194,Russia,2012.0,50,39,51,140
8195,Russia-1,2014.0,33,22,13,68
8196,Russia,1998.0,14,32,6,52
8197,Russia,1996.0,36,45,34,115
8198,Russia,1996.0,36,45,34,115
8199,Russia,1996.0,36,45,34,115
8200,Russia,1996.0,36,45,34,115
8201,Russia,1996.0,36,45,34,115
8202,Russia,1996.0,36,45,34,115
8203,Russia,2000.0,66,67,54,187
8204,Russia,2000.0,66,67,54,187
8205,Russia,2000.0,66,67,54,187
8206,Russia,2000.0,66,67,54,187
8207,Russia,2000.0,66,67,54,187
8208,Russia,2000.0,66,67,54,187
8209,Russia,2004.0,48,46,95,189
8210,Russia,2004.0,48,46,95,189
8211,Russia,2000.0,66,67,54,187
8212,Russia,2012.0,50,39,51,140
8213,Russia,2008.0,43,46,53,142
8214,Russia,2016.0,52,28,35,115
8215,Russia,2014.0,33,22,13,68
8216,Russia,2004.0,48,46,95,189
8217,Russia,1996.0,36,45,34,115
8218,Russia,2002.0,6,5,27,38
8219,Russia,2004.0,48,46,95,189
8220,Russia,2008.0,43,46,53,142
8221,Russia,1994.0,19,13,4,36
8222,Russia,2004.0,48,46,95,189
8223,Russia,2000.0,66,67,54,187
8224,Russia,2004.0,48,46,95,189
8225,Russia,2012.0,50,39,51,140
8226,Russia,2012.0,50,39,51,140
8227,Russia,2000.0,66,67,54,187
8228,Russia,2014.0,33,22,13,68
8229,Russia,2000.0,66,67,54,187
8230,Russia,2004.0,48,46,95,189
8231,Russia,2008.0,43,46,53,142
8232,Russia,1908.0,1,2,0,3
8233,Russia,2004.0,48,46,95,189
8234,Russia,2008.0,43,46,53,142
8235,Russia,2008.0,43,46,53,142
8236,Russia,2012.0,50,39,51,140
8237,Russia,2008.0,43,46,53,142
8238,Russia-2,1998.0,14,32,6,52
8239,Russia,2008.0,43,46,53,142
8240,Russia,1996.0,36,45,34,115
8241,Russia,2000.0,66,67,54,187
8242,Russia,2004.0,48,46,95,189
8243,Russia,2004.0,48,46,95,189
8244,Russia,2008.0,43,46,53,142
8245,Russia,2008.0,43,46,53,142
8246,Russia,1996.0,36,45,34,115
8247,Russia,1996.0,36,45,34,115
8248,Russia,1996.0,36,45,34,115
8249,Russia,1912.0,0,5,9,14
8250,Russia,2016.0,52,28,35,115
8251,Russia,2010.0,6,5,14,25
8252,Russia,2012.0,50,39,51,140
8253,Russia,2012.0,50,39,51,140
8254,Russia,2016.0,52,28,35,115
8255,Russia,2016.0,52,28,35,115
8256,Russia,2012.0,50,39,51,140
8257,Russia,2016.0,52,28,35,115
8258,Russia,2004.0,48,46,95,189
8259,Russia,2004.0,48,46,95,189
8260,Russia,1996.0,36,45,34,115
8261,Russia,2000.0,66,67,54,187
8262,Russia,2016.0,52,28,35,115
8263,Russia,2000.0,66,67,54,187
8264,Russia,2012.0,50,39,51,140
8265,Russia,1908.0,1,2,0,3
8266,Russia,1996.0,36,45,34,115
8267,Russia,2000.0,66,67,54,187
8268,Russia,2016.0,52,28,35,115
8269,Russia-1,2012.0,50,39,51,140
8270,Russia,2000.0,66,67,54,187
8271,Russia,2000.0,66,67,54,187
8272,Russia,2012.0,50,39,51,140
8273,Russia,2010.0,6,5,14,25
8274,Russia,1996.0,36,45,34,115
8275,Russia,2004.0,48,46,95,189
8276,Russia,2012.0,50,39,51,140
8277,Russia-1,1994.0,19,13,4,36
8278,Russia-1,1998.0,14,32,6,52
8279,Russia,2004.0,48,46,95,189
8280,Russia,2002.0,6,5,27,38
8281,Russia,2006.0,16,12,13,41
8282,Russia,2010.0,6,5,14,25
8283,Russia,2014.0,33,22,13,68
8284,Russia,1996.0,36,45,34,115
8285,Russia,2000.0,66,67,54,187
8286,Russia,2000.0,66,67,54,187
8287,Russia,2004.0,48,46,95,189
8288,Russia,2012.0,50,39,51,140
8289,Russia,2008.0,43,46,53,142
8290,Russia,2008.0,43,46,53,142
8291,Russia,2008.0,43,46,53,142
8292,Russia,2004.0,48,46,95,189
8293,Russia,2008.0,43,46,53,142
8294,Russia,2008.0,43,46,53,142
8295,Russia,2012.0,50,39,51,140
8296,Russia,1996.0,36,45,34,115
8297,Russia,1996.0,36,45,34,115
8298,Russia,1996.0,36,45,34,115
8299,Russia,1996.0,36,45,34,115
8300,Russia,2000.0,66,67,54,187
8301,Russia,2000.0,66,67,54,187
8302,Russia,2004.0,48,46,95,189
8303,Russia,2004.0,48,46,95,189
8304,Russia,2008.0,43,46,53,142
8305,Russia,2008.0,43,46,53,142
8306,Russia,2012.0,50,39,51,140
8307,Russia,2000.0,66,67,54,187
8308,Russia,2004.0,48,46,95,189
8309,Russia,1996.0,36,45,34,115
8310,Russia,1996.0,36,45,34,115
8311,Russia,2000.0,66,67,54,187
8312,Russia,2004.0,48,46,95,189
8313,Russia,2004.0,48,46,95,189
8314,Russia,2008.0,43,46,53,142
8315,Russia,1996.0,36,45,34,115
8316,Russia,2000.0,66,67,54,187
8317,Russia,2000.0,66,67,54,187
8318,Russia,2000.0,66,67,54,187
8319,Russia,2000.0,66,67,54,187
8320,Russia,2000.0,66,67,54,187
8321,Russia,2016.0,52,28,35,115
8322,Russia,2016.0,52,28,35,115
8323,Gallia II,1912.0,0,5,9,14
8324,Russia,2002.0,6,5,27,38
8325,Russia,2002.0,6,5,27,38
8326,Russia,2010.0,6,5,14,25
8327,Russia,1996.0,36,45,34,115
8328,Russia,2004.0,48,46,95,189
8329,Russia,2008.0,43,46,53,142
8330,Russia,2016.0,52,28,35,115
8331,Russia,2004.0,48,46,95,189
8332,Russia,2004.0,48,46,95,189
8333,Russia,1994.0,19,13,4,36
8334,Russia,2006.0,16,12,13,41
8335,Gallia II,1912.0,0,5,9,14
8336,Russia,2014.0,33,22,13,68
8337,Russia,2008.0,43,46,53,142
8338,Russia,2012.0,50,39,51,140
8339,Russia,2012.0,50,39,51,140
8340,Russia,2016.0,52,28,35,115
8341,Russia,2016.0,52,28,35,115
8342,Russia,1998.0,14,32,6,52
8343,Russia,2008.0,43,46,53,142
8344,Russia,2006.0,16,12,13,41
8345,Russia,1996.0,36,45,34,115
8346,Russia,2008.0,43,46,53,142
8347,Russia,2016.0,52,28,35,115
8348,Russia,2000.0,66,67,54,187
8349,Russia,1996.0,36,45,34,115
8350,Russia,2004.0,48,46,95,189
8351,Russia,2016.0,52,28,35,115
8352,Russia,2016.0,52,28,35,115
8353,Russia,2016.0,52,28,35,115
8354,Russia,2008.0,43,46,53,142
8355,Russia,1996.0,36,45,34,115
8356,Russia,2000.0,66,67,54,187
8357,Russia,2004.0,48,46,95,189
8358,Russia,2008.0,43,46,53,142
8359,Russia,2002.0,6,5,27,38
8360,Russia,2000.0,66,67,54,187
8361,Russia,2004.0,48,46,95,189
8362,Russia,2000.0,66,67,54,187
8363,Russia,1996.0,36,45,34,115
8364,Russia,2000.0,66,67,54,187
8365,Russia,2000.0,66,67,54,187
8366,Russia,2000.0,66,67,54,187
8367,Russia,2000.0,66,67,54,187
8368,Russia,2004.0,48,46,95,189
8369,Russia,2008.0,43,46,53,142
8370,Russia,2000.0,66,67,54,187
8371,Russia,2012.0,50,39,51,140
8372,Russia,2000.0,66,67,54,187
8373,Russia,1996.0,36,45,34,115
8374,Russia,2004.0,48,46,95,189
8375,Russia,2008.0,43,46,53,142
8376,Russia,2004.0,48,46,95,189
8377,Gallia II,1912.0,0,5,9,14
8378,Russia,2016.0,52,28,35,115
8379,Russia-1,2006.0,16,12,13,41
8380,Russia,1996.0,36,45,34,115
8381,Russia,2012.0,50,39,51,140
8382,Russia,2016.0,52,28,35,115
8383,Russia,2016.0,52,28,35,115
8384,Russia,2012.0,50,39,51,140
8385,Russia-1,2010.0,6,5,14,25
8386,Russia,1996.0,36,45,34,115
8387,Russia,2008.0,43,46,53,142
8388,Russia,2000.0,66,67,54,187
8389,Russia,2008.0,43,46,53,142
8390,Russia,2012.0,50,39,51,140
8391,Russia,1996.0,36,45,34,115
8392,Russia,2012.0,50,39,51,140
8393,Russia,1996.0,36,45,34,115
8394,Russia,1996.0,36,45,34,115
8395,Russia,2000.0,66,67,54,187
8396,Russia,2004.0,48,46,95,189
8397,Russia,1996.0,36,45,34,115
8398,Russia,1996.0,36,45,34,115
8399,Russia,2004.0,48,46,95,189
8400,Russia,2008.0,43,46,53,142
8401,Russia,2004.0,48,46,95,189
8402,Russia,1996.0,36,45,34,115
8403,Russia,2000.0,66,67,54,187
8404,Russia,2014.0,33,22,13,68
8405,Russia,2000.0,66,67,54,187
8406,Russia,2008.0,43,46,53,142
8407,Russia,2010.0,6,5,14,25
8408,Russia,2014.0,33,22,13,68
8409,Russia,2012.0,50,39,51,140
8410,Russia,2016.0,52,28,35,115
8411,Russia,2012.0,50,39,51,140
8412,Russia,2008.0,43,46,53,142
8413,Russia,2016.0,52,28,35,115
8414,Russia,2004.0,48,46,95,189
8415,Russia,2008.0,43,46,53,142
8416,Russia,1998.0,14,32,6,52
8417,Russia,2016.0,52,28,35,115
8418,Russia,2012.0,50,39,51,140
8419,Russia,1996.0,36,45,34,115
8420,Russia,2000.0,66,67,54,187
8421,Russia,2014.0,33,22,13,68
8422,Russia,1994.0,19,13,4,36
8423,Russia,2016.0,52,28,35,115
8424,Russia,2016.0,52,28,35,115
8425,Russia,2012.0,50,39,51,140
8426,Russia,2006.0,16,12,13,41
8427,Russia,2008.0,43,46,53,142
8428,Russia-2,1998.0,14,32,6,52
8429,Russia-1,2002.0,6,5,27,38
8430,Russia,2008.0,43,46,53,142
8431,Russia,2004.0,48,46,95,189
8432,Russia,2016.0,52,28,35,115
8433,Russia,2004.0,48,46,95,189
8434,Russia,1996.0,36,45,34,115
8435,Russia,2010.0,6,5,14,25
8436,Russia,2010.0,6,5,14,25
8437,Russia,2014.0,33,22,13,68
8438,Russia,2010.0,6,5,14,25
8439,Russia,2004.0,48,46,95,189
8440,Russia,2008.0,43,46,53,142
8441,Russia,2000.0,66,67,54,187
8442,Russia,2002.0,6,5,27,38
8443,Russia,2006.0,16,12,13,41
8444,Russia,2000.0,66,67,54,187
8445,Russia,2004.0,48,46,95,189
8446,Russia,2004.0,48,46,95,189
8447,Russia,2000.0,66,67,54,187
8448,Russia,2014.0,33,22,13,68
8449,Russia,1994.0,19,13,4,36
8450,Russia,2016.0,52,28,35,115
8451,Russia,2012.0,50,39,51,140
8452,Russia,2012.0,50,39,51,140
8453,Russia,2000.0,66,67,54,187
8454,Russia,2004.0,48,46,95,189
8455,Russia,2008.0,43,46,53,142
8456,Russia,2012.0,50,39,51,140
8457,Russia,2014.0,33,22,13,68
8458,Russia,2000.0,66,67,54,187
8459,Russia,2014.0,33,22,13,68
8460,Russia,2000.0,66,67,54,187
8461,Russia,2004.0,48,46,95,189
8462,Russia,2016.0,52,28,35,115
8463,Russia,2016.0,52,28,35,115
8464,Russia,2004.0,48,46,95,189
8465,Russia,2008.0,43,46,53,142
8466,Russia-2,2014.0,33,22,13,68
8467,Russia,2014.0,33,22,13,68
8468,Russia,1998.0,14,32,6,52
8469,Russia,2000.0,66,67,54,187
8470,Russia,2004.0,48,46,95,189
8471,Gallia II,1912.0,0,5,9,14
8472,Russia,2016.0,52,28,35,115
8473,Russia,2000.0,66,67,54,187
8474,Russia,2016.0,52,28,35,115
8475,Russia,2008.0,43,46,53,142
8476,Russia,2000.0,66,67,54,187
8477,Russia,2008.0,43,46,53,142
8478,Russia,2000.0,66,67,54,187
8479,Russia,2004.0,48,46,95,189
8480,Russia,1996.0,36,45,34,115
8481,Russia,2004.0,48,46,95,189
8482,Russia,1994.0,19,13,4,36
8483,Russia,2004.0,48,46,95,189
8484,Russia,2000.0,66,67,54,187
8485,Russia,1994.0,19,13,4,36
8486,Russia,1994.0,19,13,4,36
8487,Russia,1994.0,19,13,4,36
8488,Russia,1998.0,14,32,6,52
8489,Russia,2016.0,52,28,35,115
8490,Russia,2004.0,48,46,95,189
8491,Russia,2000.0,66,67,54,187
8492,Russia,2004.0,48,46,95,189
8493,Russia,2008.0,43,46,53,142
8494,Russia,2012.0,50,39,51,140
8495,Russia,2012.0,50,39,51,140
8496,Russia,2016.0,52,28,35,115
8497,Russia,2004.0,48,46,95,189
8498,Russia,2008.0,43,46,53,142
8499,Russia,1996.0,36,45,34,115
8500,Russia,2000.0,66,67,54,187
8501,Russia,2004.0,48,46,95,189
8502,Russia,2016.0,52,28,35,115
8503,Russia,1998.0,14,32,6,52
8504,Russia,2000.0,66,67,54,187
8505,Russia,2004.0,48,46,95,189
8506,Russia,2000.0,66,67,54,187
8507,Russia,2016.0,52,28,35,115
8508,Russia,2000.0,66,67,54,187
8509,Russia,2004.0,48,46,95,189
8510,Russia,2016.0,52,28,35,115
8511,Russia,2000.0,66,67,54,187
8512,Russia,2004.0,48,46,95,189
8513,Russia,2012.0,50,39,51,140
8514,Russia-1,2006.0,16,12,13,41
8515,Russia,2012.0,50,39,51,140
8516,Russia,1996.0,36,45,34,115
8517,Russia-1,2014.0,33,22,13,68
8518,Russia,2014.0,33,22,13,68
8519,Russia,1998.0,14,32,6,52
8520,Russia,2010.0,6,5,14,25
8521,Russia,2014.0,33,22,13,68
8522,Russia,1996.0,36,45,34,115
8523,Russia-1,2014.0,33,22,13,68
8524,Russia,1996.0,36,45,34,115
8525,Russia,2012.0,50,39,51,140
8526,Russia,2012.0,50,39,51,140
8527,Russia,1996.0,36,45,34,115
8528,Russia,2000.0,66,67,54,187
8529,Russia,2004.0,48,46,95,189
8530,Russia,2008.0,43,46,53,142
8531,Russia,2016.0,52,28,35,115
8532,Russia,2002.0,6,5,27,38
8533,Russia,2004.0,48,46,95,189
8534,Russia,2012.0,50,39,51,140
8535,Russia,2008.0,43,46,53,142
8536,Russia,2000.0,66,67,54,187
8537,Russia,1994.0,19,13,4,36
8538,Russia,2012.0,50,39,51,140
8539,Russia,2000.0,66,67,54,187
8540,Russia,2004.0,48,46,95,189
8541,Russia,1996.0,36,45,34,115
8542,Russia,2008.0,43,46,53,142
8543,Russia-2,1994.0,19,13,4,36
8544,Russia,2010.0,6,5,14,25
8545,Russia,2010.0,6,5,14,25
8546,Russia,2014.0,33,22,13,68
8547,Russia,2016.0,52,28,35,115
8548,Russia,1994.0,19,13,4,36
8549,Russia,1998.0,14,32,6,52
8550,Russia,1996.0,36,45,34,115
8551,Russia,2000.0,66,67,54,187
8552,Russia,2000.0,66,67,54,187
8553,Russia,2000.0,66,67,54,187
8554,Russia,2000.0,66,67,54,187
8555,Russia,2012.0,50,39,51,140
8556,Russia,2016.0,52,28,35,115
8557,Russia,2016.0,52,28,35,115
8558,Russia,2004.0,48,46,95,189
8559,Russia,2008.0,43,46,53,142
8560,Russia,1996.0,36,45,34,115
8561,Russia,2008.0,43,46,53,142
8562,Russia-2,2016.0,52,28,35,115
8563,Russia,2014.0,33,22,13,68
8564,Russia,2014.0,33,22,13,68
8565,Russia,2012.0,50,39,51,140
8566,Russia,2012.0,50,39,51,140
8567,Russia,2016.0,52,28,35,115
8568,Russia,2004.0,48,46,95,189
8569,Russia,2008.0,43,46,53,142
8570,Russia,2008.0,43,46,53,142
8571,Russia,2012.0,50,39,51,140
8572,Russia,2014.0,33,22,13,68
8573,Russia,2008.0,43,46,53,142
8574,Russia,1996.0,36,45,34,115
8575,Russia,2012.0,50,39,51,140
8576,Russia-1,2014.0,33,22,13,68
8577,Russia,2014.0,33,22,13,68
8578,Russia,2012.0,50,39,51,140
8579,Russia,2016.0,52,28,35,115
8580,Russia,2000.0,66,67,54,187
8581,Russia,2012.0,50,39,51,140
8582,Russia,1996.0,36,45,34,115
8583,Russia-1,2006.0,16,12,13,41
8584,Russia-1,2010.0,6,5,14,25
8585,Russia-1,2014.0,33,22,13,68
8586,Russia-1,2014.0,33,22,13,68
8587,Russia,2004.0,48,46,95,189
8588,Russia,1912.0,0,5,9,14
8589,Russia,2016.0,52,28,35,115
8590,Russia,2008.0,43,46,53,142
8591,Russia,2008.0,43,46,53,142
8592,Russia,2016.0,52,28,35,115
8593,Russia,2014.0,33,22,13,68
8594,Russia,2014.0,33,22,13,68
8595,Russia,2014.0,33,22,13,68
8596,Russia,2006.0,16,12,13,41
8597,Russia,2014.0,33,22,13,68
8598,Russia,2014.0,33,22,13,68
8599,Russia,2002.0,6,5,27,38
8600,Russia,2004.0,48,46,95,189
8601,Russia,2000.0,66,67,54,187
8602,Russia,2014.0,33,22,13,68
8603,Russia,1998.0,14,32,6,52
8604,Russia,2002.0,6,5,27,38
8605,Russia,2000.0,66,67,54,187
8606,Russia,2012.0,50,39,51,140
8607,Russia,2016.0,52,28,35,115
8608,Russia,2016.0,52,28,35,115
8609,Russia,2004.0,48,46,95,189
8610,Russia-1,2006.0,16,12,13,41
8611,Russia,1996.0,36,45,34,115
8612,Russia,1996.0,36,45,34,115
8613,Russia,1994.0,19,13,4,36
8614,Russia,1994.0,19,13,4,36
8615,Russia,1994.0,19,13,4,36
8616,Russia,1994.0,19,13,4,36
8617,Russia,1996.0,36,45,34,115
8618,Russia,2016.0,52,28,35,115
8619,Russia,2016.0,52,28,35,115
8620,Russia,2000.0,66,67,54,187
8621,Russia,2004.0,48,46,95,189
8622,Russia,2000.0,66,67,54,187
8623,Russia,2014.0,33,22,13,68
8624,Russia,2004.0,48,46,95,189
8625,Russia,2004.0,48,46,95,189
8626,Russia,2008.0,43,46,53,142
8627,Russia,2008.0,43,46,53,142
8628,Russia,2000.0,66,67,54,187
8629,Russia,2004.0,48,46,95,189
8630,Russia,2016.0,52,28,35,115
8631,Russia,2000.0,66,67,54,187
8632,Russia,2004.0,48,46,95,189
8633,Russia,2008.0,43,46,53,142
8634,Russia,2004.0,48,46,95,189
8635,Russia,2004.0,48,46,95,189
8636,Russia,1998.0,14,32,6,52
8637,Russia,1996.0,36,45,34,115
8638,Russia,2012.0,50,39,51,140
8639,Russia,2012.0,50,39,51,140
8640,Russia,2016.0,52,28,35,115
8641,Russia,1996.0,36,45,34,115
8642,Russia,2004.0,48,46,95,189
8643,Russia,2012.0,50,39,51,140
8644,Russia,1996.0,36,45,34,115
8645,Russia,2012.0,50,39,51,140
8646,Russia,2012.0,50,39,51,140
8647,Russia,2014.0,33,22,13,68
8648,Russia,2000.0,66,67,54,187
8649,Russia,2004.0,48,46,95,189
8650,Russia,2012.0,50,39,51,140
8651,Russia,2000.0,66,67,54,187
8652,Russia,2000.0,66,67,54,187
8653,Russia,2000.0,66,67,54,187
8654,Russia,2004.0,48,46,95,189
8655,Russia,2012.0,50,39,51,140
8656,Russia,2014.0,33,22,13,68
8657,Russia,2006.0,16,12,13,41
8658,Russia,2010.0,6,5,14,25
8659,Russia,2010.0,6,5,14,25
8660,Russia,2014.0,33,22,13,68
8661,Russia,1998.0,14,32,6,52
8662,Russia,1996.0,36,45,34,115
8663,Russia,1998.0,14,32,6,52
8664,Russia,2002.0,6,5,27,38
8665,Russia,2016.0,52,28,35,115
8666,Russia,1998.0,14,32,6,52
8667,Russia,2016.0,52,28,35,115
8668,Russia-2,1994.0,19,13,4,36
8669,Russia,2004.0,48,46,95,189
8670,Russia,2000.0,66,67,54,187
8671,Russia,2000.0,66,67,54,187
8672,Russia,2004.0,48,46,95,189
8673,Russia-1,2006.0,16,12,13,41
8674,Russia-1,2010.0,6,5,14,25
8675,Russia-1,2014.0,33,22,13,68
8676,Russia-1,2014.0,33,22,13,68
8677,Russia,2008.0,43,46,53,142
8678,Russia,2012.0,50,39,51,140
8679,Russia,2008.0,43,46,53,142
8680,Russia,2000.0,66,67,54,187
8681,Russia,2004.0,48,46,95,189
8682,Belarus,2008.0,8,5,16,29
8683,Belarus,2000.0,3,8,11,22
8684,Belarus,2004.0,2,5,8,15
8685,Belarus,2008.0,8,5,16,29
8686,Belarus,2000.0,3,8,11,22
8687,Belarus,1998.0,0,0,2,2
8688,Belarus,2012.0,3,12,8,23
8689,Belarus,2012.0,3,12,8,23
8690,Belarus,2008.0,8,5,16,29
8691,Belarus,1996.0,1,6,16,23
8692,Belarus,2000.0,3,8,11,22
8693,Belarus,2000.0,3,8,11,22
8694,Belarus,2004.0,2,5,8,15
8695,Belarus,2000.0,3,8,11,22
8696,Belarus,2004.0,2,5,8,15
8697,Belarus,2008.0,8,5,16,29
8698,Belarus,2008.0,8,5,16,29
8699,Belarus,2012.0,3,12,8,23
8700,Belarus,2008.0,8,5,16,29
8701,Belarus,2012.0,3,12,8,23
8702,Belarus,2012.0,3,12,8,23
8703,Belarus,1998.0,0,0,2,2
8704,Belarus,2006.0,0,1,0,1
8705,Belarus,1996.0,1,6,16,23
8706,Belarus,2000.0,3,8,11,22
8707,Belarus,2008.0,8,5,16,29
8708,Belarus,2010.0,1,1,1,3
8709,Belarus,2014.0,5,0,1,6
8710,Belarus,2014.0,5,0,1,6
8711,Belarus,2014.0,5,0,1,6
8712,Belarus,2000.0,3,8,11,22
8713,Belarus,1996.0,1,6,16,23
8714,Belarus,2016.0,1,4,7,12
8715,Belarus,2008.0,8,5,16,29
8716,Belarus,2004.0,2,5,8,15
8717,Belarus,2008.0,8,5,16,29
8718,Belarus,2012.0,3,12,8,23
8719,Belarus,2012.0,3,12,8,23
8720,Belarus,2016.0,1,4,7,12
8721,Belarus,2000.0,3,8,11,22
8722,Belarus,2016.0,1,4,7,12
8723,Belarus,2012.0,3,12,8,23
8724,Belarus,2002.0,0,0,1,1
8725,Belarus,2010.0,1,1,1,3
8726,Belarus,2000.0,3,8,11,22
8727,Belarus,2008.0,8,5,16,29
8728,Belarus,2012.0,3,12,8,23
8729,Belarus,1996.0,1,6,16,23
8730,Belarus,1996.0,1,6,16,23
8731,Belarus,2000.0,3,8,11,22
8732,Belarus,2004.0,2,5,8,15
8733,Belarus,2008.0,8,5,16,29
8734,Belarus,2008.0,8,5,16,29
8735,Belarus,2012.0,3,12,8,23
8736,Belarus,2016.0,1,4,7,12
8737,Belarus,2008.0,8,5,16,29
8738,Belarus,2012.0,3,12,8,23
8739,Belarus,2014.0,5,0,1,6
8740,Belarus,2000.0,3,8,11,22
8741,Belarus,2000.0,3,8,11,22
8742,Belarus,1996.0,1,6,16,23
8743,Belarus,2000.0,3,8,11,22
8744,Belarus,2012.0,3,12,8,23
8745,Belarus,1996.0,1,6,16,23
8746,Belarus,2008.0,8,5,16,29
8747,Belarus,2008.0,8,5,16,29
8748,Belarus,2004.0,2,5,8,15
8749,Belarus,2004.0,2,5,8,15
8750,Belarus,2004.0,2,5,8,15
8751,Belarus,2008.0,8,5,16,29
8752,Belarus,2008.0,8,5,16,29
8753,Belarus,2012.0,3,12,8,23
8754,Belarus,2016.0,1,4,7,12
8755,Belarus,2008.0,8,5,16,29
8756,Belarus,2000.0,3,8,11,22
8757,Belarus,2004.0,2,5,8,15
8758,Belarus,2012.0,3,12,8,23
8759,Belarus,1996.0,1,6,16,23
8760,Belarus,2008.0,8,5,16,29
8761,Belarus,1996.0,1,6,16,23
8762,Belarus,2000.0,3,8,11,22
8763,Belarus,2012.0,3,12,8,23
8764,Belarus,2012.0,3,12,8,23
8765,Belarus,2016.0,1,4,7,12
8766,Belarus,2004.0,2,5,8,15
8767,Belarus,2010.0,1,1,1,3
8768,Belarus,2008.0,8,5,16,29
8769,Belarus,2000.0,3,8,11,22
8770,Belarus,2008.0,8,5,16,29
8771,Belarus,1996.0,1,6,16,23
8772,Belarus,1994.0,0,2,0,2
8773,Belarus,1996.0,1,6,16,23
8774,Belarus,1996.0,1,6,16,23
8775,Belarus,2004.0,2,5,8,15
8776,Belarus,2008.0,8,5,16,29
8777,Belarus,2008.0,8,5,16,29
8778,Belarus,2012.0,3,12,8,23
8779,Belarus,2012.0,3,12,8,23
8780,Belarus,2016.0,1,4,7,12
8781,Belarus,2012.0,3,12,8,23
8782,Belarus,2012.0,3,12,8,23
8783,Belarus,2016.0,1,4,7,12
8784,Belarus,2000.0,3,8,11,22
8785,Belarus,2000.0,3,8,11,22
8786,Belarus,2000.0,3,8,11,22
8787,Belarus,2004.0,2,5,8,15
8788,Belarus,2008.0,8,5,16,29
8789,Belarus,2016.0,1,4,7,12
8790,Belarus,2008.0,8,5,16,29
8791,Belarus,2012.0,3,12,8,23
8792,Belarus,1996.0,1,6,16,23
8793,Belarus,2000.0,3,8,11,22
8794,Belarus,2008.0,8,5,16,29
8795,Belarus,1996.0,1,6,16,23
8796,Belarus,1996.0,1,6,16,23
8797,Belarus,1996.0,1,6,16,23
8798,Belarus,1996.0,1,6,16,23
8799,Belarus,2012.0,3,12,8,23
8800,Belarus,2014.0,5,0,1,6
8801,Belarus,1996.0,1,6,16,23
8802,Belarus,1996.0,1,6,16,23
8803,Belarus,2016.0,1,4,7,12
8804,Belarus,2004.0,2,5,8,15
8805,Belarus,2008.0,8,5,16,29
8806,Belarus,2016.0,1,4,7,12
8807,Belarus,2016.0,1,4,7,12
8808,Belarus,1996.0,1,6,16,23
8809,Belarus,2004.0,2,5,8,15
8810,Belarus,2014.0,5,0,1,6
8811,Belarus,2008.0,8,5,16,29
8812,Belarus,2012.0,3,12,8,23
8813,Belarus,1996.0,1,6,16,23
8814,Belarus,2000.0,3,8,11,22
8815,Belarus,1994.0,0,2,0,2
8816,Belarus,2008.0,8,5,16,29
8817,Belarus,1996.0,1,6,16,23
8818,Belarus,2004.0,2,5,8,15
8819,Belarus,1996.0,1,6,16,23
8820,Belarus,2000.0,3,8,11,22
8821,Cameroon,2000.0,18,0,0,18
8822,Cameroon,2000.0,18,0,0,18
8823,Cameroon,2000.0,18,0,0,18
8824,Cameroon,2000.0,18,0,0,18
8825,Cameroon,1968.0,0,1,0,1
8826,Cameroon,2000.0,18,0,0,18
8827,Cameroon,2000.0,18,0,0,18
8828,Cameroon,2000.0,18,0,0,18
8829,Cameroon,2000.0,18,0,0,18
8830,Cameroon,2000.0,18,0,0,18
8831,Cameroon,2000.0,18,0,0,18
8832,Cameroon,2000.0,18,0,0,18
8833,Cameroon,2000.0,18,0,0,18
8834,Cameroon,2004.0,1,0,0,1
8835,Cameroon,2008.0,1,0,0,1
8836,Cameroon,2000.0,18,0,0,18
8837,Cameroon,2000.0,18,0,0,18
8838,Cameroon,1984.0,0,0,1,1
8839,Cameroon,2000.0,18,0,0,18
8840,Cameroon,2000.0,18,0,0,18
8841,Cameroon,2000.0,18,0,0,18
8842,Cameroon,2000.0,18,0,0,18
8843,United States,2004.0,117,75,71,263
8844,United States,2014.0,10,30,24,64
8845,United States,1900.0,30,16,17,63
8846,United States,2008.0,127,110,80,317
8847,United States,2004.0,117,75,71,263
8848,United States,2000.0,130,61,51,242
8849,United States,1924.0,98,46,50,194
8850,Vesper Boat Club,1900.0,30,16,17,63
8851,Vesper Boat Club,1904.0,128,141,125,394
8852,United States,2000.0,130,61,51,242
8853,United States,1932.0,91,68,64,223
8854,United States,1920.0,111,45,38,194
8855,United States,1936.0,53,29,30,112
8856,United States,1912.0,46,25,36,107
8857,United States,1912.0,46,25,36,107
8858,United States,1904.0,128,141,125,394
8859,United States,1912.0,46,25,36,107
8860,United States,1912.0,46,25,36,107
8861,United States,1912.0,46,25,36,107
8862,United States,2016.0,139,54,71,264
8863,United States,1952.0,87,48,29,164
8864,United States,1996.0,159,48,52,259
8865,United States,2008.0,127,110,80,317
8866,United States,2012.0,145,57,46,248
8867,United States,2012.0,145,57,46,248
8868,United States,2012.0,145,57,46,248
8869,United States,2016.0,139,54,71,264
8870,United States,2016.0,139,54,71,264
8871,United States,2016.0,139,54,71,264
8872,United States,2016.0,139,54,71,264
8873,United States,1996.0,159,48,52,259
8874,United States-1,2006.0,9,11,32,52
8875,United States,2008.0,127,110,80,317
8876,United States,1972.0,72,77,46,195
8877,United States,1948.0,93,34,41,168
8878,United States,1992.0,94,57,87,238
8879,United States,1992.0,94,57,87,238
8880,United States,1992.0,94,57,87,238
8881,United States,2004.0,117,75,71,263
8882,United States,2000.0,130,61,51,242
8883,United States,1996.0,159,48,52,259
8884,United States,2016.0,139,54,71,264
8885,United States,2012.0,145,57,46,248
8886,United States,2016.0,139,54,71,264
8887,United States,2016.0,139,54,71,264
8888,United States,1952.0,87,48,29,164
8889,United States,1956.0,63,61,25,149
8890,United States,1936.0,53,29,30,112
8891,United States,1928.0,53,30,19,102
8892,United States,1952.0,87,48,29,164
8893,United States,1932.0,91,68,64,223
8894,United States,1984.0,190,121,50,361
8895,United States,2016.0,139,54,71,264
8896,United States,1972.0,72,77,46,195
8897,United States,1996.0,159,48,52,259
8898,United States,2000.0,130,61,51,242
8899,United States,1964.0,96,39,42,177
8900,United States,1920.0,111,45,38,194
8901,United States,2004.0,117,75,71,263
8902,United States,2008.0,127,110,80,317
8903,United States,1964.0,96,39,42,177
8904,United States,2014.0,10,30,24,64
8905,Mound City Rowing Club-2,1904.0,128,141,125,394
8906,United States,2000.0,130,61,51,242
8907,United States,1964.0,96,39,42,177
8908,United States,1964.0,96,39,42,177
8909,United States,2002.0,11,58,15,84
8910,United States,1984.0,190,121,50,361
8911,United States,2012.0,145,57,46,248
8912,United States,2000.0,130,61,51,242
8913,United States,2008.0,127,110,80,317
8914,United States,1948.0,93,34,41,168
8915,United States,1964.0,96,39,42,177
8916,United States,1968.0,100,37,36,173
8917,United States,2012.0,145,57,46,248
8918,United States,2014.0,10,30,24,64
8919,United States,1932.0,91,68,64,223
8920,United States,2016.0,139,54,71,264
8921,United States,1948.0,93,34,41,168
8922,United States,1952.0,87,48,29,164
8923,United States,1956.0,63,61,25,149
8924,United States,1928.0,53,30,19,102
8925,United States,1932.0,91,68,64,223
8926,United States,1956.0,63,61,25,149
8927,United States,1988.0,89,67,58,214
8928,United States,1956.0,63,61,25,149
8929,United States,1964.0,96,39,42,177
8930,United States,1904.0,128,141,125,394
8931,United States,1904.0,128,141,125,394
8932,United States,1984.0,190,121,50,361
8933,United States,1984.0,190,121,50,361
8934,United States,1996.0,159,48,52,259
8935,United States,2004.0,117,75,71,263
8936,United States,2008.0,127,110,80,317
8937,United States,2012.0,145,57,46,248
8938,United States,2016.0,139,54,71,264
8939,United States,2004.0,117,75,71,263
8940,United States,2014.0,10,30,24,64
8941,United States,1928.0,53,30,19,102
8942,United States,1932.0,91,68,64,223
8943,United States,1920.0,111,45,38,194
8944,United States,1920.0,111,45,38,194
8945,United States,1984.0,190,121,50,361
8946,United States,2008.0,127,110,80,317
8947,United States,2012.0,145,57,46,248
8948,Vesper Boat Club,1904.0,128,141,125,394
8949,United States,1984.0,190,121,50,361
8950,United States,2008.0,127,110,80,317
8951,United States,2012.0,145,57,46,248
8952,United States,2016.0,139,54,71,264
8953,United States,1976.0,73,61,41,175
8954,United States,1960.0,100,27,25,152
8955,United States,2008.0,127,110,80,317
8956,United States,2000.0,130,61,51,242
8957,United States,2008.0,127,110,80,317
8958,United States,1988.0,89,67,58,214
8959,United States,1972.0,72,77,46,195
8960,Gallant,1932.0,91,68,64,223
8961,United States,1904.0,128,141,125,394
8962,United States,1952.0,87,48,29,164
8963,United States,1984.0,190,121,50,361
8964,United States,1984.0,190,121,50,361
8965,United States,1988.0,89,67,58,214
8966,United States,1988.0,89,67,58,214
8967,United States,1992.0,94,57,87,238
8968,United States,1964.0,96,39,42,177
8969,United States,1960.0,100,27,25,152
8970,United States-1,1952.0,87,48,29,164
8971,United States,1972.0,72,77,46,195
8972,United States,1972.0,72,77,46,195
8973,United States,1972.0,72,77,46,195
8974,United States,1972.0,72,77,46,195
8975,United States,1988.0,89,67,58,214
8976,United States,2008.0,127,110,80,317
8977,United States,2012.0,145,57,46,248
8978,United States,2016.0,139,54,71,264
8979,United States,1924.0,98,46,50,194
8980,United States,1996.0,159,48,52,259
8981,United States,1964.0,96,39,42,177
8982,United States,1992.0,94,57,87,238
8983,United States,1960.0,100,27,25,152
8984,United States,1908.0,34,16,15,65
8985,United States,1956.0,63,61,25,149
8986,United States,1960.0,100,27,25,152
8987,United States,2008.0,127,110,80,317
8988,United States,1996.0,159,48,52,259
8989,United States,1976.0,73,61,41,175
8990,United States,1976.0,73,61,41,175
8991,United States,1972.0,72,77,46,195
8992,United States,1972.0,72,77,46,195
8993,United States,1972.0,72,77,46,195
8994,United States,1972.0,72,77,46,195
8995,United States,1976.0,73,61,41,175
8996,United States,1976.0,73,61,41,175
8997,United States,1976.0,73,61,41,175
8998,United States,1976.0,73,61,41,175
8999,United States,1976.0,73,61,41,175
9000,United States,1992.0,94,57,87,238
9001,United States,1912.0,46,25,36,107
9002,United States,1984.0,190,121,50,361
9003,United States,1984.0,190,121,50,361
9004,United States,1960.0,100,27,25,152
9005,United States,1984.0,190,121,50,361
9006,United States,2010.0,12,63,22,97
9007,United States,1972.0,72,77,46,195
9008,United States,1908.0,34,16,15,65
9009,United States,1996.0,159,48,52,259
9010,United States-1,1932.0,91,68,64,223
9011,United States,2002.0,11,58,15,84
9012,United States,2010.0,12,63,22,97
9013,United States,1968.0,100,37,36,173
9014,United States,1998.0,25,4,5,34
9015,United States,2002.0,11,58,15,84
9016,United States,1924.0,98,46,50,194
9017,United States,2008.0,127,110,80,317
9018,United States,1928.0,53,30,19,102
9019,United States,1948.0,93,34,41,168
9020,United States,1980.0,24,4,2,30
9021,United States,2016.0,139,54,71,264
9022,United States,2016.0,139,54,71,264
9023,United States,2012.0,145,57,46,248
9024,United States,1998.0,25,4,5,34
9025,United States,2002.0,11,58,15,84
9026,United States,1952.0,87,48,29,164
9027,United States,1956.0,63,61,25,149
9028,United States,1956.0,63,61,25,149
9029,United States,1956.0,63,61,25,149
9030,United States,2000.0,130,61,51,242
9031,United States-2,2002.0,11,58,15,84
9032,United States,1920.0,111,45,38,194
9033,United States,1968.0,100,37,36,173
9034,United States,1968.0,100,37,36,173
9035,United States,2008.0,127,110,80,317
9036,United States,1936.0,53,29,30,112
9037,United States,1984.0,190,121,50,361
9038,United States,1984.0,190,121,50,361
9039,United States,1972.0,72,77,46,195
9040,United States,2016.0,139,54,71,264
9041,United States,1984.0,190,121,50,361
9042,United States,1928.0,53,30,19,102
9043,United States,1928.0,53,30,19,102
9044,United States,2008.0,127,110,80,317
9045,United States,1948.0,93,34,41,168
9046,United States,1992.0,94,57,87,238
9047,United States,1996.0,159,48,52,259
9048,United States,1968.0,100,37,36,173
9049,United States,1968.0,100,37,36,173
9050,United States,1972.0,72,77,46,195
9051,United States,1948.0,93,34,41,168
9052,United States,1952.0,87,48,29,164
9053,United States,2016.0,139,54,71,264
9054,United States,1964.0,96,39,42,177
9055,United States,1924.0,98,46,50,194
9056,United States,1988.0,89,67,58,214
9057,United States,1996.0,159,48,52,259
9058,United States,1972.0,72,77,46,195
9059,United States,1948.0,93,34,41,168
9060,United States,1988.0,89,67,58,214
9061,United States,2002.0,11,58,15,84
9062,United States,2012.0,145,57,46,248
9063,United States,1968.0,100,37,36,173
9064,United States,1964.0,96,39,42,177
9065,United States,1968.0,100,37,36,173
9066,United States,2016.0,139,54,71,264
9067,United States,1920.0,111,45,38,194
9068,United States,1936.0,53,29,30,112
9069,United States,1992.0,94,57,87,238
9070,United States,1988.0,89,67,58,214
9071,United States,1988.0,89,67,58,214
9072,United States,1932.0,91,68,64,223
9073,United States,1948.0,93,34,41,168
9074,Christian Brothers' College-1,1904.0,128,141,125,394
9075,United States,1984.0,190,121,50,361
9076,United States,1988.0,89,67,58,214
9077,United States,1988.0,89,67,58,214
9078,United States,1992.0,94,57,87,238
9079,United States,1996.0,159,48,52,259
9080,United States,2004.0,117,75,71,263
9081,United States,2004.0,117,75,71,263
9082,United States,1994.0,6,8,5,19
9083,United States,1932.0,91,68,64,223
9084,United States,1972.0,72,77,46,195
9085,United States,1976.0,73,61,41,175
9086,Bingo,1964.0,96,39,42,177
9087,United States,1928.0,53,30,19,102
9088,United States,1992.0,94,57,87,238
9089,United States,1996.0,159,48,52,259
9090,United States,1904.0,128,141,125,394
9091,United States,1988.0,89,67,58,214
9092,United States,1924.0,98,46,50,194
9093,United States,1984.0,190,121,50,361
9094,United States,1988.0,89,67,58,214
9095,United States,1992.0,94,57,87,238
9096,United States,1996.0,159,48,52,259
9097,United States,2012.0,145,57,46,248
9098,United States,1932.0,91,68,64,223
9099,United States,2010.0,12,63,22,97
9100,United States,1900.0,30,16,17,63
9101,United States,1900.0,30,16,17,63
9102,United States,1900.0,30,16,17,63
9103,United States,1900.0,30,16,17,63
9104,United States,1900.0,30,16,17,63
9105,United States,1928.0,53,30,19,102
9106,United States,1988.0,89,67,58,214
9107,United States,2000.0,130,61,51,242
9108,Chicago Athletic Association-2,1904.0,128,141,125,394
9109,United States,1968.0,100,37,36,173
9110,United States,1996.0,159,48,52,259
9111,United States,1996.0,159,48,52,259
9112,United States,1996.0,159,48,52,259
9113,United States,2000.0,130,61,51,242
9114,United States,2004.0,117,75,71,263
9115,United States,2004.0,117,75,71,263
9116,United States,2004.0,117,75,71,263
9117,United States,1984.0,190,121,50,361
9118,United States,1932.0,91,68,64,223
9119,United States,1948.0,93,34,41,168
9120,United States,2008.0,127,110,80,317
9121,United States,1984.0,190,121,50,361
9122,United States,2000.0,130,61,51,242
9123,United States,2004.0,117,75,71,263
9124,United States,1912.0,46,25,36,107
9125,United States,1960.0,100,27,25,152
9126,United States,1960.0,100,27,25,152
9127,United States,1948.0,93,34,41,168
9128,United States,1984.0,190,121,50,361
9129,United States,1992.0,94,57,87,238
9130,United States,1996.0,159,48,52,259
9131,United States,1924.0,98,46,50,194
9132,United States,1924.0,98,46,50,194
9133,United States,1928.0,53,30,19,102
9134,United States,1956.0,63,61,25,149
9135,United States,1904.0,128,141,125,394
9136,United States,2000.0,130,61,51,242
9137,United States,1956.0,63,61,25,149
9138,United States,2004.0,117,75,71,263
9139,Mound City Rowing Club-2,1904.0,128,141,125,394
9140,United States,1984.0,190,121,50,361
9141,United States,1968.0,100,37,36,173
9142,United States,2012.0,145,57,46,248
9143,United States,2012.0,145,57,46,248
9144,United States-1,2006.0,9,11,32,52
9145,United States,1904.0,128,141,125,394
9146,United States-2,1904.0,128,141,125,394
9147,United States,1984.0,190,121,50,361
9148,United States,1956.0,63,61,25,149
9149,United States,1996.0,159,48,52,259
9150,United States,2010.0,12,63,22,97
9151,United States,2014.0,10,30,24,64
9152,United States,1960.0,100,27,25,152
9153,United States,1988.0,89,67,58,214
9154,United States,1972.0,72,77,46,195
9155,United States,1972.0,72,77,46,195
9156,United States,1972.0,72,77,46,195
9157,United States,1908.0,34,16,15,65
9158,United States-1,1952.0,87,48,29,164
9159,United States-1,1952.0,87,48,29,164
9160,United States,1984.0,190,121,50,361
9161,United States,2000.0,130,61,51,242
9162,United States,2004.0,117,75,71,263
9163,United States,2004.0,117,75,71,263
9164,United States,1952.0,87,48,29,164
9165,United States,1920.0,111,45,38,194
9166,United States,1960.0,100,27,25,152
9167,United States,1960.0,100,27,25,152
9168,United States,1964.0,96,39,42,177
9169,United States,1964.0,96,39,42,177
9170,United States,1948.0,93,34,41,168
9171,United States,1996.0,159,48,52,259
9172,United States,2000.0,130,61,51,242
9173,United States,2000.0,130,61,51,242
9174,United States,1956.0,63,61,25,149
9175,United States,1984.0,190,121,50,361
9176,United States,1996.0,159,48,52,259
9177,United States,1932.0,91,68,64,223
9178,Widgeon,1964.0,96,39,42,177
9179,United States,1972.0,72,77,46,195
9180,United States,2016.0,139,54,71,264
9181,United States,2008.0,127,110,80,317
9182,United States,2012.0,145,57,46,248
9183,United States,2012.0,145,57,46,248
9184,United States,1996.0,159,48,52,259
9185,United States,2000.0,130,61,51,242
9186,United States,2004.0,117,75,71,263
9187,United States,2008.0,127,110,80,317
9188,United States,2008.0,127,110,80,317
9189,United States,2012.0,145,57,46,248
9190,United States,1956.0,63,61,25,149
9191,United States,1960.0,100,27,25,152
9192,United States,1964.0,96,39,42,177
9193,United States,1904.0,128,141,125,394
9194,United States,1988.0,89,67,58,214
9195,United States,1998.0,25,4,5,34
9196,United States,1988.0,89,67,58,214
9197,United States,1988.0,89,67,58,214
9198,United States,1992.0,94,57,87,238
9199,United States,1992.0,94,57,87,238
9200,United States,1984.0,190,121,50,361
9201,United States,1912.0,46,25,36,107
9202,United States,1984.0,190,121,50,361
9203,United States,1996.0,159,48,52,259
9204,United States,1984.0,190,121,50,361
9205,United States,1988.0,89,67,58,214
9206,United States,1988.0,89,67,58,214
9207,"New York Turnverein, New York",1904.0,128,141,125,394
9208,United States,2012.0,145,57,46,248
9209,United States,2004.0,117,75,71,263
9210,United States,2008.0,127,110,80,317
9211,United States,1996.0,159,48,52,259
9212,Angelita,1932.0,91,68,64,223
9213,United States-1,1948.0,93,34,41,168
9214,United States,1952.0,87,48,29,164
9215,United States,1984.0,190,121,50,361
9216,United States,1984.0,190,121,50,361
9217,United States,2016.0,139,54,71,264
9218,United States,2016.0,139,54,71,264
9219,United States,2016.0,139,54,71,264
9220,United States,2016.0,139,54,71,264
9221,United States,2016.0,139,54,71,264
9222,United States,1904.0,128,141,125,394
9223,United States,1908.0,34,16,15,65
9224,United States,1988.0,89,67,58,214
9225,United States,1912.0,46,25,36,107
9226,United States,1904.0,128,141,125,394
9227,United States,1904.0,128,141,125,394
9228,United States,1904.0,128,141,125,394
9229,United States,1904.0,128,141,125,394
9230,United States,1984.0,190,121,50,361
9231,United States,1988.0,89,67,58,214
9232,United States,1988.0,89,67,58,214
9233,United States,1988.0,89,67,58,214
9234,United States,1988.0,89,67,58,214
9235,United States,1988.0,89,67,58,214
9236,United States,1988.0,89,67,58,214
9237,United States,1988.0,89,67,58,214
9238,United States,1992.0,94,57,87,238
9239,United States,1992.0,94,57,87,238
9240,United States,1992.0,94,57,87,238
9241,United States,1992.0,94,57,87,238
9242,United States,2004.0,117,75,71,263
9243,United States,2008.0,127,110,80,317
9244,United States,2012.0,145,57,46,248
9245,United States,2016.0,139,54,71,264
9246,United States,1936.0,53,29,30,112
9247,"New York Turnverein, New York",1904.0,128,141,125,394
9248,United States,1932.0,91,68,64,223
9249,United States,1952.0,87,48,29,164
9250,United States,1928.0,53,30,19,102
9251,United States,2000.0,130,61,51,242
9252,United States,1972.0,72,77,46,195
9253,United States,1972.0,72,77,46,195
9254,United States,2004.0,117,75,71,263
9255,United States,1998.0,25,4,5,34
9256,United States,1988.0,89,67,58,214
9257,United States,1988.0,89,67,58,214
9258,United States,1992.0,94,57,87,238
9259,United States,1992.0,94,57,87,238
9260,United States,1994.0,6,8,5,19
9261,United States,1994.0,6,8,5,19
9262,United States,1932.0,91,68,64,223
9263,United States,1932.0,91,68,64,223
9264,United States,1956.0,63,61,25,149
9265,United States,1896.0,11,7,2,20
9266,United States,1936.0,53,29,30,112
9267,United States-1,2000.0,130,61,51,242
9268,United States,1984.0,190,121,50,361
9269,United States,1920.0,111,45,38,194
9270,United States,1920.0,111,45,38,194
9271,United States,1920.0,111,45,38,194
9272,United States,2006.0,9,11,32,52
9273,United States,1928.0,53,30,19,102
9274,United States,1960.0,100,27,25,152
9275,United States,2000.0,130,61,51,242
9276,United States,1960.0,100,27,25,152
9277,United States,1932.0,91,68,64,223
9278,United States,1924.0,98,46,50,194
9279,United States,1976.0,73,61,41,175
9280,United States,1976.0,73,61,41,175
9281,United States,1976.0,73,61,41,175
9282,United States,1976.0,73,61,41,175
9283,United States,1988.0,89,67,58,214
9284,United States,1992.0,94,57,87,238
9285,United States,1988.0,89,67,58,214
9286,United States,1984.0,190,121,50,361
9287,United States,1924.0,98,46,50,194
9288,United States,1924.0,98,46,50,194
9289,United States,1996.0,159,48,52,259
9290,United States,2000.0,130,61,51,242
9291,United States,1906.0,12,6,6,24
9292,United States,1908.0,34,16,15,65
9293,United States,1912.0,46,25,36,107
9294,United States,1920.0,111,45,38,194
9295,United States,1920.0,111,45,38,194
9296,United States,1952.0,87,48,29,164
9297,United States,1932.0,91,68,64,223
9298,United States,1924.0,98,46,50,194
9299,United States,2012.0,145,57,46,248
9300,United States,1960.0,100,27,25,152
9301,United States,2004.0,117,75,71,263
9302,United States,2008.0,127,110,80,317
9303,United States,1932.0,91,68,64,223
9304,United States,1928.0,53,30,19,102
9305,United States,1984.0,190,121,50,361
9306,United States,1996.0,159,48,52,259
9307,United States,2000.0,130,61,51,242
9308,United States,1948.0,93,34,41,168
9309,United States,1948.0,93,34,41,168
9310,United States,2008.0,127,110,80,317
9311,United States,1960.0,100,27,25,152
9312,United States,1964.0,96,39,42,177
9313,United States,1968.0,100,37,36,173
9314,United States,1984.0,190,121,50,361
9315,United States,1960.0,100,27,25,152
9316,United States,1996.0,159,48,52,259
9317,United States,1996.0,159,48,52,259
9318,United States,1976.0,73,61,41,175
9319,United States,1976.0,73,61,41,175
9320,United States,1972.0,72,77,46,195
9321,United States,2012.0,145,57,46,248
9322,United States,2012.0,145,57,46,248
9323,United States,2016.0,139,54,71,264
9324,United States,2016.0,139,54,71,264
9325,United States,1992.0,94,57,87,238
9326,United States,1948.0,93,34,41,168
9327,United States,1956.0,63,61,25,149
9328,United States,1988.0,89,67,58,214
9329,United States,1984.0,190,121,50,361
9330,United States,2016.0,139,54,71,264
9331,United States,2016.0,139,54,71,264
9332,United States,2016.0,139,54,71,264
9333,United States,2014.0,10,30,24,64
9334,United States,2008.0,127,110,80,317
9335,United States,1996.0,159,48,52,259
9336,United States,2004.0,117,75,71,263
9337,United States,2008.0,127,110,80,317
9338,United States,2012.0,145,57,46,248
9339,United States,1956.0,63,61,25,149
9340,United States,2008.0,127,110,80,317
9341,United States,1988.0,89,67,58,214
9342,United States,1924.0,98,46,50,194
9343,United States,2014.0,10,30,24,64
9344,United States,1920.0,111,45,38,194
9345,United States,1920.0,111,45,38,194
9346,United States,1952.0,87,48,29,164
9347,United States,1960.0,100,27,25,152
9348,United States,1964.0,96,39,42,177
9349,United States,1972.0,72,77,46,195
9350,United States,1920.0,111,45,38,194
9351,United States,1904.0,128,141,125,394
9352,United States,1992.0,94,57,87,238
9353,St. Rose-2,1904.0,128,141,125,394
9354,United States,1960.0,100,27,25,152
9355,United States,1964.0,96,39,42,177
9356,United States,1948.0,93,34,41,168
9357,United States,2000.0,130,61,51,242
9358,United States,1996.0,159,48,52,259
9359,New York Athletic Club-1,1904.0,128,141,125,394
9360,St. Louis Southwest Turnverein #1-2,1904.0,128,141,125,394
9361,United States,1900.0,30,16,17,63
9362,United States,1920.0,111,45,38,194
9363,United States,1992.0,94,57,87,238
9364,United States,2008.0,127,110,80,317
9365,United States,1956.0,63,61,25,149
9366,United States,1956.0,63,61,25,149
9367,United States,1956.0,63,61,25,149
9368,United States,1960.0,100,27,25,152
9369,United States,1964.0,96,39,42,177
9370,United States,1904.0,128,141,125,394
9371,United States,1984.0,190,121,50,361
9372,United States,2004.0,117,75,71,263
9373,United States,2004.0,117,75,71,263
9374,United States,1972.0,72,77,46,195
9375,United States,1932.0,91,68,64,223
9376,United States,1956.0,63,61,25,149
9377,United States,1924.0,98,46,50,194
9378,United States,1992.0,94,57,87,238
9379,United States,1964.0,96,39,42,177
9380,United States,1936.0,53,29,30,112
9381,United States,1996.0,159,48,52,259
9382,United States,1912.0,46,25,36,107
9383,United States,1928.0,53,30,19,102
9384,United States,1984.0,190,121,50,361
9385,United States,1984.0,190,121,50,361
9386,United States,1984.0,190,121,50,361
9387,United States,1988.0,89,67,58,214
9388,Christian Brothers' College-1,1904.0,128,141,125,394
9389,United States,1928.0,53,30,19,102
9390,United States,2016.0,139,54,71,264
9391,Christian Brothers' College-1,1904.0,128,141,125,394
9392,United States,1976.0,73,61,41,175
9393,United States,2000.0,130,61,51,242
9394,United States,1924.0,98,46,50,194
9395,United States,2008.0,127,110,80,317
9396,United States,1952.0,87,48,29,164
9397,United States,1980.0,24,4,2,30
9398,United States,1984.0,190,121,50,361
9399,United States,1984.0,190,121,50,361
9400,United States,1988.0,89,67,58,214
9401,United States,1976.0,73,61,41,175
9402,United States,1976.0,73,61,41,175
9403,United States,1972.0,72,77,46,195
9404,United States,1904.0,128,141,125,394
9405,United States,1964.0,96,39,42,177
9406,United States,1988.0,89,67,58,214
9407,United States,1948.0,93,34,41,168
9408,United States,2010.0,12,63,22,97
9409,United States,1960.0,100,27,25,152
9410,United States,1920.0,111,45,38,194
9411,United States-1,1936.0,53,29,30,112
9412,United States,2014.0,10,30,24,64
9413,United States,1984.0,190,121,50,361
9414,United States,1964.0,96,39,42,177
9415,United States,1924.0,98,46,50,194
9416,United States,2008.0,127,110,80,317
9417,United States,1984.0,190,121,50,361
9418,United States,1920.0,111,45,38,194
9419,United States,1920.0,111,45,38,194
9420,United States,1998.0,25,4,5,34
9421,United States,2008.0,127,110,80,317
9422,United States,1952.0,87,48,29,164
9423,United States,1972.0,72,77,46,195
9424,United States,1972.0,72,77,46,195
9425,United States,1992.0,94,57,87,238
9426,United States,2000.0,130,61,51,242
9427,United States,1976.0,73,61,41,175
9428,United States,1976.0,73,61,41,175
9429,United States-1,2008.0,127,110,80,317
9430,United States-1,2012.0,145,57,46,248
9431,United States-1,2008.0,127,110,80,317
9432,United States-1,2012.0,145,57,46,248
9433,United States-1,2012.0,145,57,46,248
9434,United States,2012.0,145,57,46,248
9435,United States,2008.0,127,110,80,317
9436,United States,2012.0,145,57,46,248
9437,United States-2,1932.0,91,68,64,223
9438,United States,1904.0,128,141,125,394
9439,United States,1904.0,128,141,125,394
9440,Boston Archers,1904.0,128,141,125,394
9441,United States,1976.0,73,61,41,175
9442,Boston Archers,1904.0,128,141,125,394
9443,United States,1984.0,190,121,50,361
9444,United States,1984.0,190,121,50,361
9445,United States,1984.0,190,121,50,361
9446,United States,1988.0,89,67,58,214
9447,United States,1968.0,100,37,36,173
9448,United States,1976.0,73,61,41,175
9449,United States,1964.0,96,39,42,177
9450,United States,2008.0,127,110,80,317
9451,United States,2012.0,145,57,46,248
9452,Western Rowing Club-3,1904.0,128,141,125,394
9453,United States,1996.0,159,48,52,259
9454,United States,1984.0,190,121,50,361
9455,United States,1988.0,89,67,58,214
9456,United States,1988.0,89,67,58,214
9457,United States,1992.0,94,57,87,238
9458,United States,2008.0,127,110,80,317
9459,United States,1988.0,89,67,58,214
9460,United States,1992.0,94,57,87,238
9461,United States,1912.0,46,25,36,107
9462,United States,1992.0,94,57,87,238
9463,United States,1984.0,190,121,50,361
9464,United States,1960.0,100,27,25,152
9465,United States,1960.0,100,27,25,152
9466,United States,1904.0,128,141,125,394
9467,United States,1896.0,11,7,2,20
9468,United States,1896.0,11,7,2,20
9469,United States,1972.0,72,77,46,195
9470,Angelita,1932.0,91,68,64,223
9471,United States,1992.0,94,57,87,238
9472,United States,2004.0,117,75,71,263
9473,United States,1996.0,159,48,52,259
9474,United States,1984.0,190,121,50,361
9475,United States,1996.0,159,48,52,259
9476,United States,1992.0,94,57,87,238
9477,United States,2012.0,145,57,46,248
9478,United States,2000.0,130,61,51,242
9479,United States,1956.0,63,61,25,149
9480,United States,1968.0,100,37,36,173
9481,United States,1968.0,100,37,36,173
9482,United States,1972.0,72,77,46,195
9483,United States,1972.0,72,77,46,195
9484,United States,1964.0,96,39,42,177
9485,United States,2000.0,130,61,51,242
9486,United States,2004.0,117,75,71,263
9487,United States,2008.0,127,110,80,317
9488,United States,2016.0,139,54,71,264
9489,United States,1924.0,98,46,50,194
9490,United States,1948.0,93,34,41,168
9491,United States-1,1956.0,63,61,25,149
9492,United States,1948.0,93,34,41,168
9493,United States,1952.0,87,48,29,164
9494,United States,1976.0,73,61,41,175
9495,United States,1998.0,25,4,5,34
9496,United States,2002.0,11,58,15,84
9497,United States,1992.0,94,57,87,238
9498,United States,1912.0,46,25,36,107
9499,United States Golf Association-3,1904.0,128,141,125,394
9500,Trans-Mississippi Golf Association-2,1904.0,128,141,125,394
9501,United States,2008.0,127,110,80,317
9502,United States,2012.0,145,57,46,248
9503,United States,1936.0,53,29,30,112
9504,United States,2008.0,127,110,80,317
9505,United States,2006.0,9,11,32,52
9506,United States,2010.0,12,63,22,97
9507,United States,1956.0,63,61,25,149
9508,United States,1928.0,53,30,19,102
9509,United States,1964.0,96,39,42,177
9510,United States,1956.0,63,61,25,149
9511,United States,1960.0,100,27,25,152
9512,United States,1908.0,34,16,15,65
9513,United States,2010.0,12,63,22,97
9514,United States,1928.0,53,30,19,102
9515,United States,1932.0,91,68,64,223
9516,United States,1932.0,91,68,64,223
9517,United States,2010.0,12,63,22,97
9518,United States,1992.0,94,57,87,238
9519,United States,1956.0,63,61,25,149
9520,United States,1988.0,89,67,58,214
9521,United States,1984.0,190,121,50,361
9522,United States,1988.0,89,67,58,214
9523,United States,1952.0,87,48,29,164
9524,United States,1956.0,63,61,25,149
9525,United States,1984.0,190,121,50,361
9526,United States,1988.0,89,67,58,214
9527,United States,1988.0,89,67,58,214
9528,United States,2008.0,127,110,80,317
9529,United States,1992.0,94,57,87,238
9530,United States,1988.0,89,67,58,214
9531,United States,2008.0,127,110,80,317
9532,United States,1932.0,91,68,64,223
9533,Angelita,1932.0,91,68,64,223
9534,United States,1984.0,190,121,50,361
9535,United States,1984.0,190,121,50,361
9536,United States,1984.0,190,121,50,361
9537,United States Golf Association-3,1904.0,128,141,125,394
9538,United States,1984.0,190,121,50,361
9539,United States,1968.0,100,37,36,173
9540,Gallant,1932.0,91,68,64,223
9541,United States,1984.0,190,121,50,361
9542,United States,1996.0,159,48,52,259
9543,United States,1932.0,91,68,64,223
9544,United States,1992.0,94,57,87,238
9545,United States,1964.0,96,39,42,177
9546,United States,1960.0,100,27,25,152
9547,United States,2014.0,10,30,24,64
9548,United States,1948.0,93,34,41,168
9549,United States,1936.0,53,29,30,112
9550,United States,2002.0,11,58,15,84
9551,United States,1924.0,98,46,50,194
9552,United States,1984.0,190,121,50,361
9553,United States,1932.0,91,68,64,223
9554,United States,1932.0,91,68,64,223
9555,Vesper Boat Club,1900.0,30,16,17,63
9556,United States,1972.0,72,77,46,195
9557,United States,1972.0,72,77,46,195
9558,United States,1964.0,96,39,42,177
9559,United States,1964.0,96,39,42,177
9560,United States,1976.0,73,61,41,175
9561,United States,1988.0,89,67,58,214
9562,United States,1928.0,53,30,19,102
9563,United States,1972.0,72,77,46,195
9564,United States,1920.0,111,45,38,194
9565,United States-2,1948.0,93,34,41,168
9566,United States-1,1984.0,190,121,50,361
9567,United States-1,1984.0,190,121,50,361
9568,United States,1948.0,93,34,41,168
9569,United States,2016.0,139,54,71,264
9570,United States,1984.0,190,121,50,361
9571,United States,2000.0,130,61,51,242
9572,United States,1904.0,128,141,125,394
9573,United States,1904.0,128,141,125,394
9574,United States,1908.0,34,16,15,65
9575,United States,1908.0,34,16,15,65
9576,United States,1948.0,93,34,41,168
9577,United States,1968.0,100,37,36,173
9578,United States,2000.0,130,61,51,242
9579,United States,1908.0,34,16,15,65
9580,United States,1908.0,34,16,15,65
9581,United States,1928.0,53,30,19,102
9582,United States,2004.0,117,75,71,263
9583,United States,2012.0,145,57,46,248
9584,United States,1994.0,6,8,5,19
9585,United States,1964.0,96,39,42,177
9586,United States,2014.0,10,30,24,64
9587,United States,1904.0,128,141,125,394
9588,United States,2016.0,139,54,71,264
9589,United States,2004.0,117,75,71,263
9590,United States,2008.0,127,110,80,317
9591,United States,2012.0,145,57,46,248
9592,United States,2016.0,139,54,71,264
9593,United States,2016.0,139,54,71,264
9594,United States,1984.0,190,121,50,361
9595,United States,1984.0,190,121,50,361
9596,United States,1984.0,190,121,50,361
9597,United States,1996.0,159,48,52,259
9598,United States,1984.0,190,121,50,361
9599,United States,1964.0,96,39,42,177
9600,United States,1952.0,87,48,29,164
9601,United States,2008.0,127,110,80,317
9602,United States,2010.0,12,63,22,97
9603,United States,2010.0,12,63,22,97
9604,United States,2014.0,10,30,24,64
9605,United States,2016.0,139,54,71,264
9606,United States,1988.0,89,67,58,214
9607,United States,1948.0,93,34,41,168
9608,United States,2008.0,127,110,80,317
9609,United States,1932.0,91,68,64,223
9610,United States,1932.0,91,68,64,223
9611,United States,2016.0,139,54,71,264
9612,Complex II,1952.0,87,48,29,164
9613,United States,1932.0,91,68,64,223
9614,United States,1976.0,73,61,41,175
9615,United States,2012.0,145,57,46,248
9616,United States,1960.0,100,27,25,152
9617,United States,1972.0,72,77,46,195
9618,United States,1992.0,94,57,87,238
9619,United States,2012.0,145,57,46,248
9620,United States,2016.0,139,54,71,264
9621,United States,1956.0,63,61,25,149
9622,United States,1932.0,91,68,64,223
9623,United States,1996.0,159,48,52,259
9624,United States,2000.0,130,61,51,242
9625,United States,2004.0,117,75,71,263
9626,United States,2002.0,11,58,15,84
9627,United States,2006.0,9,11,32,52
9628,United States,2006.0,9,11,32,52
9629,United States,1984.0,190,121,50,361
9630,United States,1984.0,190,121,50,361
9631,United States,1984.0,190,121,50,361
9632,United States,1984.0,190,121,50,361
9633,United States,2016.0,139,54,71,264
9634,United States,2002.0,11,58,15,84
9635,United States,2008.0,127,110,80,317
9636,United States,2012.0,145,57,46,248
9637,United States,2010.0,12,63,22,97
9638,United States,2004.0,117,75,71,263
9639,United States,1912.0,46,25,36,107
9640,United States,1984.0,190,121,50,361
9641,United States,1992.0,94,57,87,238
9642,United States,1996.0,159,48,52,259
9643,United States,2010.0,12,63,22,97
9644,United States,1996.0,159,48,52,259
9645,United States,1996.0,159,48,52,259
9646,United States,2000.0,130,61,51,242
9647,United States,2014.0,10,30,24,64
9648,United States,2016.0,139,54,71,264
9649,United States,1960.0,100,27,25,152
9650,United States,1980.0,24,4,2,30
9651,United States,1956.0,63,61,25,149
9652,United States,1960.0,100,27,25,152
9653,United States,1972.0,72,77,46,195
9654,United States,1980.0,24,4,2,30
9655,United States,2002.0,11,58,15,84
9656,United States,2006.0,9,11,32,52
9657,United States,2010.0,12,63,22,97
9658,United States,2014.0,10,30,24,64
9659,United States,2012.0,145,57,46,248
9660,Angelita,1932.0,91,68,64,223
9661,United States,2004.0,117,75,71,263
9662,United States,1928.0,53,30,19,102
9663,United States,1932.0,91,68,64,223
9664,United States,1972.0,72,77,46,195
9665,United States,1984.0,190,121,50,361
9666,United States,1904.0,128,141,125,394
9667,United States,1936.0,53,29,30,112
9668,United States,1984.0,190,121,50,361
9669,United States,1896.0,11,7,2,20
9670,United States,1896.0,11,7,2,20
9671,United States,1964.0,96,39,42,177
9672,United States,1920.0,111,45,38,194
9673,United States,2002.0,11,58,15,84
9674,United States,2010.0,12,63,22,97
9675,United States,2014.0,10,30,24,64
9676,United States,2016.0,139,54,71,264
9677,United States,1992.0,94,57,87,238
9678,United States,1996.0,159,48,52,259
9679,United States,1924.0,98,46,50,194
9680,United States,1920.0,111,45,38,194
9681,United States,1920.0,111,45,38,194
9682,United States,1960.0,100,27,25,152
9683,United States,1960.0,100,27,25,152
9684,United States,1964.0,96,39,42,177
9685,United States,1964.0,96,39,42,177
9686,United States,1964.0,96,39,42,177
9687,Cincinnati Archers,1904.0,128,141,125,394
9688,United States,1924.0,98,46,50,194
9689,United States,2012.0,145,57,46,248
9690,United States,1968.0,100,37,36,173
9691,United States,2004.0,117,75,71,263
9692,United States,2008.0,127,110,80,317
9693,United States,1960.0,100,27,25,152
9694,United States,2012.0,145,57,46,248
9695,United States,2012.0,145,57,46,248
9696,United States,2016.0,139,54,71,264
9697,United States,1960.0,100,27,25,152
9698,United States,1956.0,63,61,25,149
9699,United States,1960.0,100,27,25,152
9700,United States,1924.0,98,46,50,194
9701,United States,1996.0,159,48,52,259
9702,United States,2008.0,127,110,80,317
9703,United States,2008.0,127,110,80,317
9704,United States,2016.0,139,54,71,264
9705,United States,2016.0,139,54,71,264
9706,United States,1952.0,87,48,29,164
9707,United States,1956.0,63,61,25,149
9708,United States,1908.0,34,16,15,65
9709,United States,1948.0,93,34,41,168
9710,United States,1976.0,73,61,41,175
9711,United States,1992.0,94,57,87,238
9712,United States,2016.0,139,54,71,264
9713,United States,1972.0,72,77,46,195
9714,United States,1924.0,98,46,50,194
9715,United States,1960.0,100,27,25,152
9716,United States,1948.0,93,34,41,168
9717,United States,1948.0,93,34,41,168
9718,United States,1904.0,128,141,125,394
9719,United States,1976.0,73,61,41,175
9720,United States,1932.0,91,68,64,223
9721,United States,1976.0,73,61,41,175
9722,United States,1976.0,73,61,41,175
9723,United States,2008.0,127,110,80,317
9724,United States,2016.0,139,54,71,264
9725,United States,1972.0,72,77,46,195
9726,United States,2006.0,9,11,32,52
9727,United States,1984.0,190,121,50,361
9728,United States,1984.0,190,121,50,361
9729,United States,1908.0,34,16,15,65
9730,United States,1948.0,93,34,41,168
9731,United States,2000.0,130,61,51,242
9732,United States,2012.0,145,57,46,248
9733,United States,1952.0,87,48,29,164
9734,United States,1972.0,72,77,46,195
9735,United States,1972.0,72,77,46,195
9736,United States,1976.0,73,61,41,175
9737,United States,1928.0,53,30,19,102
9738,United States,1928.0,53,30,19,102
9739,United States,1932.0,91,68,64,223
9740,United States,1932.0,91,68,64,223
9741,United States,1988.0,89,67,58,214
9742,United States-2,1936.0,53,29,30,112
9743,United States,1900.0,30,16,17,63
9744,United States,1972.0,72,77,46,195
9745,United States,1964.0,96,39,42,177
9746,United States,1928.0,53,30,19,102
9747,United States,2000.0,130,61,51,242
9748,United States,1996.0,159,48,52,259
9749,United States,1972.0,72,77,46,195
9750,Gallant,1932.0,91,68,64,223
9751,United States,1956.0,63,61,25,149
9752,United States,1972.0,72,77,46,195
9753,United States,1972.0,72,77,46,195
9754,United States,2016.0,139,54,71,264
9755,United States,1984.0,190,121,50,361
9756,United States,1992.0,94,57,87,238
9757,United States,1984.0,190,121,50,361
9758,United States,1984.0,190,121,50,361
9759,United States,1976.0,73,61,41,175
9760,United States,1956.0,63,61,25,149
9761,United States,1924.0,98,46,50,194
9762,United States,1896.0,11,7,2,20
9763,United States,1896.0,11,7,2,20
9764,United States,1896.0,11,7,2,20
9765,United States,1900.0,30,16,17,63
9766,United States,1932.0,91,68,64,223
9767,United States,1956.0,63,61,25,149
9768,United States,1920.0,111,45,38,194
9769,United States,1988.0,89,67,58,214
9770,United States,1992.0,94,57,87,238
9771,United States,1948.0,93,34,41,168
9772,United States,1908.0,34,16,15,65
9773,United States,1904.0,128,141,125,394
9774,United States,1904.0,128,141,125,394
9775,St. Rose-2,1904.0,128,141,125,394
9776,United States,1956.0,63,61,25,149
9777,St. Rose-2,1904.0,128,141,125,394
9778,United States,1932.0,91,68,64,223
9779,Angelita,1932.0,91,68,64,223
9780,United States,1984.0,190,121,50,361
9781,United States,1988.0,89,67,58,214
9782,United States,1992.0,94,57,87,238
9783,United States,2004.0,117,75,71,263
9784,United States,1928.0,53,30,19,102
9785,United States,1932.0,91,68,64,223
9786,United States,2008.0,127,110,80,317
9787,United States,2016.0,139,54,71,264
9788,United States,1996.0,159,48,52,259
9789,United States,2000.0,130,61,51,242
9790,United States,2004.0,117,75,71,263
9791,United States,1948.0,93,34,41,168
9792,United States,1972.0,72,77,46,195
9793,United States,1928.0,53,30,19,102
9794,St. Rose-2,1904.0,128,141,125,394
9795,United States,1956.0,63,61,25,149
9796,United States,1920.0,111,45,38,194
9797,United States,1924.0,98,46,50,194
9798,United States,1928.0,53,30,19,102
9799,United States,1984.0,190,121,50,361
9800,United States,2000.0,130,61,51,242
9801,United States,2004.0,117,75,71,263
9802,United States,2004.0,117,75,71,263
9803,United States,2004.0,117,75,71,263
9804,United States,2004.0,117,75,71,263
9805,United States,2004.0,117,75,71,263
9806,United States,2008.0,127,110,80,317
9807,United States,2008.0,127,110,80,317
9808,United States,2008.0,127,110,80,317
9809,United States,2008.0,127,110,80,317
9810,United States,2008.0,127,110,80,317
9811,United States,2008.0,127,110,80,317
9812,United States,2012.0,145,57,46,248
9813,United States,1924.0,98,46,50,194
9814,United States,1924.0,98,46,50,194
9815,United States,1964.0,96,39,42,177
9816,United States,1956.0,63,61,25,149
9817,United States,1956.0,63,61,25,149
9818,United States,2016.0,139,54,71,264
9819,United States,1948.0,93,34,41,168
9820,United States,2004.0,117,75,71,263
9821,United States,1924.0,98,46,50,194
9822,United States,2016.0,139,54,71,264
9823,United States,2008.0,127,110,80,317
9824,United States,1994.0,6,8,5,19
9825,United States,1998.0,25,4,5,34
9826,United States,2014.0,10,30,24,64
9827,United States,1928.0,53,30,19,102
9828,United States,1932.0,91,68,64,223
9829,United States,1964.0,96,39,42,177
9830,United States,1980.0,24,4,2,30
9831,United States,2008.0,127,110,80,317
9832,United States,2012.0,145,57,46,248
9833,United States,2016.0,139,54,71,264
9834,United States,1912.0,46,25,36,107
9835,United States,1912.0,46,25,36,107
9836,United States,2004.0,117,75,71,263
9837,United States,2004.0,117,75,71,263
9838,United States,2008.0,127,110,80,317
9839,United States,1996.0,159,48,52,259
9840,United States,2000.0,130,61,51,242
9841,United States,1900.0,30,16,17,63
9842,Vesper Boat Club,1904.0,128,141,125,394
9843,United States,2014.0,10,30,24,64
9844,United States,1932.0,91,68,64,223
9845,United States,2000.0,130,61,51,242
9846,United States,2004.0,117,75,71,263
9847,United States,2004.0,117,75,71,263
9848,United States,2004.0,117,75,71,263
9849,United States,2008.0,127,110,80,317
9850,United States,1924.0,98,46,50,194
9851,United States,1984.0,190,121,50,361
9852,United States,1964.0,96,39,42,177
9853,United States,1906.0,12,6,6,24
9854,United States,1960.0,100,27,25,152
9855,United States,1932.0,91,68,64,223
9856,United States,2008.0,127,110,80,317
9857,United States,1928.0,53,30,19,102
9858,United States,1996.0,159,48,52,259
9859,United States,1992.0,94,57,87,238
9860,United States-1,1952.0,87,48,29,164
9861,United States,2016.0,139,54,71,264
9862,United States,2004.0,117,75,71,263
9863,United States,1988.0,89,67,58,214
9864,United States,1992.0,94,57,87,238
9865,Christian Brothers' College-1,1904.0,128,141,125,394
9866,United States,1928.0,53,30,19,102
9867,United States,1956.0,63,61,25,149
9868,United States,1932.0,91,68,64,223
9869,United States,2008.0,127,110,80,317
9870,Western Golf Association-1,1904.0,128,141,125,394
9871,United States,1936.0,53,29,30,112
9872,United States,1972.0,72,77,46,195
9873,United States,1904.0,128,141,125,394
9874,United States,1984.0,190,121,50,361
9875,United States,1948.0,93,34,41,168
9876,United States,1948.0,93,34,41,168
9877,United States,1948.0,93,34,41,168
9878,United States,1896.0,11,7,2,20
9879,United States,1960.0,100,27,25,152
9880,United States,1964.0,96,39,42,177
9881,United States,1952.0,87,48,29,164
9882,United States-2,1948.0,93,34,41,168
9883,United States,1984.0,190,121,50,361
9884,United States,1984.0,190,121,50,361
9885,United States,1988.0,89,67,58,214
9886,United States,1988.0,89,67,58,214
9887,United States,1928.0,53,30,19,102
9888,United States-1,2008.0,127,110,80,317
9889,Boston Archers,1904.0,128,141,125,394
9890,United States,1928.0,53,30,19,102
9891,United States,1948.0,93,34,41,168
9892,United States,1968.0,100,37,36,173
9893,United States,1968.0,100,37,36,173
9894,United States,1968.0,100,37,36,173
9895,United States,1972.0,72,77,46,195
9896,United States,1904.0,128,141,125,394
9897,United States,1904.0,128,141,125,394
9898,United States,1904.0,128,141,125,394
9899,United States,1904.0,128,141,125,394
9900,New York Athletic Club #1-1,1904.0,128,141,125,394
9901,United States,1906.0,12,6,6,24
9902,United States,1908.0,34,16,15,65
9903,United States,1908.0,34,16,15,65
9904,United States,1956.0,63,61,25,149
9905,United States,1956.0,63,61,25,149
9906,United States,1960.0,100,27,25,152
9907,United States,1960.0,100,27,25,152
9908,United States,1976.0,73,61,41,175
9909,United States,2000.0,130,61,51,242
9910,United States,1956.0,63,61,25,149
9911,United States,1984.0,190,121,50,361
9912,United States,1960.0,100,27,25,152
9913,United States,2002.0,11,58,15,84
9914,United States,2006.0,9,11,32,52
9915,United States,2010.0,12,63,22,97
9916,United States,1932.0,91,68,64,223
9917,United States,1912.0,46,25,36,107
9918,United States,1996.0,159,48,52,259
9919,United States,1968.0,100,37,36,173
9920,United States,1976.0,73,61,41,175
9921,United States,1972.0,72,77,46,195
9922,United States,1976.0,73,61,41,175
9923,United States,1984.0,190,121,50,361
9924,United States,1996.0,159,48,52,259
9925,United States,2004.0,117,75,71,263
9926,United States,2008.0,127,110,80,317
9927,United States,2012.0,145,57,46,248
9928,United States,1964.0,96,39,42,177
9929,United States,2012.0,145,57,46,248
9930,United States,1984.0,190,121,50,361
9931,United States,1952.0,87,48,29,164
9932,United States,1996.0,159,48,52,259
9933,United States,1992.0,94,57,87,238
9934,United States,1976.0,73,61,41,175
9935,United States,1956.0,63,61,25,149
9936,United States,1960.0,100,27,25,152
9937,United States,1960.0,100,27,25,152
9938,United States,1952.0,87,48,29,164
9939,United States,1956.0,63,61,25,149
9940,United States,1948.0,93,34,41,168
9941,United States,1952.0,87,48,29,164
9942,United States,1996.0,159,48,52,259
9943,United States,1996.0,159,48,52,259
9944,United States,1996.0,159,48,52,259
9945,United States,2000.0,130,61,51,242
9946,United States,2000.0,130,61,51,242
9947,United States,1972.0,72,77,46,195
9948,United States,2016.0,139,54,71,264
9949,United States-1,2010.0,12,63,22,97
9950,United States-1,2014.0,10,30,24,64
9951,United States,2014.0,10,30,24,64
9952,United States,2008.0,127,110,80,317
9953,United States,2012.0,145,57,46,248
9954,United States,1960.0,100,27,25,152
9955,United States,1960.0,100,27,25,152
9956,Angelita,1932.0,91,68,64,223
9957,United States,1984.0,190,121,50,361
9958,United States,2006.0,9,11,32,52
9959,United States,2006.0,9,11,32,52
9960,United States,2010.0,12,63,22,97
9961,United States,2010.0,12,63,22,97
9962,United States,1976.0,73,61,41,175
9963,United States,1976.0,73,61,41,175
9964,United States,1992.0,94,57,87,238
9965,United States,1996.0,159,48,52,259
9966,United States,1996.0,159,48,52,259
9967,United States,2000.0,130,61,51,242
9968,United States,2000.0,130,61,51,242
9969,United States,2006.0,9,11,32,52
9970,United States,1936.0,53,29,30,112
9971,United States,2008.0,127,110,80,317
9972,United States,1932.0,91,68,64,223
9973,United States,1948.0,93,34,41,168
9974,United States/France,1900.0,30,16,17,63
9975,United States,1992.0,94,57,87,238
9976,United States,1960.0,100,27,25,152
9977,United States,1964.0,96,39,42,177
9978,United States,1964.0,96,39,42,177
9979,United States,1932.0,91,68,64,223
9980,United States,2002.0,11,58,15,84
9981,United States,2004.0,117,75,71,263
9982,United States,1996.0,159,48,52,259
9983,United States,1972.0,72,77,46,195
9984,United States,1972.0,72,77,46,195
9985,Aphrodite,1964.0,96,39,42,177
9986,Vesper Boat Club,1900.0,30,16,17,63
9987,United States,2014.0,10,30,24,64
9988,United States,1998.0,25,4,5,34
9989,United States,2002.0,11,58,15,84
9990,United States,1968.0,100,37,36,173
9991,United States,1992.0,94,57,87,238
9992,United States,1976.0,73,61,41,175
9993,United States,1932.0,91,68,64,223
9994,United States,1936.0,53,29,30,112
9995,United States,1924.0,98,46,50,194
9996,United States,2014.0,10,30,24,64
9997,United States,1948.0,93,34,41,168
9998,United States,2012.0,145,57,46,248
9999,United States,2016.0,139,54,71,264
10000,United States,1964.0,96,39,42,177
10001,United States,1992.0,94,57,87,238
10002,United States,2012.0,145,57,46,248
10003,United States,1988.0,89,67,58,214
10004,United States,1924.0,98,46,50,194
10005,United States,1996.0,159,48,52,259
10006,United States,2004.0,117,75,71,263
10007,United States,2010.0,12,63,22,97
10008,United States,2010.0,12,63,22,97
10009,Vesper Boat Club,1904.0,128,141,125,394
10010,United States,2012.0,145,57,46,248
10011,United States,1984.0,190,121,50,361
10012,United States,1932.0,91,68,64,223
10013,United States,1948.0,93,34,41,168
10014,United States,2000.0,130,61,51,242
10015,United States,2016.0,139,54,71,264
10016,United States,2010.0,12,63,22,97
10017,United States,1992.0,94,57,87,238
10018,United States,1920.0,111,45,38,194
10019,United States,1924.0,98,46,50,194
10020,United States,1928.0,53,30,19,102
10021,United States,1928.0,53,30,19,102
10022,United States,1952.0,87,48,29,164
10023,United States,1952.0,87,48,29,164
10024,United States,1920.0,111,45,38,194
10025,United States,1924.0,98,46,50,194
10026,United States,1992.0,94,57,87,238
10027,United States,1996.0,159,48,52,259
10028,United States,1996.0,159,48,52,259
10029,United States,1928.0,53,30,19,102
10030,United States,1904.0,128,141,125,394
10031,United States,1984.0,190,121,50,361
10032,United States,1984.0,190,121,50,361
10033,United States,1904.0,128,141,125,394
10034,United States,1996.0,159,48,52,259
10035,United States,1932.0,91,68,64,223
10036,United States,1932.0,91,68,64,223
10037,United States,1932.0,91,68,64,223
10038,United States,1992.0,94,57,87,238
10039,United States,1992.0,94,57,87,238
10040,United States,1984.0,190,121,50,361
10041,St. Rose-2,1904.0,128,141,125,394
10042,Century Boat Club-1,1904.0,128,141,125,394
10043,United States,1908.0,34,16,15,65
10044,United States,1912.0,46,25,36,107
10045,United States,1948.0,93,34,41,168
10046,United States,1948.0,93,34,41,168
10047,United States,1952.0,87,48,29,164
10048,United States,1952.0,87,48,29,164
10049,United States,1964.0,96,39,42,177
10050,United States,1952.0,87,48,29,164
10051,United States,1992.0,94,57,87,238
10052,United States,2004.0,117,75,71,263
10053,United States,1924.0,98,46,50,194
10054,United States,2016.0,139,54,71,264
10055,United States,2016.0,139,54,71,264
10056,United States,2016.0,139,54,71,264
10057,United States,2016.0,139,54,71,264
10058,United States,2004.0,117,75,71,263
10059,United States,2004.0,117,75,71,263
10060,United States,1960.0,100,27,25,152
10061,United States,1960.0,100,27,25,152
10062,United States,1932.0,91,68,64,223
10063,United States,2008.0,127,110,80,317
10064,United States,2008.0,127,110,80,317
10065,United States,1948.0,93,34,41,168
10066,United States,2012.0,145,57,46,248
10067,United States,1984.0,190,121,50,361
10068,United States,1988.0,89,67,58,214
10069,United States,1924.0,98,46,50,194
10070,United States,1992.0,94,57,87,238
10071,United States,1924.0,98,46,50,194
10072,United States,2004.0,117,75,71,263
10073,United States-2,1996.0,159,48,52,259
10074,United States-1,1956.0,63,61,25,149
10075,United States,1920.0,111,45,38,194
10076,United States,1924.0,98,46,50,194
10077,United States-1,1928.0,53,30,19,102
10078,United States,1992.0,94,57,87,238
10079,United States,1960.0,100,27,25,152
10080,United States,1928.0,53,30,19,102
10081,United States,1992.0,94,57,87,238
10082,United States,1996.0,159,48,52,259
10083,United States,2000.0,130,61,51,242
10084,United States,2000.0,130,61,51,242
10085,United States,1908.0,34,16,15,65
10086,United States,1912.0,46,25,36,107
10087,United States,1912.0,46,25,36,107
10088,United States,2012.0,145,57,46,248
10089,United States,1912.0,46,25,36,107
10090,United States,2008.0,127,110,80,317
10091,United States,1992.0,94,57,87,238
10092,United States,1928.0,53,30,19,102
10093,United States,1924.0,98,46,50,194
10094,United States,1992.0,94,57,87,238
10095,United States,1984.0,190,121,50,361
10096,United States,1988.0,89,67,58,214
10097,United States,1952.0,87,48,29,164
10098,St. Rose-2,1904.0,128,141,125,394
10099,United States,2016.0,139,54,71,264
10100,Angelita,1932.0,91,68,64,223
10101,United States,1984.0,190,121,50,361
10102,United States,1956.0,63,61,25,149
10103,Gallant,1932.0,91,68,64,223
10104,United States,2012.0,145,57,46,248
10105,United States,2012.0,145,57,46,248
10106,United States,2016.0,139,54,71,264
10107,United States,1948.0,93,34,41,168
10108,United States,1992.0,94,57,87,238
10109,United States,1996.0,159,48,52,259
10110,United States,2000.0,130,61,51,242
10111,United States,2004.0,117,75,71,263
10112,St. Louis Amateur Athletic Association,1904.0,128,141,125,394
10113,United States,1904.0,128,141,125,394
10114,United States,1904.0,128,141,125,394
10115,United States,1904.0,128,141,125,394
10116,United States,1904.0,128,141,125,394
10117,United States,1904.0,128,141,125,394
10118,United States,1904.0,128,141,125,394
10119,United States,1960.0,100,27,25,152
10120,United States,2000.0,130,61,51,242
10121,United States,1936.0,53,29,30,112
10122,United States,1948.0,93,34,41,168
10123,United States,1948.0,93,34,41,168
10124,United States,1964.0,96,39,42,177
10125,United States,1964.0,96,39,42,177
10126,United States,2016.0,139,54,71,264
10127,United States,2016.0,139,54,71,264
10128,United States,1920.0,111,45,38,194
10129,United States,1992.0,94,57,87,238
10130,United States,2006.0,9,11,32,52
10131,United States,2012.0,145,57,46,248
10132,United States,1928.0,53,30,19,102
10133,United States,2004.0,117,75,71,263
10134,United States,1996.0,159,48,52,259
10135,United States,2000.0,130,61,51,242
10136,United States,2002.0,11,58,15,84
10137,United States,2010.0,12,63,22,97
10138,United States,1920.0,111,45,38,194
10139,United States,1924.0,98,46,50,194
10140,United States,1984.0,190,121,50,361
10141,United States,1964.0,96,39,42,177
10142,United States,1968.0,100,37,36,173
10143,United States,2010.0,12,63,22,97
10144,United States,1948.0,93,34,41,168
10145,United States,1964.0,96,39,42,177
10146,United States,1964.0,96,39,42,177
10147,United States,2008.0,127,110,80,317
10148,United States,1932.0,91,68,64,223
10149,United States,2010.0,12,63,22,97
10150,United States,2014.0,10,30,24,64
10151,"Central Turnverein, Chicago",1904.0,128,141,125,394
10152,United States,1904.0,128,141,125,394
10153,United States,1908.0,34,16,15,65
10154,United States,2012.0,145,57,46,248
10155,United States,1956.0,63,61,25,149
10156,Western Rowing Club-3,1904.0,128,141,125,394
10157,United States,1952.0,87,48,29,164
10158,United States,1912.0,46,25,36,107
10159,United States,2004.0,117,75,71,263
10160,United States,2002.0,11,58,15,84
10161,United States,1976.0,73,61,41,175
10162,United States,1932.0,91,68,64,223
10163,United States,1936.0,53,29,30,112
10164,United States,1998.0,25,4,5,34
10165,United States,1936.0,53,29,30,112
10166,United States,1998.0,25,4,5,34
10167,United States,2002.0,11,58,15,84
10168,United States,2006.0,9,11,32,52
10169,United States,1988.0,89,67,58,214
10170,United States-1,1948.0,93,34,41,168
10171,United States-1,1948.0,93,34,41,168
10172,United States,2008.0,127,110,80,317
10173,United States,2012.0,145,57,46,248
10174,United States,2016.0,139,54,71,264
10175,United States,1964.0,96,39,42,177
10176,United States,2000.0,130,61,51,242
10177,United States,2004.0,117,75,71,263
10178,United States,1984.0,190,121,50,361
10179,United States,2016.0,139,54,71,264
10180,Cincinnati Archers,1904.0,128,141,125,394
10181,United States,1984.0,190,121,50,361
10182,United States,1904.0,128,141,125,394
10183,United States,1984.0,190,121,50,361
10184,United States,2012.0,145,57,46,248
10185,United States,2016.0,139,54,71,264
10186,United States,2016.0,139,54,71,264
10187,United States,1932.0,91,68,64,223
10188,United States,2016.0,139,54,71,264
10189,United States,1996.0,159,48,52,259
10190,United States,1976.0,73,61,41,175
10191,United States,1920.0,111,45,38,194
10192,United States-1,1932.0,91,68,64,223
10193,United States,1932.0,91,68,64,223
10194,United States,1908.0,34,16,15,65
10195,United States,2012.0,145,57,46,248
10196,United States,2016.0,139,54,71,264
10197,United States,1920.0,111,45,38,194
10198,United States,1988.0,89,67,58,214
10199,United States,1992.0,94,57,87,238
10200,United States,1924.0,98,46,50,194
10201,United States,1924.0,98,46,50,194
10202,United States,1924.0,98,46,50,194
10203,United States,1972.0,72,77,46,195
10204,Western Golf Association-1,1904.0,128,141,125,394
10205,United States,1984.0,190,121,50,361
10206,United States,1988.0,89,67,58,214
10207,United States,1992.0,94,57,87,238
10208,United States,1996.0,159,48,52,259
10209,United States,2000.0,130,61,51,242
10210,United States,2000.0,130,61,51,242
10211,United States,1904.0,128,141,125,394
10212,Western Golf Association-1,1904.0,128,141,125,394
10213,Western Golf Association-1,1904.0,128,141,125,394
10214,United States,1908.0,34,16,15,65
10215,United States,1908.0,34,16,15,65
10216,United States,2008.0,127,110,80,317
10217,United States,1964.0,96,39,42,177
10218,United States,1964.0,96,39,42,177
10219,United States,1964.0,96,39,42,177
10220,United States,1964.0,96,39,42,177
10221,United States,1988.0,89,67,58,214
10222,United States,2016.0,139,54,71,264
10223,United States,2012.0,145,57,46,248
10224,United States,2016.0,139,54,71,264
10225,United States,2016.0,139,54,71,264
10226,United States,2016.0,139,54,71,264
10227,United States,1948.0,93,34,41,168
10228,United States,1948.0,93,34,41,168
10229,United States,1948.0,93,34,41,168
10230,United States,1984.0,190,121,50,361
10231,United States,1904.0,128,141,125,394
10232,United States,2004.0,117,75,71,263
10233,United States,2008.0,127,110,80,317
10234,United States,2012.0,145,57,46,248
10235,United States,1924.0,98,46,50,194
10236,United States,1992.0,94,57,87,238
10237,Llanoria,1952.0,87,48,29,164
10238,United States,1904.0,128,141,125,394
10239,United States,2006.0,9,11,32,52
10240,United States,2010.0,12,63,22,97
10241,United States,1984.0,190,121,50,361
10242,United States,1932.0,91,68,64,223
10243,United States,1984.0,190,121,50,361
10244,Century Boat Club-1,1904.0,128,141,125,394
10245,United States,1980.0,24,4,2,30
10246,United States,2000.0,130,61,51,242
10247,United States,2000.0,130,61,51,242
10248,United States,2016.0,139,54,71,264
10249,United States,2016.0,139,54,71,264
10250,United States,2012.0,145,57,46,248
10251,United States,1984.0,190,121,50,361
10252,United States,1956.0,63,61,25,149
10253,United States,2000.0,130,61,51,242
10254,United States,2004.0,117,75,71,263
10255,United States,1924.0,98,46,50,194
10256,United States,1988.0,89,67,58,214
10257,United States,1984.0,190,121,50,361
10258,United States-2,2014.0,10,30,24,64
10259,United States,1956.0,63,61,25,149
10260,United States,1976.0,73,61,41,175
10261,Missouri Athletic Club-3,1904.0,128,141,125,394
10262,Missouri Athletic Club-3,1904.0,128,141,125,394
10263,United States,1988.0,89,67,58,214
10264,United States,1988.0,89,67,58,214
10265,United States,1988.0,89,67,58,214
10266,United States,1992.0,94,57,87,238
10267,United States,1992.0,94,57,87,238
10268,United States,1968.0,100,37,36,173
10269,United States,1968.0,100,37,36,173
10270,United States,1988.0,89,67,58,214
10271,United States,1948.0,93,34,41,168
10272,United States,1952.0,87,48,29,164
10273,United States,2000.0,130,61,51,242
10274,United States,1988.0,89,67,58,214
10275,United States,1988.0,89,67,58,214
10276,United States,1932.0,91,68,64,223
10277,United States,1932.0,91,68,64,223
10278,United States,1948.0,93,34,41,168
10279,United States,1948.0,93,34,41,168
10280,United States,1948.0,93,34,41,168
10281,United States,1984.0,190,121,50,361
10282,United States,1992.0,94,57,87,238
10283,United States,1932.0,91,68,64,223
10284,United States,1900.0,30,16,17,63
10285,United States,1900.0,30,16,17,63
10286,United States,1900.0,30,16,17,63
10287,United States,1904.0,128,141,125,394
10288,United States,1904.0,128,141,125,394
10289,United States,1904.0,128,141,125,394
10290,United States,1906.0,12,6,6,24
10291,United States,1906.0,12,6,6,24
10292,United States,1908.0,34,16,15,65
10293,United States,1908.0,34,16,15,65
10294,Vesper Boat Club,1900.0,30,16,17,63
10295,Vesper Boat Club,1904.0,128,141,125,394
10296,United States,1904.0,128,141,125,394
10297,United States,1904.0,128,141,125,394
10298,United States,1904.0,128,141,125,394
10299,United States,1904.0,128,141,125,394
10300,United States,1904.0,128,141,125,394
10301,United States,1904.0,128,141,125,394
10302,United States,1924.0,98,46,50,194
10303,United States,1952.0,87,48,29,164
10304,United States,1956.0,63,61,25,149
10305,United States,2000.0,130,61,51,242
10306,United States,1972.0,72,77,46,195
10307,United States,1972.0,72,77,46,195
10308,United States,1924.0,98,46,50,194
10309,United States,1984.0,190,121,50,361
10310,United States,1984.0,190,121,50,361
10311,United States,1988.0,89,67,58,214
10312,United States,1924.0,98,46,50,194
10313,United States,1992.0,94,57,87,238
10314,Seawanhaka Boat Club-1,1904.0,128,141,125,394
10315,United States,1932.0,91,68,64,223
10316,United States,1960.0,100,27,25,152
10317,United States,1960.0,100,27,25,152
10318,United States,1928.0,53,30,19,102
10319,United States,1968.0,100,37,36,173
10320,United States,2014.0,10,30,24,64
10321,United States,2016.0,139,54,71,264
10322,United States,2016.0,139,54,71,264
10323,United States,1932.0,91,68,64,223
10324,United States,1996.0,159,48,52,259
10325,United States,2000.0,130,61,51,242
10326,United States,2004.0,117,75,71,263
10327,United States,1932.0,91,68,64,223
10328,United States,1920.0,111,45,38,194
10329,United States,1920.0,111,45,38,194
10330,United States,1924.0,98,46,50,194
10331,United States,1992.0,94,57,87,238
10332,United States,2012.0,145,57,46,248
10333,United States,2016.0,139,54,71,264
10334,United States,2004.0,117,75,71,263
10335,United States,2008.0,127,110,80,317
10336,United States,2008.0,127,110,80,317
10337,United States,2012.0,145,57,46,248
10338,United States,2012.0,145,57,46,248
10339,United States,2012.0,145,57,46,248
10340,United States,2016.0,139,54,71,264
10341,United States,2016.0,139,54,71,264
10342,United States,2016.0,139,54,71,264
10343,United States,2006.0,9,11,32,52
10344,United States,1920.0,111,45,38,194
10345,United States,1920.0,111,45,38,194
10346,United States,1920.0,111,45,38,194
10347,United States,1920.0,111,45,38,194
10348,United States,1924.0,98,46,50,194
10349,United States,1972.0,72,77,46,195
10350,United States,1964.0,96,39,42,177
10351,United States,1964.0,96,39,42,177
10352,United States,1972.0,72,77,46,195
10353,United States,1992.0,94,57,87,238
10354,United States,1996.0,159,48,52,259
10355,United States,1996.0,159,48,52,259
10356,United States,2000.0,130,61,51,242
10357,United States,2004.0,117,75,71,263
10358,United States,1992.0,94,57,87,238
10359,United States,1992.0,94,57,87,238
10360,United States,1996.0,159,48,52,259
10361,United States,1968.0,100,37,36,173
10362,United States,1968.0,100,37,36,173
10363,United States,1968.0,100,37,36,173
10364,United States,1968.0,100,37,36,173
10365,United States,1964.0,96,39,42,177
10366,United States,1904.0,128,141,125,394
10367,United States,1952.0,87,48,29,164
10368,United States,2016.0,139,54,71,264
10369,United States,1924.0,98,46,50,194
10370,United States,1956.0,63,61,25,149
10371,United States,1984.0,190,121,50,361
10372,United States,2004.0,117,75,71,263
10373,United States,2008.0,127,110,80,317
10374,United States,1956.0,63,61,25,149
10375,United States,1960.0,100,27,25,152
10376,United States,1964.0,96,39,42,177
10377,United States,1976.0,73,61,41,175
10378,United States,1932.0,91,68,64,223
10379,United States,1992.0,94,57,87,238
10380,United States,1904.0,128,141,125,394
10381,United States,1904.0,128,141,125,394
10382,United States,1964.0,96,39,42,177
10383,United States,2016.0,139,54,71,264
10384,United States,2016.0,139,54,71,264
10385,United States,1920.0,111,45,38,194
10386,United States,1968.0,100,37,36,173
10387,United States,2004.0,117,75,71,263
10388,United States,1920.0,111,45,38,194
10389,United States,1920.0,111,45,38,194
10390,United States,1920.0,111,45,38,194
10391,United States,1924.0,98,46,50,194
10392,United States,1924.0,98,46,50,194
10393,United States-2,1928.0,53,30,19,102
10394,United States-1,1932.0,91,68,64,223
10395,United States,1932.0,91,68,64,223
10396,United States,1936.0,53,29,30,112
10397,United States,1924.0,98,46,50,194
10398,United States,1948.0,93,34,41,168
10399,United States,1920.0,111,45,38,194
10400,United States,1932.0,91,68,64,223
10401,United States,1984.0,190,121,50,361
10402,United States,1920.0,111,45,38,194
10403,United States,2002.0,11,58,15,84
10404,United States,1988.0,89,67,58,214
10405,United States,1984.0,190,121,50,361
10406,United States,1988.0,89,67,58,214
10407,United States,1994.0,6,8,5,19
10408,United States,1984.0,190,121,50,361
10409,United States,1900.0,30,16,17,63
10410,United States,1904.0,128,141,125,394
10411,United States,1904.0,128,141,125,394
10412,United States,1908.0,34,16,15,65
10413,Milwaukee Athletic Club-1,1904.0,128,141,125,394
10414,United States,1936.0,53,29,30,112
10415,United States,2008.0,127,110,80,317
10416,Vesper Boat Club,1904.0,128,141,125,394
10417,United States,1968.0,100,37,36,173
10418,United States-1,2006.0,9,11,32,52
10419,United States,1984.0,190,121,50,361
10420,United States,1924.0,98,46,50,194
10421,United States,2006.0,9,11,32,52
10422,United States,1984.0,190,121,50,361
10423,United States,1936.0,53,29,30,112
10424,United States,2004.0,117,75,71,263
10425,United States,2008.0,127,110,80,317
10426,United States-2,2002.0,11,58,15,84
10427,United States,1932.0,91,68,64,223
10428,United States,1948.0,93,34,41,168
10429,United States,1920.0,111,45,38,194
10430,United States,1992.0,94,57,87,238
10431,United States,2000.0,130,61,51,242
10432,United States,2004.0,117,75,71,263
10433,United States-1,2014.0,10,30,24,64
10434,United States,1964.0,96,39,42,177
10435,United States-1,2000.0,130,61,51,242
10436,United States,1976.0,73,61,41,175
10437,United States,1972.0,72,77,46,195
10438,United States,1948.0,93,34,41,168
10439,United States,1956.0,63,61,25,149
10440,United States,1976.0,73,61,41,175
10441,United States,1968.0,100,37,36,173
10442,Mound City Rowing Club-2,1904.0,128,141,125,394
10443,United States,1984.0,190,121,50,361
10444,United States,1976.0,73,61,41,175
10445,United States,1908.0,34,16,15,65
10446,United States,1936.0,53,29,30,112
10447,United States,1988.0,89,67,58,214
10448,United States,1992.0,94,57,87,238
10449,United States-2,1948.0,93,34,41,168
10450,United States,1968.0,100,37,36,173
10451,United States,1920.0,111,45,38,194
10452,United States,1972.0,72,77,46,195
10453,United States,1984.0,190,121,50,361
10454,United States,1992.0,94,57,87,238
10455,United States,1996.0,159,48,52,259
10456,United States,2000.0,130,61,51,242
10457,United States,2004.0,117,75,71,263
10458,United States,2008.0,127,110,80,317
10459,United States,2000.0,130,61,51,242
10460,United States,1968.0,100,37,36,173
10461,United States,2008.0,127,110,80,317
10462,United States,2008.0,127,110,80,317
10463,United States,2012.0,145,57,46,248
10464,United States,2016.0,139,54,71,264
10465,United States,1904.0,128,141,125,394
10466,United States,1996.0,159,48,52,259
10467,United States,1996.0,159,48,52,259
10468,United States,1996.0,159,48,52,259
10469,United States,1964.0,96,39,42,177
10470,United States,1984.0,190,121,50,361
10471,United States,2008.0,127,110,80,317
10472,United States,2012.0,145,57,46,248
10473,United States,2016.0,139,54,71,264
10474,United States,1904.0,128,141,125,394
10475,United States,2004.0,117,75,71,263
10476,United States,1906.0,12,6,6,24
10477,United States,2012.0,145,57,46,248
10478,United States,2012.0,145,57,46,248
10479,United States,2012.0,145,57,46,248
10480,United States,2012.0,145,57,46,248
10481,United States,2012.0,145,57,46,248
10482,United States,2016.0,139,54,71,264
10483,United States,2000.0,130,61,51,242
10484,United States,1948.0,93,34,41,168
10485,United States,1948.0,93,34,41,168
10486,United States Golf Association-3,1904.0,128,141,125,394
10487,United States,1984.0,190,121,50,361
10488,United States,1980.0,24,4,2,30
10489,United States,1976.0,73,61,41,175
10490,United States,1976.0,73,61,41,175
10491,United States,1964.0,96,39,42,177
10492,United States,1932.0,91,68,64,223
10493,United States,1928.0,53,30,19,102
10494,United States,1920.0,111,45,38,194
10495,United States,1920.0,111,45,38,194
10496,United States,1920.0,111,45,38,194
10497,United States,2004.0,117,75,71,263
10498,United States,1964.0,96,39,42,177
10499,United States,1968.0,100,37,36,173
10500,United States,1972.0,72,77,46,195
10501,United States,1936.0,53,29,30,112
10502,United States,1968.0,100,37,36,173
10503,United States,1968.0,100,37,36,173
10504,United States,1952.0,87,48,29,164
10505,United States,1936.0,53,29,30,112
10506,Western Rowing Club-3,1904.0,128,141,125,394
10507,St. Louis Southwest Turnverein #2-3,1904.0,128,141,125,394
10508,United States,1968.0,100,37,36,173
10509,United States,1906.0,12,6,6,24
10510,St. Rose-2,1904.0,128,141,125,394
10511,United States,2014.0,10,30,24,64
10512,United States,1952.0,87,48,29,164
10513,United States,1972.0,72,77,46,195
10514,United States,1948.0,93,34,41,168
10515,United States,1952.0,87,48,29,164
10516,United States,1992.0,94,57,87,238
10517,United States,1932.0,91,68,64,223
10518,United States,1976.0,73,61,41,175
10519,United States,1976.0,73,61,41,175
10520,United States,1972.0,72,77,46,195
10521,United States,1932.0,91,68,64,223
10522,United States,1996.0,159,48,52,259
10523,United States,1994.0,6,8,5,19
10524,United States,1984.0,190,121,50,361
10525,United States,1972.0,72,77,46,195
10526,United States,1908.0,34,16,15,65
10527,United States,1996.0,159,48,52,259
10528,United States,1996.0,159,48,52,259
10529,United States,2000.0,130,61,51,242
10530,United States,1984.0,190,121,50,361
10531,United States,1984.0,190,121,50,361
10532,United States,1984.0,190,121,50,361
10533,United States,1932.0,91,68,64,223
10534,United States,2002.0,11,58,15,84
10535,United States,2008.0,127,110,80,317
10536,United States,1928.0,53,30,19,102
10537,United States,1928.0,53,30,19,102
10538,United States,1932.0,91,68,64,223
10539,United States,1932.0,91,68,64,223
10540,United States,2008.0,127,110,80,317
10541,United States,1984.0,190,121,50,361
10542,United States,1988.0,89,67,58,214
10543,United States,1920.0,111,45,38,194
10544,United States,2016.0,139,54,71,264
10545,United States-4,1904.0,128,141,125,394
10546,United States,1952.0,87,48,29,164
10547,United States,2004.0,117,75,71,263
10548,United States,2008.0,127,110,80,317
10549,United States,1928.0,53,30,19,102
10550,United States,1928.0,53,30,19,102
10551,United States,1932.0,91,68,64,223
10552,United States,1932.0,91,68,64,223
10553,United States,1956.0,63,61,25,149
10554,United States,2016.0,139,54,71,264
10555,United States,2008.0,127,110,80,317
10556,United States,2000.0,130,61,51,242
10557,United States,2004.0,117,75,71,263
10558,United States,2000.0,130,61,51,242
10559,United States,2000.0,130,61,51,242
10560,United States,1908.0,34,16,15,65
10561,United States,1908.0,34,16,15,65
10562,United States,1896.0,11,7,2,20
10563,United States,1896.0,11,7,2,20
10564,United States,1896.0,11,7,2,20
10565,United States,1896.0,11,7,2,20
10566,United States,1900.0,30,16,17,63
10567,United States,1900.0,30,16,17,63
10568,United States,2016.0,139,54,71,264
10569,United States,1968.0,100,37,36,173
10570,United States,1932.0,91,68,64,223
10571,United States,1936.0,53,29,30,112
10572,United States,1988.0,89,67,58,214
10573,United States,1988.0,89,67,58,214
10574,United States,1948.0,93,34,41,168
10575,United States,1952.0,87,48,29,164
10576,United States,2004.0,117,75,71,263
10577,United States,2004.0,117,75,71,263
10578,United States,2004.0,117,75,71,263
10579,United States,2012.0,145,57,46,248
10580,United States,2016.0,139,54,71,264
10581,United States,2004.0,117,75,71,263
10582,United States,2012.0,145,57,46,248
10583,United States,1984.0,190,121,50,361
10584,United States,1984.0,190,121,50,361
10585,United States,1984.0,190,121,50,361
10586,United States,1984.0,190,121,50,361
10587,United States,1988.0,89,67,58,214
10588,United States,1992.0,94,57,87,238
10589,United States,1984.0,190,121,50,361
10590,United States,2010.0,12,63,22,97
10591,Vesper Boat Club,1900.0,30,16,17,63
10592,United States,1920.0,111,45,38,194
10593,United States,1972.0,72,77,46,195
10594,United States,1972.0,72,77,46,195
10595,United States,1972.0,72,77,46,195
10596,United States,1932.0,91,68,64,223
10597,United States,2000.0,130,61,51,242
10598,United States,1956.0,63,61,25,149
10599,United States,1960.0,100,27,25,152
10600,United States,2016.0,139,54,71,264
10601,United States,1948.0,93,34,41,168
10602,United States,1952.0,87,48,29,164
10603,United States,1956.0,63,61,25,149
10604,United States,1924.0,98,46,50,194
10605,United States,1920.0,111,45,38,194
10606,United States,1924.0,98,46,50,194
10607,United States,1920.0,111,45,38,194
10608,United States,1936.0,53,29,30,112
10609,United States,1996.0,159,48,52,259
10610,United States,1936.0,53,29,30,112
10611,United States,1948.0,93,34,41,168
10612,United States,1984.0,190,121,50,361
10613,United States,1996.0,159,48,52,259
10614,St. Louis Amateur Athletic Association,1904.0,128,141,125,394
10615,United States,2004.0,117,75,71,263
10616,United States,1908.0,34,16,15,65
10617,United States,1908.0,34,16,15,65
10618,United States,1988.0,89,67,58,214
10619,United States,1948.0,93,34,41,168
10620,United States,2016.0,139,54,71,264
10621,United States,1984.0,190,121,50,361
10622,United States,1960.0,100,27,25,152
10623,United States,1960.0,100,27,25,152
10624,United States,1988.0,89,67,58,214
10625,United States,1936.0,53,29,30,112
10626,United States,1904.0,128,141,125,394
10627,United States,1924.0,98,46,50,194
10628,United States,1932.0,91,68,64,223
10629,United States,1948.0,93,34,41,168
10630,United States,1988.0,89,67,58,214
10631,United States,1988.0,89,67,58,214
10632,United States,1992.0,94,57,87,238
10633,United States,1976.0,73,61,41,175
10634,United States,1924.0,98,46,50,194
10635,United States,1984.0,190,121,50,361
10636,United States,2000.0,130,61,51,242
10637,United States,1952.0,87,48,29,164
10638,United States,1976.0,73,61,41,175
10639,United States,2016.0,139,54,71,264
10640,United States,1904.0,128,141,125,394
10641,United States,2008.0,127,110,80,317
10642,United States,1996.0,159,48,52,259
10643,United States,1912.0,46,25,36,107
10644,Vesper Boat Club,1904.0,128,141,125,394
10645,United States,2010.0,12,63,22,97
10646,United States,1984.0,190,121,50,361
10647,United States,1906.0,12,6,6,24
10648,United States,2016.0,139,54,71,264
10649,United States,1996.0,159,48,52,259
10650,United States,2000.0,130,61,51,242
10651,United States,2002.0,11,58,15,84
10652,United States,2014.0,10,30,24,64
10653,United States,1904.0,128,141,125,394
10654,Missouri Athletic Club-3,1904.0,128,141,125,394
10655,Chicago Athletic Association-2,1904.0,128,141,125,394
10656,United States,1920.0,111,45,38,194
10657,United States,2014.0,10,30,24,64
10658,United States,2004.0,117,75,71,263
10659,United States,2008.0,127,110,80,317
10660,United States,2000.0,130,61,51,242
10661,United States,2004.0,117,75,71,263
10662,United States,1932.0,91,68,64,223
10663,United States,1964.0,96,39,42,177
10664,United States,1984.0,190,121,50,361
10665,United States,2008.0,127,110,80,317
10666,United States,1976.0,73,61,41,175
10667,United States,1976.0,73,61,41,175
10668,New York Athletic Club-1,1904.0,128,141,125,394
10669,New York Athletic Club #1-1,1904.0,128,141,125,394
10670,United States,1904.0,128,141,125,394
10671,United States,1908.0,34,16,15,65
10672,United States,1948.0,93,34,41,168
10673,United States,1956.0,63,61,25,149
10674,United States,1988.0,89,67,58,214
10675,United States,1932.0,91,68,64,223
10676,United States,1964.0,96,39,42,177
10677,United States,1908.0,34,16,15,65
10678,United States,1908.0,34,16,15,65
10679,United States,1984.0,190,121,50,361
10680,United States,1968.0,100,37,36,173
10681,United States,2012.0,145,57,46,248
10682,United States,1908.0,34,16,15,65
10683,United States,1988.0,89,67,58,214
10684,United States,1924.0,98,46,50,194
10685,United States,1952.0,87,48,29,164
10686,United States,1964.0,96,39,42,177
10687,United States,1984.0,190,121,50,361
10688,United States,1984.0,190,121,50,361
10689,United States,1964.0,96,39,42,177
10690,United States,1924.0,98,46,50,194
10691,United States,1912.0,46,25,36,107
10692,United States,1924.0,98,46,50,194
10693,United States,1912.0,46,25,36,107
10694,United States,1912.0,46,25,36,107
10695,United States,1996.0,159,48,52,259
10696,United States,1932.0,91,68,64,223
10697,United States,1998.0,25,4,5,34
10698,United States,2002.0,11,58,15,84
10699,United States-1,1928.0,53,30,19,102
10700,United States,1996.0,159,48,52,259
10701,United States,1976.0,73,61,41,175
10702,United States,1984.0,190,121,50,361
10703,United States,1920.0,111,45,38,194
10704,United States,2016.0,139,54,71,264
10705,United States,2000.0,130,61,51,242
10706,United States-2,1928.0,53,30,19,102
10707,United States-1,1932.0,91,68,64,223
10708,Jupiter,1932.0,91,68,64,223
10709,United States,1924.0,98,46,50,194
10710,United States,1992.0,94,57,87,238
10711,United States,1988.0,89,67,58,214
10712,United States,1960.0,100,27,25,152
10713,United States,1904.0,128,141,125,394
10714,United States,1904.0,128,141,125,394
10715,United States,1996.0,159,48,52,259
10716,United States,1984.0,190,121,50,361
10717,United States,2016.0,139,54,71,264
10718,United States,1964.0,96,39,42,177
10719,United States,1992.0,94,57,87,238
10720,United States,1936.0,53,29,30,112
10721,United States,1968.0,100,37,36,173
10722,United States,1968.0,100,37,36,173
10723,United States,1992.0,94,57,87,238
10724,United States,1996.0,159,48,52,259
10725,United States,2000.0,130,61,51,242
10726,United States,2000.0,130,61,51,242
10727,United States,2004.0,117,75,71,263
10728,United States,2004.0,117,75,71,263
10729,United States,1904.0,128,141,125,394
10730,United States,1932.0,91,68,64,223
10731,United States,1932.0,91,68,64,223
10732,United States,1976.0,73,61,41,175
10733,United States,2008.0,127,110,80,317
10734,United States,1976.0,73,61,41,175
10735,United States,1996.0,159,48,52,259
10736,United States-2,2014.0,10,30,24,64
10737,United States,2008.0,127,110,80,317
10738,United States,2008.0,127,110,80,317
10739,United States,2008.0,127,110,80,317
10740,United States,2012.0,145,57,46,248
10741,United States,2012.0,145,57,46,248
10742,United States,2012.0,145,57,46,248
10743,United States,1984.0,190,121,50,361
10744,United States,1904.0,128,141,125,394
10745,"Philadelphia Turngemeinde, Philadelphia",1904.0,128,141,125,394
10746,United States,1948.0,93,34,41,168
10747,United States,2000.0,130,61,51,242
10748,United States,2004.0,117,75,71,263
10749,United States,1984.0,190,121,50,361
10750,United States,1988.0,89,67,58,214
10751,United States,1988.0,89,67,58,214
10752,United States,1988.0,89,67,58,214
10753,United States,1988.0,89,67,58,214
10754,United States,1956.0,63,61,25,149
10755,United States-2,1998.0,25,4,5,34
10756,United States-2,2002.0,11,58,15,84
10757,United States,2016.0,139,54,71,264
10758,United States,1952.0,87,48,29,164
10759,St. Louis Amateur Athletic Association,1904.0,128,141,125,394
10760,United States,1904.0,128,141,125,394
10761,United States,1932.0,91,68,64,223
10762,United States,1996.0,159,48,52,259
10763,United States,1948.0,93,34,41,168
10764,United States,1976.0,73,61,41,175
10765,United States,1984.0,190,121,50,361
10766,United States,2008.0,127,110,80,317
10767,United States,2002.0,11,58,15,84
10768,United States,1920.0,111,45,38,194
10769,United States,1920.0,111,45,38,194
10770,United States,1992.0,94,57,87,238
10771,United States,1996.0,159,48,52,259
10772,United States,1932.0,91,68,64,223
10773,United States,1904.0,128,141,125,394
10774,United States,2006.0,9,11,32,52
10775,United States,1964.0,96,39,42,177
10776,United States,1976.0,73,61,41,175
10777,United States,1968.0,100,37,36,173
10778,United States,1968.0,100,37,36,173
10779,United States,1968.0,100,37,36,173
10780,United States,1956.0,63,61,25,149
10781,United States,1912.0,46,25,36,107
10782,United States,2016.0,139,54,71,264
10783,St. Louis Southwest Turnverein #2-3,1904.0,128,141,125,394
10784,United States,1976.0,73,61,41,175
10785,United States,1988.0,89,67,58,214
10786,United States,1992.0,94,57,87,238
10787,United States,2006.0,9,11,32,52
10788,United States,2008.0,127,110,80,317
10789,United States,1904.0,128,141,125,394
10790,United States,1904.0,128,141,125,394
10791,United States,1904.0,128,141,125,394
10792,United States,1906.0,12,6,6,24
10793,United States,1984.0,190,121,50,361
10794,United States,1992.0,94,57,87,238
10795,United States,1992.0,94,57,87,238
10796,United States,1992.0,94,57,87,238
10797,United States,1960.0,100,27,25,152
10798,United States,1928.0,53,30,19,102
10799,United States,1976.0,73,61,41,175
10800,United States,1956.0,63,61,25,149
10801,United States,1960.0,100,27,25,152
10802,United States,2016.0,139,54,71,264
10803,United States,1992.0,94,57,87,238
10804,United States,1900.0,30,16,17,63
10805,United States,1996.0,159,48,52,259
10806,United States,1968.0,100,37,36,173
10807,United States,1932.0,91,68,64,223
10808,United States,1912.0,46,25,36,107
10809,United States,1968.0,100,37,36,173
10810,United States,1972.0,72,77,46,195
10811,United States,1972.0,72,77,46,195
10812,United States,1976.0,73,61,41,175
10813,United States,1968.0,100,37,36,173
10814,United States,1968.0,100,37,36,173
10815,United States,1968.0,100,37,36,173
10816,United States,1960.0,100,27,25,152
10817,United States,1932.0,91,68,64,223
10818,United States,1996.0,159,48,52,259
10819,United States,1996.0,159,48,52,259
10820,United States,1996.0,159,48,52,259
10821,United States,1996.0,159,48,52,259
10822,United States,2000.0,130,61,51,242
10823,United States,2000.0,130,61,51,242
10824,United States,2000.0,130,61,51,242
10825,United States,2000.0,130,61,51,242
10826,United States,2004.0,117,75,71,263
10827,United States,2004.0,117,75,71,263
10828,United States,1904.0,128,141,125,394
10829,United States,1932.0,91,68,64,223
10830,United States,1964.0,96,39,42,177
10831,Shrew II,1960.0,100,27,25,152
10832,United States,1976.0,73,61,41,175
10833,United States,1920.0,111,45,38,194
10834,United States,1908.0,34,16,15,65
10835,United States,1984.0,190,121,50,361
10836,United States,2014.0,10,30,24,64
10837,United States,1928.0,53,30,19,102
10838,United States,1996.0,159,48,52,259
10839,United States,2000.0,130,61,51,242
10840,United States,2004.0,117,75,71,263
10841,United States,2004.0,117,75,71,263
10842,United States,2004.0,117,75,71,263
10843,United States,2004.0,117,75,71,263
10844,United States,2004.0,117,75,71,263
10845,United States,2012.0,145,57,46,248
10846,United States,2012.0,145,57,46,248
10847,United States,2016.0,139,54,71,264
10848,United States,2016.0,139,54,71,264
10849,Chicago Athletic Association-2,1904.0,128,141,125,394
10850,Chicago Athletic Association-2,1904.0,128,141,125,394
10851,United States,1972.0,72,77,46,195
10852,United States,1972.0,72,77,46,195
10853,United States,1976.0,73,61,41,175
10854,United States,1976.0,73,61,41,175
10855,United States,2008.0,127,110,80,317
10856,United States,2012.0,145,57,46,248
10857,New York Athletic Club-1,1904.0,128,141,125,394
10858,New York Athletic Club #1-1,1904.0,128,141,125,394
10859,United States,1904.0,128,141,125,394
10860,United States,2008.0,127,110,80,317
10861,United States,2012.0,145,57,46,248
10862,United States,1956.0,63,61,25,149
10863,United States,2000.0,130,61,51,242
10864,United States,2004.0,117,75,71,263
10865,United States,2004.0,117,75,71,263
10866,United States,2004.0,117,75,71,263
10867,United States,2008.0,127,110,80,317
10868,United States,2012.0,145,57,46,248
10869,United States,2012.0,145,57,46,248
10870,United States,2010.0,12,63,22,97
10871,United States,1964.0,96,39,42,177
10872,United States,2004.0,117,75,71,263
10873,United States,2008.0,127,110,80,317
10874,United States,1920.0,111,45,38,194
10875,United States,1996.0,159,48,52,259
10876,United States,2000.0,130,61,51,242
10877,United States,2012.0,145,57,46,248
10878,United States,2012.0,145,57,46,248
10879,United States,1996.0,159,48,52,259
10880,United States,1932.0,91,68,64,223
10881,United States,1936.0,53,29,30,112
10882,United States,1952.0,87,48,29,164
10883,United States,2012.0,145,57,46,248
10884,United States,2012.0,145,57,46,248
10885,United States,1948.0,93,34,41,168
10886,United States,1900.0,30,16,17,63
10887,United States,1904.0,128,141,125,394
10888,United States,1996.0,159,48,52,259
10889,United States,1996.0,159,48,52,259
10890,United States,1948.0,93,34,41,168
10891,United States,1948.0,93,34,41,168
10892,United States,1964.0,96,39,42,177
10893,United States,2012.0,145,57,46,248
10894,United States,2016.0,139,54,71,264
10895,United States,1948.0,93,34,41,168
10896,United States,2008.0,127,110,80,317
10897,United States,2012.0,145,57,46,248
10898,United States,1956.0,63,61,25,149
10899,United States,1976.0,73,61,41,175
10900,United States,1996.0,159,48,52,259
10901,United States,2000.0,130,61,51,242
10902,United States,2004.0,117,75,71,263
10903,United States,1980.0,24,4,2,30
10904,United States,1920.0,111,45,38,194
10905,United States,1920.0,111,45,38,194
10906,United States,1984.0,190,121,50,361
10907,United States,1996.0,159,48,52,259
10908,United States,1976.0,73,61,41,175
10909,United States,2004.0,117,75,71,263
10910,United States,2004.0,117,75,71,263
10911,United States,1968.0,100,37,36,173
10912,United States,1964.0,96,39,42,177
10913,United States,1996.0,159,48,52,259
10914,United States,2000.0,130,61,51,242
10915,United States,1952.0,87,48,29,164
10916,United States,1960.0,100,27,25,152
10917,United States,2012.0,145,57,46,248
10918,United States,2016.0,139,54,71,264
10919,United States,1996.0,159,48,52,259
10920,United States,1972.0,72,77,46,195
10921,United States,1924.0,98,46,50,194
10922,United States,1984.0,190,121,50,361
10923,United States,1992.0,94,57,87,238
10924,United States,1996.0,159,48,52,259
10925,United States,2008.0,127,110,80,317
10926,United States,2016.0,139,54,71,264
10927,United States,2004.0,117,75,71,263
10928,United States,2004.0,117,75,71,263
10929,Chicago Athletic Association,1904.0,128,141,125,394
10930,United States,1932.0,91,68,64,223
10931,United States,1932.0,91,68,64,223
10932,United States,1924.0,98,46,50,194
10933,United States,1948.0,93,34,41,168
10934,United States,1952.0,87,48,29,164
10935,United States,1988.0,89,67,58,214
10936,United States,1912.0,46,25,36,107
10937,United States,2000.0,130,61,51,242
10938,United States,1964.0,96,39,42,177
10939,United States,1964.0,96,39,42,177
10940,United States,2008.0,127,110,80,317
10941,United States,1984.0,190,121,50,361
10942,United States,2004.0,117,75,71,263
10943,United States,1908.0,34,16,15,65
10944,United States-1,2002.0,11,58,15,84
10945,United States,1968.0,100,37,36,173
10946,United States,1964.0,96,39,42,177
10947,United States,1976.0,73,61,41,175
10948,United States,1928.0,53,30,19,102
10949,Chicago Athletic Association-2,1904.0,128,141,125,394
10950,United States,1992.0,94,57,87,238
10951,United States,2000.0,130,61,51,242
10952,United States,1904.0,128,141,125,394
10953,Chicago Athletic Association,1904.0,128,141,125,394
10954,United States,1984.0,190,121,50,361
10955,United States,1984.0,190,121,50,361
10956,United States,1984.0,190,121,50,361
10957,United States,1984.0,190,121,50,361
10958,United States,2008.0,127,110,80,317
10959,United States,2012.0,145,57,46,248
10960,United States,1928.0,53,30,19,102
10961,United States-2,1932.0,91,68,64,223
10962,United States,1948.0,93,34,41,168
10963,United States,1928.0,53,30,19,102
10964,United States-1,1928.0,53,30,19,102
10965,United States,1908.0,34,16,15,65
10966,United States,1912.0,46,25,36,107
10967,United States,1912.0,46,25,36,107
10968,United States,1956.0,63,61,25,149
10969,United States,1996.0,159,48,52,259
10970,United States,1996.0,159,48,52,259
10971,United States,1996.0,159,48,52,259
10972,United States,1928.0,53,30,19,102
10973,Vesper Boat Club,1900.0,30,16,17,63
10974,United States,2006.0,9,11,32,52
10975,United States,2006.0,9,11,32,52
10976,United States,2006.0,9,11,32,52
10977,United States,2010.0,12,63,22,97
10978,United States,2010.0,12,63,22,97
10979,United States,1984.0,190,121,50,361
10980,United States,1984.0,190,121,50,361
10981,United States,1904.0,128,141,125,394
10982,"Philadelphia Turngemeinde, Philadelphia",1904.0,128,141,125,394
10983,United States,1904.0,128,141,125,394
10984,United States,1904.0,128,141,125,394
10985,United States,1904.0,128,141,125,394
10986,United States,1904.0,128,141,125,394
10987,United States,1980.0,24,4,2,30
10988,United States,1980.0,24,4,2,30
10989,United States,1980.0,24,4,2,30
10990,United States,1980.0,24,4,2,30
10991,United States,1980.0,24,4,2,30
10992,United States,1980.0,24,4,2,30
10993,United States,1972.0,72,77,46,195
10994,United States,1972.0,72,77,46,195
10995,United States,1972.0,72,77,46,195
10996,United States,1972.0,72,77,46,195
10997,Western Rowing Club-3,1904.0,128,141,125,394
10998,United States,1904.0,128,141,125,394
10999,United States,1956.0,63,61,25,149
11000,United States,1960.0,100,27,25,152
11001,United States,1932.0,91,68,64,223
11002,United States,2016.0,139,54,71,264
11003,United States,1924.0,98,46,50,194
11004,United States,1976.0,73,61,41,175
11005,United States,1948.0,93,34,41,168
11006,United States,2004.0,117,75,71,263
11007,United States,1972.0,72,77,46,195
11008,United States,1972.0,72,77,46,195
11009,United States,1972.0,72,77,46,195
11010,United States,1976.0,73,61,41,175
11011,United States,1976.0,73,61,41,175
11012,United States,1976.0,73,61,41,175
11013,United States,2000.0,130,61,51,242
11014,United States,2016.0,139,54,71,264
11015,United States,1996.0,159,48,52,259
11016,United States,2004.0,117,75,71,263
11017,United States,2008.0,127,110,80,317
11018,United States,1972.0,72,77,46,195
11019,United States,1912.0,46,25,36,107
11020,United States,1924.0,98,46,50,194
11021,United States,2000.0,130,61,51,242
11022,United States,2004.0,117,75,71,263
11023,United States,1968.0,100,37,36,173
11024,United States,1968.0,100,37,36,173
11025,United States,1968.0,100,37,36,173
11026,United States,1968.0,100,37,36,173
11027,United States,1968.0,100,37,36,173
11028,United States,1996.0,159,48,52,259
11029,United States,1904.0,128,141,125,394
11030,United States,1904.0,128,141,125,394
11031,United States,1972.0,72,77,46,195
11032,United States,1972.0,72,77,46,195
11033,United States,1948.0,93,34,41,168
11034,United States,1948.0,93,34,41,168
11035,United States,1948.0,93,34,41,168
11036,United States,1912.0,46,25,36,107
11037,United States,1968.0,100,37,36,173
11038,United States,1952.0,87,48,29,164
11039,United States,1984.0,190,121,50,361
11040,United States,1952.0,87,48,29,164
11041,United States,2000.0,130,61,51,242
11042,United States,1984.0,190,121,50,361
11043,United States,1932.0,91,68,64,223
11044,United States,2016.0,139,54,71,264
11045,United States,2016.0,139,54,71,264
11046,United States,2016.0,139,54,71,264
11047,United States,1948.0,93,34,41,168
11048,"Philadelphia Turngemeinde, Philadelphia",1904.0,128,141,125,394
11049,New York Athletic Club-1,1904.0,128,141,125,394
11050,United States,2008.0,127,110,80,317
11051,United States,1964.0,96,39,42,177
11052,United States,1968.0,100,37,36,173
11053,United States,1968.0,100,37,36,173
11054,United States,1968.0,100,37,36,173
11055,United States,1968.0,100,37,36,173
11056,United States-1,1948.0,93,34,41,168
11057,United States,1904.0,128,141,125,394
11058,United States,1996.0,159,48,52,259
11059,United States,1960.0,100,27,25,152
11060,United States,2016.0,139,54,71,264
11061,United States,1932.0,91,68,64,223
11062,United States,2016.0,139,54,71,264
11063,United States,1972.0,72,77,46,195
11064,United States,1984.0,190,121,50,361
11065,United States,1992.0,94,57,87,238
11066,United States,1904.0,128,141,125,394
11067,United States,1904.0,128,141,125,394
11068,United States,1904.0,128,141,125,394
11069,United States,1908.0,34,16,15,65
11070,United States,1924.0,98,46,50,194
11071,United States,1996.0,159,48,52,259
11072,United States,1924.0,98,46,50,194
11073,United States-1,1928.0,53,30,19,102
11074,United States,1924.0,98,46,50,194
11075,United States-1,2002.0,11,58,15,84
11076,United States,1968.0,100,37,36,173
11077,United States,1968.0,100,37,36,173
11078,United States,2008.0,127,110,80,317
11079,United States,1912.0,46,25,36,107
11080,United States,1912.0,46,25,36,107
11081,United States,1912.0,46,25,36,107
11082,United States,1924.0,98,46,50,194
11083,United States,2016.0,139,54,71,264
11084,United States,1952.0,87,48,29,164
11085,United States,1972.0,72,77,46,195
11086,United States,1972.0,72,77,46,195
11087,Ravenswood Boat Club-2,1904.0,128,141,125,394
11088,United States,1956.0,63,61,25,149
11089,United States,2012.0,145,57,46,248
11090,United States,2008.0,127,110,80,317
11091,United States,2008.0,127,110,80,317
11092,United States,2008.0,127,110,80,317
11093,United States,1976.0,73,61,41,175
11094,United States,2008.0,127,110,80,317
11095,United States,2008.0,127,110,80,317
11096,United States,2008.0,127,110,80,317
11097,United States,2008.0,127,110,80,317
11098,United States,2012.0,145,57,46,248
11099,United States,1972.0,72,77,46,195
11100,United States,1904.0,128,141,125,394
11101,United States,1904.0,128,141,125,394
11102,United States,1904.0,128,141,125,394
11103,United States,1984.0,190,121,50,361
11104,United States,1984.0,190,121,50,361
11105,United States,1984.0,190,121,50,361
11106,United States,1984.0,190,121,50,361
11107,United States-1,2010.0,12,63,22,97
11108,United States-1,2014.0,10,30,24,64
11109,United States-1,2014.0,10,30,24,64
11110,United States,2000.0,130,61,51,242
11111,United States,1900.0,30,16,17,63
11112,United States,1932.0,91,68,64,223
11113,United States,2016.0,139,54,71,264
11114,United States,1968.0,100,37,36,173
11115,United States,1968.0,100,37,36,173
11116,United States,1972.0,72,77,46,195
11117,United States,1972.0,72,77,46,195
11118,United States,1984.0,190,121,50,361
11119,United States-2,1932.0,91,68,64,223
11120,United States,2016.0,139,54,71,264
11121,United States,1984.0,190,121,50,361
11122,United States,1984.0,190,121,50,361
11123,United States,1920.0,111,45,38,194
11124,United States,2012.0,145,57,46,248
11125,United States,1976.0,73,61,41,175
11126,United States,1952.0,87,48,29,164
11127,United States,2004.0,117,75,71,263
11128,United States,2008.0,127,110,80,317
11129,United States,1912.0,46,25,36,107
11130,United States,1924.0,98,46,50,194
11131,United States,1908.0,34,16,15,65
11132,United States,1908.0,34,16,15,65
11133,United States,1968.0,100,37,36,173
11134,United States,1972.0,72,77,46,195
11135,United States-2,1932.0,91,68,64,223
11136,United States,2008.0,127,110,80,317
11137,United States,2008.0,127,110,80,317
11138,United States,1968.0,100,37,36,173
11139,United States,2012.0,145,57,46,248
11140,United States,1952.0,87,48,29,164
11141,United States,1968.0,100,37,36,173
11142,United States,1952.0,87,48,29,164
11143,United States,1956.0,63,61,25,149
11144,United States,1924.0,98,46,50,194
11145,United States,1924.0,98,46,50,194
11146,United States,1928.0,53,30,19,102
11147,United States,2002.0,11,58,15,84
11148,United States,2000.0,130,61,51,242
11149,United States,1960.0,100,27,25,152
11150,United States,2008.0,127,110,80,317
11151,United States,1984.0,190,121,50,361
11152,United States,1988.0,89,67,58,214
11153,United States,1984.0,190,121,50,361
11154,United States,1988.0,89,67,58,214
11155,United States,1992.0,94,57,87,238
11156,United States,1972.0,72,77,46,195
11157,United States,1924.0,98,46,50,194
11158,United States,1904.0,128,141,125,394
11159,United States,1904.0,128,141,125,394
11160,Cincinnati Archers,1904.0,128,141,125,394
11161,United States,1896.0,11,7,2,20
11162,Cincinnati Archers,1904.0,128,141,125,394
11163,United States,1924.0,98,46,50,194
11164,United States,1976.0,73,61,41,175
11165,United States,2004.0,117,75,71,263
11166,United States,2008.0,127,110,80,317
11167,United States,1992.0,94,57,87,238
11168,United States,1992.0,94,57,87,238
11169,United States,1996.0,159,48,52,259
11170,United States,2008.0,127,110,80,317
11171,United States,1960.0,100,27,25,152
11172,Angelita,1932.0,91,68,64,223
11173,United States,2000.0,130,61,51,242
11174,United States,1924.0,98,46,50,194
11175,United States,1924.0,98,46,50,194
11176,United States,2002.0,11,58,15,84
11177,United States,1996.0,159,48,52,259
11178,United States,1996.0,159,48,52,259
11179,United States,2002.0,11,58,15,84
11180,United States,1936.0,53,29,30,112
11181,United States,2004.0,117,75,71,263
11182,United States,2004.0,117,75,71,263
11183,Minotaur,1960.0,100,27,25,152
11184,United States,1936.0,53,29,30,112
11185,Western Golf Association-1,1904.0,128,141,125,394
11186,United States-2,1924.0,98,46,50,194
11187,United States,1920.0,111,45,38,194
11188,St. Louis Amateur Athletic Association,1904.0,128,141,125,394
11189,United States,1984.0,190,121,50,361
11190,United States,2012.0,145,57,46,248
11191,United States,2012.0,145,57,46,248
11192,United States,1904.0,128,141,125,394
11193,United States,1904.0,128,141,125,394
11194,United States,1904.0,128,141,125,394
11195,United States,1904.0,128,141,125,394
11196,United States,1904.0,128,141,125,394
11197,United States Golf Association-3,1904.0,128,141,125,394
11198,United States,1924.0,98,46,50,194
11199,United States,1912.0,46,25,36,107
11200,United States,1912.0,46,25,36,107
11201,United States,2008.0,127,110,80,317
11202,United States,1936.0,53,29,30,112
11203,United States,1924.0,98,46,50,194
11204,United States,1984.0,190,121,50,361
11205,United States,2000.0,130,61,51,242
11206,United States,2000.0,130,61,51,242
11207,United States,1984.0,190,121,50,361
11208,United States,2012.0,145,57,46,248
11209,United States,1956.0,63,61,25,149
11210,United States,1964.0,96,39,42,177
11211,United States,1964.0,96,39,42,177
11212,United States,2016.0,139,54,71,264
11213,United States,1960.0,100,27,25,152
11214,United States,1976.0,73,61,41,175
11215,United States,1952.0,87,48,29,164
11216,United States,1932.0,91,68,64,223
11217,United States,1976.0,73,61,41,175
11218,United States,2008.0,127,110,80,317
11219,United States,2006.0,9,11,32,52
11220,United States,2012.0,145,57,46,248
11221,United States,1908.0,34,16,15,65
11222,United States,2016.0,139,54,71,264
11223,United States,1972.0,72,77,46,195
11224,United States,1992.0,94,57,87,238
11225,United States,2000.0,130,61,51,242
11226,United States,2004.0,117,75,71,263
11227,United States-1,2002.0,11,58,15,84
11228,United States,1984.0,190,121,50,361
11229,United States,1968.0,100,37,36,173
11230,United States,1972.0,72,77,46,195
11231,United States,1972.0,72,77,46,195
11232,United States,1992.0,94,57,87,238
11233,United States,2006.0,9,11,32,52
11234,United States,1952.0,87,48,29,164
11235,United States,2008.0,127,110,80,317
11236,United States,1920.0,111,45,38,194
11237,United States,1920.0,111,45,38,194
11238,United States,1920.0,111,45,38,194
11239,United States,1912.0,46,25,36,107
11240,United States,1912.0,46,25,36,107
11241,United States,1992.0,94,57,87,238
11242,United States,1964.0,96,39,42,177
11243,United States,1992.0,94,57,87,238
11244,United States,1996.0,159,48,52,259
11245,United States,1996.0,159,48,52,259
11246,United States,1996.0,159,48,52,259
11247,United States,2006.0,9,11,32,52
11248,United States-1,1992.0,94,57,87,238
11249,United States,1988.0,89,67,58,214
11250,United States,1988.0,89,67,58,214
11251,United States,1988.0,89,67,58,214
11252,United States,1908.0,34,16,15,65
11253,St. Louis Southwest Turnverein #2-3,1904.0,128,141,125,394
11254,United States,2004.0,117,75,71,263
11255,United States,2008.0,127,110,80,317
11256,United States,2008.0,127,110,80,317
11257,United States,1904.0,128,141,125,394
11258,United States,1920.0,111,45,38,194
11259,United States,1988.0,89,67,58,214
11260,United States,1932.0,91,68,64,223
11261,United States,2016.0,139,54,71,264
11262,United States,2016.0,139,54,71,264
11263,United States,1992.0,94,57,87,238
11264,United States,1932.0,91,68,64,223
11265,United States,1932.0,91,68,64,223
11266,United States,2016.0,139,54,71,264
11267,United States,1984.0,190,121,50,361
11268,United States,1984.0,190,121,50,361
11269,United States,1988.0,89,67,58,214
11270,United States,1988.0,89,67,58,214
11271,United States,1988.0,89,67,58,214
11272,United States,1992.0,94,57,87,238
11273,United States,1992.0,94,57,87,238
11274,United States,1968.0,100,37,36,173
11275,United States,1968.0,100,37,36,173
11276,United States,1968.0,100,37,36,173
11277,United States,2004.0,117,75,71,263
11278,United States,2008.0,127,110,80,317
11279,United States,2012.0,145,57,46,248
11280,United States,1976.0,73,61,41,175
11281,St. Rose-2,1904.0,128,141,125,394
11282,St. Rose-2,1904.0,128,141,125,394
11283,United States,1996.0,159,48,52,259
11284,United States,1896.0,11,7,2,20
11285,United States,1994.0,6,8,5,19
11286,Christian Brothers' College-1,1904.0,128,141,125,394
11287,Christian Brothers' College-1,1904.0,128,141,125,394
11288,Christian Brothers' College-1,1904.0,128,141,125,394
11289,United States,1900.0,30,16,17,63
11290,United States,2004.0,117,75,71,263
11291,United States,1932.0,91,68,64,223
11292,United States,1964.0,96,39,42,177
11293,United States,1968.0,100,37,36,173
11294,United States,1984.0,190,121,50,361
11295,United States,2010.0,12,63,22,97
11296,United States,1956.0,63,61,25,149
11297,United States,1956.0,63,61,25,149
11298,United States,1932.0,91,68,64,223
11299,United States,2004.0,117,75,71,263
11300,United States,1984.0,190,121,50,361
11301,United States,2004.0,117,75,71,263
11302,United States,1924.0,98,46,50,194
11303,United States,1956.0,63,61,25,149
11304,United States,1956.0,63,61,25,149
11305,United States,1992.0,94,57,87,238
11306,United States,1956.0,63,61,25,149
11307,United States,1960.0,100,27,25,152
11308,United States,1956.0,63,61,25,149
11309,United States,1976.0,73,61,41,175
11310,United States,1924.0,98,46,50,194
11311,United States,1932.0,91,68,64,223
11312,United States,1992.0,94,57,87,238
11313,United States,2012.0,145,57,46,248
11314,United States,2004.0,117,75,71,263
11315,United States,2008.0,127,110,80,317
11316,United States,2000.0,130,61,51,242
11317,United States,2008.0,127,110,80,317
11318,United States-2,1924.0,98,46,50,194
11319,United States,2012.0,145,57,46,248
11320,United States,2012.0,145,57,46,248
11321,United States,2012.0,145,57,46,248
11322,United States,1992.0,94,57,87,238
11323,United States,1988.0,89,67,58,214
11324,United States,1984.0,190,121,50,361
11325,United States,1924.0,98,46,50,194
11326,United States,1976.0,73,61,41,175
11327,United States,1976.0,73,61,41,175
11328,Western Rowing Club-3,1904.0,128,141,125,394
11329,United States,1968.0,100,37,36,173
11330,United States,1932.0,91,68,64,223
11331,United States,1932.0,91,68,64,223
11332,United States,1932.0,91,68,64,223
11333,St. Rose-2,1904.0,128,141,125,394
11334,United States,1996.0,159,48,52,259
11335,United States,2016.0,139,54,71,264
11336,United States,1984.0,190,121,50,361
11337,United States,1996.0,159,48,52,259
11338,United States,2000.0,130,61,51,242
11339,United States,1920.0,111,45,38,194
11340,United States,1920.0,111,45,38,194
11341,United States,1936.0,53,29,30,112
11342,United States,2000.0,130,61,51,242
11343,United States,1992.0,94,57,87,238
11344,United States,1968.0,100,37,36,173
11345,United States,1968.0,100,37,36,173
11346,United States,1924.0,98,46,50,194
11347,United States,1924.0,98,46,50,194
11348,United States,2010.0,12,63,22,97
11349,United States,1936.0,53,29,30,112
11350,United States,2010.0,12,63,22,97
11351,United States,1972.0,72,77,46,195
11352,United States,1984.0,190,121,50,361
11353,United States,1984.0,190,121,50,361
11354,United States,1984.0,190,121,50,361
11355,United States,2004.0,117,75,71,263
11356,United States,1984.0,190,121,50,361
11357,United States,1984.0,190,121,50,361
11358,United States,2000.0,130,61,51,242
11359,United States,1992.0,94,57,87,238
11360,United States,1980.0,24,4,2,30
11361,United States,1972.0,72,77,46,195
11362,United States,1992.0,94,57,87,238
11363,United States,1996.0,159,48,52,259
11364,United States,1996.0,159,48,52,259
11365,United States,2000.0,130,61,51,242
11366,United States,1960.0,100,27,25,152
11367,United States,1956.0,63,61,25,149
11368,United States,1960.0,100,27,25,152
11369,United States,1984.0,190,121,50,361
11370,United States,2004.0,117,75,71,263
11371,United States,2008.0,127,110,80,317
11372,United States,2008.0,127,110,80,317
11373,United States,2008.0,127,110,80,317
11374,United States,2008.0,127,110,80,317
11375,United States,1984.0,190,121,50,361
11376,Milwaukee Athletic Club-1,1904.0,128,141,125,394
11377,United States,2016.0,139,54,71,264
11378,United States-2,2016.0,139,54,71,264
11379,United States,1968.0,100,37,36,173
11380,United States,1968.0,100,37,36,173
11381,United States,1968.0,100,37,36,173
11382,United States,2008.0,127,110,80,317
11383,United States,2012.0,145,57,46,248
11384,United States,1920.0,111,45,38,194
11385,United States,2008.0,127,110,80,317
11386,United States,1988.0,89,67,58,214
11387,United States,1968.0,100,37,36,173
11388,United States,2012.0,145,57,46,248
11389,United States,1952.0,87,48,29,164
11390,United States,1960.0,100,27,25,152
11391,United States,1972.0,72,77,46,195
11392,United States,1952.0,87,48,29,164
11393,United States,1992.0,94,57,87,238
11394,United States,2008.0,127,110,80,317
11395,United States,2012.0,145,57,46,248
11396,United States,2012.0,145,57,46,248
11397,United States,2012.0,145,57,46,248
11398,United States,1972.0,72,77,46,195
11399,United States,1984.0,190,121,50,361
11400,United States,1992.0,94,57,87,238
11401,United States,1960.0,100,27,25,152
11402,United States,1964.0,96,39,42,177
11403,United States,1996.0,159,48,52,259
11404,United States,1976.0,73,61,41,175
11405,United States,1956.0,63,61,25,149
11406,United States,1956.0,63,61,25,149
11407,United States,1900.0,30,16,17,63
11408,United States/Great Britain,1900.0,30,16,17,63
11409,United States,2000.0,130,61,51,242
11410,United States,1996.0,159,48,52,259
11411,United States Golf Association-3,1904.0,128,141,125,394
11412,United States-1,2002.0,11,58,15,84
11413,United States,1904.0,128,141,125,394
11414,United States,1968.0,100,37,36,173
11415,United States,1948.0,93,34,41,168
11416,United States,1992.0,94,57,87,238
11417,United States,1964.0,96,39,42,177
11418,United States,1988.0,89,67,58,214
11419,United States,1920.0,111,45,38,194
11420,United States,2016.0,139,54,71,264
11421,United States,1984.0,190,121,50,361
11422,United States,1992.0,94,57,87,238
11423,United States,1988.0,89,67,58,214
11424,United States,1992.0,94,57,87,238
11425,United States,1988.0,89,67,58,214
11426,United States,1992.0,94,57,87,238
11427,United States,2016.0,139,54,71,264
11428,United States,1988.0,89,67,58,214
11429,United States-1,1964.0,96,39,42,177
11430,United States-1,1964.0,96,39,42,177
11431,United States,1988.0,89,67,58,214
11432,United States,1992.0,94,57,87,238
11433,United States,1988.0,89,67,58,214
11434,United States,1992.0,94,57,87,238
11435,United States,2004.0,117,75,71,263
11436,United States,2004.0,117,75,71,263
11437,United States,2008.0,127,110,80,317
11438,United States,2008.0,127,110,80,317
11439,United States,1972.0,72,77,46,195
11440,United States,1984.0,190,121,50,361
11441,United States,1984.0,190,121,50,361
11442,United States,1988.0,89,67,58,214
11443,United States,1988.0,89,67,58,214
11444,United States,1992.0,94,57,87,238
11445,United States,1992.0,94,57,87,238
11446,United States,1996.0,159,48,52,259
11447,United States,2000.0,130,61,51,242
11448,United States,2004.0,117,75,71,263
11449,United States,2004.0,117,75,71,263
11450,United States,2008.0,127,110,80,317
11451,Vesper Boat Club,1900.0,30,16,17,63
11452,United States,1904.0,128,141,125,394
11453,United States,1912.0,46,25,36,107
11454,United States,1912.0,46,25,36,107
11455,United States,1920.0,111,45,38,194
11456,United States,1920.0,111,45,38,194
11457,United States,1924.0,98,46,50,194
11458,United States,1924.0,98,46,50,194
11459,United States,2008.0,127,110,80,317
11460,United States,1992.0,94,57,87,238
11461,United States,1948.0,93,34,41,168
11462,United States,1932.0,91,68,64,223
11463,United States,1932.0,91,68,64,223
11464,United States,2016.0,139,54,71,264
11465,United States,2012.0,145,57,46,248
11466,United States,2012.0,145,57,46,248
11467,United States,2016.0,139,54,71,264
11468,United States,1936.0,53,29,30,112
11469,United States,2010.0,12,63,22,97
11470,United States,2004.0,117,75,71,263
11471,United States,2004.0,117,75,71,263
11472,United States,1928.0,53,30,19,102
11473,United States,2002.0,11,58,15,84
11474,United States,2006.0,9,11,32,52
11475,"Philadelphia Turngemeinde, Philadelphia",1904.0,128,141,125,394
11476,United States,2006.0,9,11,32,52
11477,United States,1952.0,87,48,29,164
11478,United States,1952.0,87,48,29,164
11479,United States,1920.0,111,45,38,194
11480,United States,1920.0,111,45,38,194
11481,United States,1920.0,111,45,38,194
11482,United States,1924.0,98,46,50,194
11483,United States,2010.0,12,63,22,97
11484,United States,2014.0,10,30,24,64
11485,United States,1976.0,73,61,41,175
11486,United States,1984.0,190,121,50,361
11487,Foxhunters Hurlingham,1900.0,30,16,17,63
11488,United States,2004.0,117,75,71,263
11489,United States,1920.0,111,45,38,194
11490,Chicago Athletic Association-2,1904.0,128,141,125,394
11491,United States,1904.0,128,141,125,394
11492,United States,1952.0,87,48,29,164
11493,United States,2000.0,130,61,51,242
11494,United States,2000.0,130,61,51,242
11495,United States,2004.0,117,75,71,263
11496,United States,2004.0,117,75,71,263
11497,United States,2008.0,127,110,80,317
11498,United States,1960.0,100,27,25,152
11499,United States,1952.0,87,48,29,164
11500,United States,1908.0,34,16,15,65
11501,United States,1912.0,46,25,36,107
11502,United States,2004.0,117,75,71,263
11503,United States,1920.0,111,45,38,194
11504,United States,1920.0,111,45,38,194
11505,United States,1956.0,63,61,25,149
11506,United States,1920.0,111,45,38,194
11507,United States,1920.0,111,45,38,194
11508,United States,1924.0,98,46,50,194
11509,United States,1992.0,94,57,87,238
11510,United States,1972.0,72,77,46,195
11511,United States,1960.0,100,27,25,152
11512,United States,2016.0,139,54,71,264
11513,United States,2002.0,11,58,15,84
11514,United States,2006.0,9,11,32,52
11515,United States,1924.0,98,46,50,194
11516,United States-1,1952.0,87,48,29,164
11517,United States-1,1952.0,87,48,29,164
11518,United States,1988.0,89,67,58,214
11519,United States,1952.0,87,48,29,164
11520,United States,2014.0,10,30,24,64
11521,United States,2006.0,9,11,32,52
11522,United States,1992.0,94,57,87,238
11523,United States,1906.0,12,6,6,24
11524,United States,1992.0,94,57,87,238
11525,United States,1994.0,6,8,5,19
11526,United States,2010.0,12,63,22,97
11527,United States,2014.0,10,30,24,64
11528,United States,2010.0,12,63,22,97
11529,United States-2,2012.0,145,57,46,248
11530,United States,2004.0,117,75,71,263
11531,United States,1964.0,96,39,42,177
11532,United States,2000.0,130,61,51,242
11533,United States,2008.0,127,110,80,317
11534,United States,1984.0,190,121,50,361
11535,United States,1936.0,53,29,30,112
11536,United States,1984.0,190,121,50,361
11537,United States,1932.0,91,68,64,223
11538,United States,1932.0,91,68,64,223
11539,United States,1932.0,91,68,64,223
11540,United States,1936.0,53,29,30,112
11541,United States,2002.0,11,58,15,84
11542,United States,2010.0,12,63,22,97
11543,United States,2010.0,12,63,22,97
11544,United States,1952.0,87,48,29,164
11545,United States,1984.0,190,121,50,361
11546,United States,1988.0,89,67,58,214
11547,United States,1928.0,53,30,19,102
11548,United States,1920.0,111,45,38,194
11549,United States,1904.0,128,141,125,394
11550,United States,1904.0,128,141,125,394
11551,United States,1968.0,100,37,36,173
11552,United States,1998.0,25,4,5,34
11553,United States,2002.0,11,58,15,84
11554,United States,2006.0,9,11,32,52
11555,United States,2006.0,9,11,32,52
11556,United States,1956.0,63,61,25,149
11557,United States,2016.0,139,54,71,264
11558,United States,2016.0,139,54,71,264
11559,United States,1972.0,72,77,46,195
11560,United States,1984.0,190,121,50,361
11561,United States,1988.0,89,67,58,214
11562,United States,1948.0,93,34,41,168
11563,United States,1924.0,98,46,50,194
11564,United States,2000.0,130,61,51,242
11565,United States,1968.0,100,37,36,173
11566,United States,1972.0,72,77,46,195
11567,United States,1924.0,98,46,50,194
11568,United States,2008.0,127,110,80,317
11569,United States,1984.0,190,121,50,361
11570,United States,1988.0,89,67,58,214
11571,United States-1,1996.0,159,48,52,259
11572,United States,1924.0,98,46,50,194
11573,United States,1904.0,128,141,125,394
11574,United States,1904.0,128,141,125,394
11575,United States,2004.0,117,75,71,263
11576,United States,1920.0,111,45,38,194
11577,United States,1920.0,111,45,38,194
11578,United States,1920.0,111,45,38,194
11579,United States,1964.0,96,39,42,177
11580,United States,1960.0,100,27,25,152
11581,United States,1924.0,98,46,50,194
11582,United States,1932.0,91,68,64,223
11583,United States,1912.0,46,25,36,107
11584,United States,1912.0,46,25,36,107
11585,United States,1988.0,89,67,58,214
11586,United States,1984.0,190,121,50,361
11587,United States,1992.0,94,57,87,238
11588,United States,1920.0,111,45,38,194
11589,United States,2002.0,11,58,15,84
11590,United States,1956.0,63,61,25,149
11591,United States,1932.0,91,68,64,223
11592,United States,1964.0,96,39,42,177
11593,United States,1984.0,190,121,50,361
11594,United States,2012.0,145,57,46,248
11595,United States,2008.0,127,110,80,317
11596,United States,2010.0,12,63,22,97
11597,United States,2014.0,10,30,24,64
11598,United States,1936.0,53,29,30,112
11599,United States,1976.0,73,61,41,175
11600,United States,1996.0,159,48,52,259
11601,United States,1956.0,63,61,25,149
11602,United States,2016.0,139,54,71,264
11603,United States,2016.0,139,54,71,264
11604,United States,2012.0,145,57,46,248
11605,United States-2,2002.0,11,58,15,84
11606,United States,1928.0,53,30,19,102
11607,United States,1928.0,53,30,19,102
11608,United States,1964.0,96,39,42,177
11609,United States,1968.0,100,37,36,173
11610,United States,1968.0,100,37,36,173
11611,United States,1920.0,111,45,38,194
11612,United States,1976.0,73,61,41,175
11613,United States,2004.0,117,75,71,263
11614,United States,2004.0,117,75,71,263
11615,United States,1984.0,190,121,50,361
11616,United States,1952.0,87,48,29,164
11617,United States,1952.0,87,48,29,164
11618,United States,1952.0,87,48,29,164
11619,United States,1956.0,63,61,25,149
11620,United States,1952.0,87,48,29,164
11621,United States,1956.0,63,61,25,149
11622,United States,1960.0,100,27,25,152
11623,United States,2008.0,127,110,80,317
11624,United States,1912.0,46,25,36,107
11625,United States,2004.0,117,75,71,263
11626,United States,1976.0,73,61,41,175
11627,United States,1988.0,89,67,58,214
11628,United States,1992.0,94,57,87,238
11629,United States,1988.0,89,67,58,214
11630,United States,1996.0,159,48,52,259
11631,United States,2014.0,10,30,24,64
11632,United States,2016.0,139,54,71,264
11633,United States,2000.0,130,61,51,242
11634,United States,2004.0,117,75,71,263
11635,United States,2004.0,117,75,71,263
11636,United States,1900.0,30,16,17,63
11637,United States,1900.0,30,16,17,63
11638,United States,1900.0,30,16,17,63
11639,United States,1900.0,30,16,17,63
11640,United States,1996.0,159,48,52,259
11641,United States,2000.0,130,61,51,242
11642,"Central Turnverein, Chicago",1904.0,128,141,125,394
11643,United States,1904.0,128,141,125,394
11644,United States,2008.0,127,110,80,317
11645,United States,2000.0,130,61,51,242
11646,United States,2000.0,130,61,51,242
11647,United States,2000.0,130,61,51,242
11648,United States,2004.0,117,75,71,263
11649,United States,1988.0,89,67,58,214
11650,United States,2004.0,117,75,71,263
11651,United States,2008.0,127,110,80,317
11652,United States,2000.0,130,61,51,242
11653,United States,1924.0,98,46,50,194
11654,United States,1988.0,89,67,58,214
11655,United States,2008.0,127,110,80,317
11656,United States,1968.0,100,37,36,173
11657,United States,1912.0,46,25,36,107
11658,United States,2016.0,139,54,71,264
11659,United States,1928.0,53,30,19,102
11660,United States,2010.0,12,63,22,97
11661,United States,1920.0,111,45,38,194
11662,United States,1932.0,91,68,64,223
11663,United States,1976.0,73,61,41,175
11664,United States,2004.0,117,75,71,263
11665,United States,2004.0,117,75,71,263
11666,United States,1948.0,93,34,41,168
11667,United States,1952.0,87,48,29,164
11668,United States,1988.0,89,67,58,214
11669,United States,1996.0,159,48,52,259
11670,United States,1932.0,91,68,64,223
11671,United States,1972.0,72,77,46,195
11672,United States,1998.0,25,4,5,34
11673,United States,2002.0,11,58,15,84
11674,United States,2012.0,145,57,46,248
11675,United States,1924.0,98,46,50,194
11676,United States,1936.0,53,29,30,112
11677,United States,1932.0,91,68,64,223
11678,United States,1996.0,159,48,52,259
11679,United States,1924.0,98,46,50,194
11680,United States,1924.0,98,46,50,194
11681,United States,1924.0,98,46,50,194
11682,United States,1992.0,94,57,87,238
11683,United States,1976.0,73,61,41,175
11684,United States,2010.0,12,63,22,97
11685,United States,1928.0,53,30,19,102
11686,United States,1996.0,159,48,52,259
11687,United States,1900.0,30,16,17,63
11688,United States,1928.0,53,30,19,102
11689,Trans-Mississippi Golf Association-2,1904.0,128,141,125,394
11690,United States,1956.0,63,61,25,149
11691,United States,1960.0,100,27,25,152
11692,United States,2008.0,127,110,80,317
11693,United States,2010.0,12,63,22,97
11694,United States,2014.0,10,30,24,64
11695,United States,2010.0,12,63,22,97
11696,United States,2014.0,10,30,24,64
11697,United States-1,1956.0,63,61,25,149
11698,United States,1920.0,111,45,38,194
11699,United States,1912.0,46,25,36,107
11700,United States,1912.0,46,25,36,107
11701,United States,1912.0,46,25,36,107
11702,United States,1920.0,111,45,38,194
11703,United States,1920.0,111,45,38,194
11704,United States,1920.0,111,45,38,194
11705,United States,1896.0,11,7,2,20
11706,United States,1960.0,100,27,25,152
11707,United States,1988.0,89,67,58,214
11708,United States,2010.0,12,63,22,97
11709,United States,1920.0,111,45,38,194
11710,United States,1924.0,98,46,50,194
11711,United States-1,2014.0,10,30,24,64
11712,United States-1,2014.0,10,30,24,64
11713,United States,2004.0,117,75,71,263
11714,United States,2008.0,127,110,80,317
11715,United States,1936.0,53,29,30,112
11716,United States,2008.0,127,110,80,317
11717,United States Golf Association-3,1904.0,128,141,125,394
11718,United States,1964.0,96,39,42,177
11719,United States,1964.0,96,39,42,177
11720,United States,1924.0,98,46,50,194
11721,United States,2012.0,145,57,46,248
11722,United States,1984.0,190,121,50,361
11723,United States,1960.0,100,27,25,152
11724,United States,1960.0,100,27,25,152
11725,United States,1984.0,190,121,50,361
11726,United States,2012.0,145,57,46,248
11727,United States,2016.0,139,54,71,264
11728,United States,1924.0,98,46,50,194
11729,United States,1928.0,53,30,19,102
11730,United States,1928.0,53,30,19,102
11731,United States,1936.0,53,29,30,112
11732,United States,1984.0,190,121,50,361
11733,United States,1992.0,94,57,87,238
11734,United States,1952.0,87,48,29,164
11735,United States,1992.0,94,57,87,238
11736,United States,2010.0,12,63,22,97
11737,Christian Brothers' College-1,1904.0,128,141,125,394
11738,United States-2,1936.0,53,29,30,112
11739,United States,1984.0,190,121,50,361
11740,United States,2012.0,145,57,46,248
11741,United States,2008.0,127,110,80,317
11742,United States,1936.0,53,29,30,112
11743,United States,1936.0,53,29,30,112
11744,United States,1952.0,87,48,29,164
11745,United States,1984.0,190,121,50,361
11746,United States,1952.0,87,48,29,164
11747,United States,1912.0,46,25,36,107
11748,United States,1904.0,128,141,125,394
11749,United States,1904.0,128,141,125,394
11750,United States,1984.0,190,121,50,361
11751,United States,1988.0,89,67,58,214
11752,United States,1906.0,12,6,6,24
11753,United States,2002.0,11,58,15,84
11754,United States,1924.0,98,46,50,194
11755,United States,1996.0,159,48,52,259
11756,United States,1992.0,94,57,87,238
11757,United States,2012.0,145,57,46,248
11758,United States,2016.0,139,54,71,264
11759,United States,2016.0,139,54,71,264
11760,United States,2016.0,139,54,71,264
11761,United States,2016.0,139,54,71,264
11762,United States,2016.0,139,54,71,264
11763,United States,2008.0,127,110,80,317
11764,United States,2016.0,139,54,71,264
11765,United States,1952.0,87,48,29,164
11766,United States,1948.0,93,34,41,168
11767,United States,1948.0,93,34,41,168
11768,United States,1952.0,87,48,29,164
11769,United States,1996.0,159,48,52,259
11770,United States,1920.0,111,45,38,194
11771,United States,1920.0,111,45,38,194
11772,United States,1920.0,111,45,38,194
11773,United States,1920.0,111,45,38,194
11774,United States,1920.0,111,45,38,194
11775,United States,1920.0,111,45,38,194
11776,United States,1920.0,111,45,38,194
11777,United States,1948.0,93,34,41,168
11778,United States,2002.0,11,58,15,84
11779,United States,1924.0,98,46,50,194
11780,United States,2008.0,127,110,80,317
11781,United States,1996.0,159,48,52,259
11782,United States,2000.0,130,61,51,242
11783,United States,1992.0,94,57,87,238
11784,United States,1996.0,159,48,52,259
11785,United States,1936.0,53,29,30,112
11786,United States,1904.0,128,141,125,394
11787,United States-1,1904.0,128,141,125,394
11788,United States,1976.0,73,61,41,175
11789,United States,1996.0,159,48,52,259
11790,United States,2012.0,145,57,46,248
11791,United States,2012.0,145,57,46,248
11792,United States,1904.0,128,141,125,394
11793,United States-2,1904.0,128,141,125,394
11794,United States,1996.0,159,48,52,259
11795,United States,2000.0,130,61,51,242
11796,United States,2004.0,117,75,71,263
11797,United States,2008.0,127,110,80,317
11798,United States,1996.0,159,48,52,259
11799,United States,1908.0,34,16,15,65
11800,United States,1912.0,46,25,36,107
11801,United States,1912.0,46,25,36,107
11802,United States,1912.0,46,25,36,107
11803,United States,2012.0,145,57,46,248
11804,United States,1932.0,91,68,64,223
11805,United States,1932.0,91,68,64,223
11806,United States,1984.0,190,121,50,361
11807,United States,2000.0,130,61,51,242
11808,United States,1984.0,190,121,50,361
11809,United States,1984.0,190,121,50,361
11810,United States,1984.0,190,121,50,361
11811,United States,1984.0,190,121,50,361
11812,United States,1988.0,89,67,58,214
11813,United States,1988.0,89,67,58,214
11814,United States,1988.0,89,67,58,214
11815,United States,1992.0,94,57,87,238
11816,United States,1992.0,94,57,87,238
11817,United States,1996.0,159,48,52,259
11818,United States,1976.0,73,61,41,175
11819,United States,1936.0,53,29,30,112
11820,United States,1984.0,190,121,50,361
11821,United States,1988.0,89,67,58,214
11822,United States,1988.0,89,67,58,214
11823,United States,1992.0,94,57,87,238
11824,United States,1992.0,94,57,87,238
11825,United States,2012.0,145,57,46,248
11826,United States,2016.0,139,54,71,264
11827,United States,2016.0,139,54,71,264
11828,United States,2000.0,130,61,51,242
11829,United States,2000.0,130,61,51,242
11830,United States,2004.0,117,75,71,263
11831,United States,2004.0,117,75,71,263
11832,United States,2008.0,127,110,80,317
11833,United States,2008.0,127,110,80,317
11834,United States,2008.0,127,110,80,317
11835,United States,2012.0,145,57,46,248
11836,Jupiter,1932.0,91,68,64,223
11837,United States,1912.0,46,25,36,107
11838,United States,1984.0,190,121,50,361
11839,United States,1924.0,98,46,50,194
11840,United States,1976.0,73,61,41,175
11841,United States,1952.0,87,48,29,164
11842,United States,2006.0,9,11,32,52
11843,United States,2014.0,10,30,24,64
11844,United States,1904.0,128,141,125,394
11845,United States,1904.0,128,141,125,394
11846,United States,1904.0,128,141,125,394
11847,Chicago Athletic Association,1904.0,128,141,125,394
11848,United States,1906.0,12,6,6,24
11849,United States,1906.0,12,6,6,24
11850,United States,2000.0,130,61,51,242
11851,United States,1996.0,159,48,52,259
11852,United States,2000.0,130,61,51,242
11853,United States,2004.0,117,75,71,263
11854,United States,1972.0,72,77,46,195
11855,United States,2008.0,127,110,80,317
11856,United States,2012.0,145,57,46,248
11857,United States,1976.0,73,61,41,175
11858,United States,1984.0,190,121,50,361
11859,United States,1912.0,46,25,36,107
11860,United States,1912.0,46,25,36,107
11861,United States,1964.0,96,39,42,177
11862,United States,1992.0,94,57,87,238
11863,United States,2000.0,130,61,51,242
11864,United States,1924.0,98,46,50,194
11865,United States,1972.0,72,77,46,195
11866,United States,1996.0,159,48,52,259
11867,United States,1996.0,159,48,52,259
11868,United States,1998.0,25,4,5,34
11869,United States,1912.0,46,25,36,107
11870,United States,1912.0,46,25,36,107
11871,United States,2008.0,127,110,80,317
11872,United States,2008.0,127,110,80,317
11873,United States,2008.0,127,110,80,317
11874,United States,2008.0,127,110,80,317
11875,United States,2008.0,127,110,80,317
11876,United States,1920.0,111,45,38,194
11877,United States,1932.0,91,68,64,223
11878,United States,1972.0,72,77,46,195
11879,United States,1972.0,72,77,46,195
11880,United States,1988.0,89,67,58,214
11881,United States,2008.0,127,110,80,317
11882,United States,2012.0,145,57,46,248
11883,United States,2016.0,139,54,71,264
11884,United States,1996.0,159,48,52,259
11885,United States,2004.0,117,75,71,263
11886,United States,2004.0,117,75,71,263
11887,United States,2008.0,127,110,80,317
11888,United States,2008.0,127,110,80,317
11889,United States,2008.0,127,110,80,317
11890,United States,2008.0,127,110,80,317
11891,United States,2012.0,145,57,46,248
11892,United States,2012.0,145,57,46,248
11893,United States,2012.0,145,57,46,248
11894,United States,2012.0,145,57,46,248
11895,United States,2012.0,145,57,46,248
11896,United States,2016.0,139,54,71,264
11897,Vesper Boat Club,1900.0,30,16,17,63
11898,United States,2010.0,12,63,22,97
11899,United States,2012.0,145,57,46,248
11900,United States,1912.0,46,25,36,107
11901,United States,2014.0,10,30,24,64
11902,United States,2008.0,127,110,80,317
11903,United States,2012.0,145,57,46,248
11904,United States,2016.0,139,54,71,264
11905,United States,1952.0,87,48,29,164
11906,United States,1960.0,100,27,25,152
11907,United States,1964.0,96,39,42,177
11908,United States,1900.0,30,16,17,63
11909,United States,1920.0,111,45,38,194
11910,Llanoria,1948.0,93,34,41,168
11911,United States,1998.0,25,4,5,34
11912,United States,2002.0,11,58,15,84
11913,United States,1996.0,159,48,52,259
11914,United States,2008.0,127,110,80,317
11915,United States,2008.0,127,110,80,317
11916,United States,2000.0,130,61,51,242
11917,United States,2004.0,117,75,71,263
11918,United States,2008.0,127,110,80,317
11919,United States,2000.0,130,61,51,242
11920,United States,2004.0,117,75,71,263
11921,United States,1984.0,190,121,50,361
11922,Vesper Boat Club,1904.0,128,141,125,394
11923,United States,1976.0,73,61,41,175
11924,United States,1984.0,190,121,50,361
11925,United States,1984.0,190,121,50,361
11926,United States,1988.0,89,67,58,214
11927,United States,1988.0,89,67,58,214
11928,United States,1924.0,98,46,50,194
11929,United States,1928.0,53,30,19,102
11930,United States-1,1932.0,91,68,64,223
11931,United States,2012.0,145,57,46,248
11932,United States,1992.0,94,57,87,238
11933,United States,1992.0,94,57,87,238
11934,United States,2004.0,117,75,71,263
11935,United States,1952.0,87,48,29,164
11936,United States,1952.0,87,48,29,164
11937,Kathleen,1956.0,63,61,25,149
11938,United States,2008.0,127,110,80,317
11939,United States,2016.0,139,54,71,264
11940,United States,2004.0,117,75,71,263
11941,United States,2000.0,130,61,51,242
11942,United States,2016.0,139,54,71,264
11943,United States,1996.0,159,48,52,259
11944,United States,1936.0,53,29,30,112
11945,United States,1984.0,190,121,50,361
11946,United States,1960.0,100,27,25,152
11947,United States-1,1960.0,100,27,25,152
11948,United States-1,1960.0,100,27,25,152
11949,United States,1964.0,96,39,42,177
11950,United States,1948.0,93,34,41,168
11951,United States,1984.0,190,121,50,361
11952,United States,1984.0,190,121,50,361
11953,United States,1936.0,53,29,30,112
11954,United States,1988.0,89,67,58,214
11955,Christian Brothers' College-1,1904.0,128,141,125,394
11956,United States,1904.0,128,141,125,394
11957,United States,1996.0,159,48,52,259
11958,United States,1972.0,72,77,46,195
11959,United States,1920.0,111,45,38,194
11960,United States,1964.0,96,39,42,177
11961,United States,1964.0,96,39,42,177
11962,United States,1924.0,98,46,50,194
11963,United States,2010.0,12,63,22,97
11964,United States,1948.0,93,34,41,168
11965,United States,1948.0,93,34,41,168
11966,United States,1924.0,98,46,50,194
11967,Frimousse,1900.0,30,16,17,63
11968,United States,1936.0,53,29,30,112
11969,United States,2004.0,117,75,71,263
11970,Foxhunters Hurlingham,1900.0,30,16,17,63
11971,United States,1948.0,93,34,41,168
11972,United States,1948.0,93,34,41,168
11973,United States,1996.0,159,48,52,259
11974,United States,2000.0,130,61,51,242
11975,United States,1932.0,91,68,64,223
11976,United States,2004.0,117,75,71,263
11977,United States,2008.0,127,110,80,317
11978,United States,2008.0,127,110,80,317
11979,United States,2016.0,139,54,71,264
11980,United States,1932.0,91,68,64,223
11981,United States,1932.0,91,68,64,223
11982,United States,1932.0,91,68,64,223
11983,United States,2012.0,145,57,46,248
11984,United States,2016.0,139,54,71,264
11985,United States,2016.0,139,54,71,264
11986,United States,1996.0,159,48,52,259
11987,United States,2004.0,117,75,71,263
11988,United States,1984.0,190,121,50,361
11989,United States,2008.0,127,110,80,317
11990,United States,2008.0,127,110,80,317
11991,Milwaukee Athletic Club-1,1904.0,128,141,125,394
11992,United States,1992.0,94,57,87,238
11993,United States,1968.0,100,37,36,173
11994,United States,1996.0,159,48,52,259
11995,United States,1980.0,24,4,2,30
11996,United States,1984.0,190,121,50,361
11997,United States,1984.0,190,121,50,361
11998,United States,1988.0,89,67,58,214
11999,United States,1996.0,159,48,52,259
12000,United States,2000.0,130,61,51,242
12001,United States,2012.0,145,57,46,248
12002,United States,2010.0,12,63,22,97
12003,United States,2014.0,10,30,24,64
12004,United States,1992.0,94,57,87,238
12005,United States,1996.0,159,48,52,259
12006,United States,1996.0,159,48,52,259
12007,United States,2010.0,12,63,22,97
12008,United States,2000.0,130,61,51,242
12009,United States,2012.0,145,57,46,248
12010,United States,2006.0,9,11,32,52
12011,United States,2010.0,12,63,22,97
12012,United States,2010.0,12,63,22,97
12013,United States,2014.0,10,30,24,64
12014,United States,1972.0,72,77,46,195
12015,United States,1956.0,63,61,25,149
12016,United States,1956.0,63,61,25,149
12017,United States,1964.0,96,39,42,177
12018,United States,1924.0,98,46,50,194
12019,United States,1988.0,89,67,58,214
12020,United States,1992.0,94,57,87,238
12021,United States,1968.0,100,37,36,173
12022,United States,1972.0,72,77,46,195
12023,United States,1952.0,87,48,29,164
12024,United States,2016.0,139,54,71,264
12025,United States,2016.0,139,54,71,264
12026,United States,2016.0,139,54,71,264
12027,United States,2016.0,139,54,71,264
12028,United States,2012.0,145,57,46,248
12029,United States,1968.0,100,37,36,173
12030,United States,2004.0,117,75,71,263
12031,United States,1984.0,190,121,50,361
12032,United States,1988.0,89,67,58,214
12033,United States,2016.0,139,54,71,264
12034,United States,1920.0,111,45,38,194
12035,United States,2004.0,117,75,71,263
12036,United States,1984.0,190,121,50,361
12037,United States,2012.0,145,57,46,248
12038,United States,2012.0,145,57,46,248
12039,United States,2016.0,139,54,71,264
12040,United States,1976.0,73,61,41,175
12041,Vesper Boat Club,1900.0,30,16,17,63
12042,United States,1992.0,94,57,87,238
12043,United States,1992.0,94,57,87,238
12044,United States,1996.0,159,48,52,259
12045,United States,1972.0,72,77,46,195
12046,United States,2008.0,127,110,80,317
12047,United States,1972.0,72,77,46,195
12048,United States,2010.0,12,63,22,97
12049,United States,2008.0,127,110,80,317
12050,United States,2012.0,145,57,46,248
12051,United States,1948.0,93,34,41,168
12052,United States-2,1998.0,25,4,5,34
12053,United States-2,2002.0,11,58,15,84
12054,United States,1992.0,94,57,87,238
12055,United States-2,1948.0,93,34,41,168
12056,United States-1,1952.0,87,48,29,164
12057,United States-1,1952.0,87,48,29,164
12058,United States,1912.0,46,25,36,107
12059,United States,1908.0,34,16,15,65
12060,United States,1984.0,190,121,50,361
12061,United States,1984.0,190,121,50,361
12062,United States,1992.0,94,57,87,238
12063,United States,1992.0,94,57,87,238
12064,United States,1996.0,159,48,52,259
12065,United States,1996.0,159,48,52,259
12066,United States,1996.0,159,48,52,259
12067,United States,1996.0,159,48,52,259
12068,United States,2010.0,12,63,22,97
12069,United States,2014.0,10,30,24,64
12070,United States,1956.0,63,61,25,149
12071,United States,1956.0,63,61,25,149
12072,United States-2,1928.0,53,30,19,102
12073,United States,1996.0,159,48,52,259
12074,United States,2016.0,139,54,71,264
12075,United States,2016.0,139,54,71,264
12076,United States,1976.0,73,61,41,175
12077,United States,1956.0,63,61,25,149
12078,United States,2012.0,145,57,46,248
12079,United States,2016.0,139,54,71,264
12080,United States,1948.0,93,34,41,168
12081,United States,1952.0,87,48,29,164
12082,United States,1952.0,87,48,29,164
12083,United States,1952.0,87,48,29,164
12084,United States,1964.0,96,39,42,177
12085,United States,1968.0,100,37,36,173
12086,United States-2,2016.0,139,54,71,264
12087,United States,1956.0,63,61,25,149
12088,United States,1968.0,100,37,36,173
12089,United States,1972.0,72,77,46,195
12090,United States,1996.0,159,48,52,259
12091,United States,1920.0,111,45,38,194
12092,Potomac Archers,1904.0,128,141,125,394
12093,Trans-Mississippi Golf Association-2,1904.0,128,141,125,394
12094,United States,1992.0,94,57,87,238
12095,United States,1976.0,73,61,41,175
12096,United States,1960.0,100,27,25,152
12097,United States-1,2004.0,117,75,71,263
12098,United States-1,2008.0,127,110,80,317
12099,United States-1,2012.0,145,57,46,248
12100,United States,1956.0,63,61,25,149
12101,United States,1960.0,100,27,25,152
12102,United States,1996.0,159,48,52,259
12103,United States,1904.0,128,141,125,394
12104,United States,1904.0,128,141,125,394
12105,"Central Turnverein, Chicago",1904.0,128,141,125,394
12106,United States,2002.0,11,58,15,84
12107,United States,1988.0,89,67,58,214
12108,United States,1932.0,91,68,64,223
12109,United States,1988.0,89,67,58,214
12110,"Central Turnverein, Chicago",1904.0,128,141,125,394
12111,United States,1996.0,159,48,52,259
12112,United States,1972.0,72,77,46,195
12113,United States,1972.0,72,77,46,195
12114,United States,1952.0,87,48,29,164
12115,United States,1964.0,96,39,42,177
12116,United States,1932.0,91,68,64,223
12117,United States,1960.0,100,27,25,152
12118,United States,1960.0,100,27,25,152
12119,United States,1924.0,98,46,50,194
12120,United States,1976.0,73,61,41,175
12121,United States,1952.0,87,48,29,164
12122,United States,1988.0,89,67,58,214
12123,United States,1992.0,94,57,87,238
12124,United States,1996.0,159,48,52,259
12125,United States,1980.0,24,4,2,30
12126,United States,2004.0,117,75,71,263
12127,United States,1960.0,100,27,25,152
12128,United States,1932.0,91,68,64,223
12129,United States,1988.0,89,67,58,214
12130,United States,1992.0,94,57,87,238
12131,United States,2004.0,117,75,71,263
12132,United States,1920.0,111,45,38,194
12133,United States,1984.0,190,121,50,361
12134,United States,1988.0,89,67,58,214
12135,United States,1920.0,111,45,38,194
12136,United States,1952.0,87,48,29,164
12137,United States,1952.0,87,48,29,164
12138,United States,1956.0,63,61,25,149
12139,United States,1956.0,63,61,25,149
12140,United States,2012.0,145,57,46,248
12141,United States,2016.0,139,54,71,264
12142,United States,2012.0,145,57,46,248
12143,United States,2016.0,139,54,71,264
12144,United States,1984.0,190,121,50,361
12145,United States,1900.0,30,16,17,63
12146,United States,1900.0,30,16,17,63
12147,United States,1996.0,159,48,52,259
12148,United States,2000.0,130,61,51,242
12149,"BLO Polo Club, Rugby",1900.0,30,16,17,63
12150,United States,2012.0,145,57,46,248
12151,United States,1984.0,190,121,50,361
12152,United States,1956.0,63,61,25,149
12153,United States,1952.0,87,48,29,164
12154,United States,1964.0,96,39,42,177
12155,United States,1968.0,100,37,36,173
12156,United States,2004.0,117,75,71,263
12157,United States,1984.0,190,121,50,361
12158,United States,1912.0,46,25,36,107
12159,United States,1912.0,46,25,36,107
12160,United States,1920.0,111,45,38,194
12161,United States,1912.0,46,25,36,107
12162,United States,1912.0,46,25,36,107
12163,United States,1984.0,190,121,50,361
12164,United States,1928.0,53,30,19,102
12165,United States,2000.0,130,61,51,242
12166,United States,2008.0,127,110,80,317
12167,United States,1972.0,72,77,46,195
12168,United States,1972.0,72,77,46,195
12169,United States,2004.0,117,75,71,263
12170,United States,2000.0,130,61,51,242
12171,United States,1988.0,89,67,58,214
12172,United States,1976.0,73,61,41,175
12173,United States,1984.0,190,121,50,361
12174,United States,1964.0,96,39,42,177
12175,United States,1984.0,190,121,50,361
12176,United States,1996.0,159,48,52,259
12177,United States,2012.0,145,57,46,248
12178,United States,1912.0,46,25,36,107
12179,United States,1920.0,111,45,38,194
12180,United States,1928.0,53,30,19,102
12181,United States,1972.0,72,77,46,195
12182,United States,1908.0,34,16,15,65
12183,United States,1912.0,46,25,36,107
12184,United States,1924.0,98,46,50,194
12185,United States,1964.0,96,39,42,177
12186,United States,1964.0,96,39,42,177
12187,United States,1964.0,96,39,42,177
12188,United States,2000.0,130,61,51,242
12189,United States,1928.0,53,30,19,102
12190,United States,1956.0,63,61,25,149
12191,United States,1994.0,6,8,5,19
12192,United States,1984.0,190,121,50,361
12193,United States,1984.0,190,121,50,361
12194,United States,1988.0,89,67,58,214
12195,United States,1936.0,53,29,30,112
12196,United States,1988.0,89,67,58,214
12197,United States,2000.0,130,61,51,242
12198,United States,1984.0,190,121,50,361
12199,United States,2000.0,130,61,51,242
12200,United States,1972.0,72,77,46,195
12201,United States,1972.0,72,77,46,195
12202,United States,1976.0,73,61,41,175
12203,United States,1968.0,100,37,36,173
12204,United States,1968.0,100,37,36,173
12205,United States,1928.0,53,30,19,102
12206,United States,1928.0,53,30,19,102
12207,United States,1932.0,91,68,64,223
12208,United States,1956.0,63,61,25,149
12209,United States,1956.0,63,61,25,149
12210,United States,1956.0,63,61,25,149
12211,United States,1960.0,100,27,25,152
12212,United States,1960.0,100,27,25,152
12213,United States,1988.0,89,67,58,214
12214,United States,1984.0,190,121,50,361
12215,United States,1988.0,89,67,58,214
12216,United States,1904.0,128,141,125,394
12217,Trans-Mississippi Golf Association-2,1904.0,128,141,125,394
12218,United States,1956.0,63,61,25,149
12219,Trans-Mississippi Golf Association-2,1904.0,128,141,125,394
12220,United States,1948.0,93,34,41,168
12221,United States,1948.0,93,34,41,168
12222,United States,1948.0,93,34,41,168
12223,United States,1952.0,87,48,29,164
12224,United States,2010.0,12,63,22,97
12225,United States,1988.0,89,67,58,214
12226,United States,1992.0,94,57,87,238
12227,United States,1900.0,30,16,17,63
12228,United States,2012.0,145,57,46,248
12229,United States,1904.0,128,141,125,394
12230,Ravenswood Boat Club-2,1904.0,128,141,125,394
12231,United States,2004.0,117,75,71,263
12232,United States,1960.0,100,27,25,152
12233,United States,1976.0,73,61,41,175
12234,United States,1952.0,87,48,29,164
12235,United States,1972.0,72,77,46,195
12236,United States,1936.0,53,29,30,112
12237,United States,1932.0,91,68,64,223
12238,Bingo,1964.0,96,39,42,177
12239,United States,1984.0,190,121,50,361
12240,United States,1984.0,190,121,50,361
12241,United States,1984.0,190,121,50,361
12242,United States,1928.0,53,30,19,102
12243,United States,1920.0,111,45,38,194
12244,United States-2,2004.0,117,75,71,263
12245,United States,2012.0,145,57,46,248
12246,United States,2012.0,145,57,46,248
12247,United States,2016.0,139,54,71,264
12248,United States,1960.0,100,27,25,152
12249,United States,1952.0,87,48,29,164
12250,United States,1952.0,87,48,29,164
12251,United States,1936.0,53,29,30,112
12252,United States,1984.0,190,121,50,361
12253,United States,1984.0,190,121,50,361
12254,United States,1984.0,190,121,50,361
12255,United States,1988.0,89,67,58,214
12256,United States,1988.0,89,67,58,214
12257,United States,1928.0,53,30,19,102
12258,United States,1936.0,53,29,30,112
12259,United States,1936.0,53,29,30,112
12260,United States,1936.0,53,29,30,112
12261,United States,1920.0,111,45,38,194
12262,United States,1904.0,128,141,125,394
12263,United States,1908.0,34,16,15,65
12264,United States,1932.0,91,68,64,223
12265,United States,2016.0,139,54,71,264
12266,United States,2016.0,139,54,71,264
12267,United States,1992.0,94,57,87,238
12268,United States,2016.0,139,54,71,264
12269,United States,1912.0,46,25,36,107
12270,Widgeon,1964.0,96,39,42,177
12271,United States,1972.0,72,77,46,195
12272,United States,1972.0,72,77,46,195
12273,United States,1972.0,72,77,46,195
12274,United States,2008.0,127,110,80,317
12275,United States,2004.0,117,75,71,263
12276,United States,2008.0,127,110,80,317
12277,Christian Brothers' College-1,1904.0,128,141,125,394
12278,United States,1984.0,190,121,50,361
12279,United States,1988.0,89,67,58,214
12280,United States,1956.0,63,61,25,149
12281,United States,1960.0,100,27,25,152
12282,United States,1912.0,46,25,36,107
12283,United States,1912.0,46,25,36,107
12284,United States,2008.0,127,110,80,317
12285,United States,2000.0,130,61,51,242
12286,United States,1948.0,93,34,41,168
12287,United States,1984.0,190,121,50,361
12288,United States,2012.0,145,57,46,248
12289,United States,2008.0,127,110,80,317
12290,United States,2008.0,127,110,80,317
12291,United States,2016.0,139,54,71,264
12292,United States,2016.0,139,54,71,264
12293,United States,1998.0,25,4,5,34
12294,United States,2002.0,11,58,15,84
12295,United States,1904.0,128,141,125,394
12296,United States,1904.0,128,141,125,394
12297,United States,1904.0,128,141,125,394
12298,United States,1904.0,128,141,125,394
12299,United States,1904.0,128,141,125,394
12300,United States-1,2010.0,12,63,22,97
12301,United States,1984.0,190,121,50,361
12302,United States,1932.0,91,68,64,223
12303,United States,1932.0,91,68,64,223
12304,United States,1936.0,53,29,30,112
12305,United States,1936.0,53,29,30,112
12306,United States,1964.0,96,39,42,177
12307,United States,1912.0,46,25,36,107
12308,United States,1968.0,100,37,36,173
12309,United States,1968.0,100,37,36,173
12310,United States,1968.0,100,37,36,173
12311,United States,1920.0,111,45,38,194
12312,United States,1932.0,91,68,64,223
12313,United States,1976.0,73,61,41,175
12314,United States-2,2010.0,12,63,22,97
12315,United States-1,2014.0,10,30,24,64
12316,Missouri Athletic Club-3,1904.0,128,141,125,394
12317,United States,1968.0,100,37,36,173
12318,United States,1904.0,128,141,125,394
12319,United States,1972.0,72,77,46,195
12320,United States,2004.0,117,75,71,263
12321,United States,2008.0,127,110,80,317
12322,United States,2000.0,130,61,51,242
12323,United States,1996.0,159,48,52,259
12324,United States,2000.0,130,61,51,242
12325,United States,1972.0,72,77,46,195
12326,United States,2008.0,127,110,80,317
12327,United States,1992.0,94,57,87,238
12328,United States,1996.0,159,48,52,259
12329,United States,2000.0,130,61,51,242
12330,United States,2008.0,127,110,80,317
12331,United States,1936.0,53,29,30,112
12332,United States,2002.0,11,58,15,84
12333,United States,1984.0,190,121,50,361
12334,United States,1932.0,91,68,64,223
12335,United States,1928.0,53,30,19,102
12336,United States,1932.0,91,68,64,223
12337,United States,1952.0,87,48,29,164
12338,United States,2002.0,11,58,15,84
12339,United States,2002.0,11,58,15,84
12340,United States,2010.0,12,63,22,97
12341,United States,2010.0,12,63,22,97
12342,United States,2010.0,12,63,22,97
12343,United States,2014.0,10,30,24,64
12344,United States,1984.0,190,121,50,361
12345,United States,2004.0,117,75,71,263
12346,United States,2016.0,139,54,71,264
12347,United States,2016.0,139,54,71,264
12348,United States,1996.0,159,48,52,259
12349,United States,1924.0,98,46,50,194
12350,United States,2008.0,127,110,80,317
12351,United States,1996.0,159,48,52,259
12352,United States,1932.0,91,68,64,223
12353,United States,2010.0,12,63,22,97
12354,United States,1992.0,94,57,87,238
12355,United States,1992.0,94,57,87,238
12356,United States,1992.0,94,57,87,238
12357,United States,1992.0,94,57,87,238
12358,United States,1992.0,94,57,87,238
12359,United States,1996.0,159,48,52,259
12360,United States,1996.0,159,48,52,259
12361,United States,1996.0,159,48,52,259
12362,United States-1,1976.0,73,61,41,175
12363,United States,1964.0,96,39,42,177
12364,United States,1996.0,159,48,52,259
12365,United States,1988.0,89,67,58,214
12366,United States,1968.0,100,37,36,173
12367,United States,1968.0,100,37,36,173
12368,United States,1984.0,190,121,50,361
12369,United States,2000.0,130,61,51,242
12370,United States,2008.0,127,110,80,317
12371,United States-2,1932.0,91,68,64,223
12372,United States,2004.0,117,75,71,263
12373,United States,1904.0,128,141,125,394
12374,United States,1984.0,190,121,50,361
12375,United States,1984.0,190,121,50,361
12376,United States,1988.0,89,67,58,214
12377,United States,1992.0,94,57,87,238
12378,United States,1992.0,94,57,87,238
12379,United States,1996.0,159,48,52,259
12380,United States,1924.0,98,46,50,194
12381,United States,1924.0,98,46,50,194
12382,United States,1960.0,100,27,25,152
12383,United States,1964.0,96,39,42,177
12384,United States,2012.0,145,57,46,248
12385,United States,1984.0,190,121,50,361
12386,United States,1988.0,89,67,58,214
12387,United States,1964.0,96,39,42,177
12388,United States,2004.0,117,75,71,263
12389,United States,2008.0,127,110,80,317
12390,United States,2012.0,145,57,46,248
12391,United States,2012.0,145,57,46,248
12392,United States,1998.0,25,4,5,34
12393,United States,2002.0,11,58,15,84
12394,United States,1996.0,159,48,52,259
12395,United States,1936.0,53,29,30,112
12396,United States,2002.0,11,58,15,84
12397,United States,1994.0,6,8,5,19
12398,United States,1994.0,6,8,5,19
12399,United States,1972.0,72,77,46,195
12400,United States,2004.0,117,75,71,263
12401,United States,1936.0,53,29,30,112
12402,United States,1900.0,30,16,17,63
12403,United States,1988.0,89,67,58,214
12404,United States,1992.0,94,57,87,238
12405,United States,1912.0,46,25,36,107
12406,United States,1920.0,111,45,38,194
12407,United States,1976.0,73,61,41,175
12408,United States,1976.0,73,61,41,175
12409,United States,1976.0,73,61,41,175
12410,United States,1976.0,73,61,41,175
12411,United States,1996.0,159,48,52,259
12412,United States,2000.0,130,61,51,242
12413,United States,2000.0,130,61,51,242
12414,United States,2004.0,117,75,71,263
12415,United States,1936.0,53,29,30,112
12416,United States,1976.0,73,61,41,175
12417,Llanoria,1948.0,93,34,41,168
12418,United States,1932.0,91,68,64,223
12419,United States,1952.0,87,48,29,164
12420,United States,1952.0,87,48,29,164
12421,United States,1920.0,111,45,38,194
12422,United States,1948.0,93,34,41,168
12423,United States,1964.0,96,39,42,177
12424,United States,2012.0,145,57,46,248
12425,United States,2016.0,139,54,71,264
12426,Western Golf Association-1,1904.0,128,141,125,394
12427,Angelita,1932.0,91,68,64,223
12428,United States,1952.0,87,48,29,164
12429,United States,1984.0,190,121,50,361
12430,United States,1984.0,190,121,50,361
12431,United States,1984.0,190,121,50,361
12432,United States,1992.0,94,57,87,238
12433,United States,1992.0,94,57,87,238
12434,United States,1952.0,87,48,29,164
12435,United States,2008.0,127,110,80,317
12436,United States,1984.0,190,121,50,361
12437,United States,1956.0,63,61,25,149
12438,Angelita,1932.0,91,68,64,223
12439,United States,2012.0,145,57,46,248
12440,United States,1948.0,93,34,41,168
12441,Llanoria,1952.0,87,48,29,164
12442,United States,1976.0,73,61,41,175
12443,United States,1964.0,96,39,42,177
12444,United States,1960.0,100,27,25,152
12445,United States,1936.0,53,29,30,112
12446,United States,1992.0,94,57,87,238
12447,United States,1936.0,53,29,30,112
12448,United States,1960.0,100,27,25,152
12449,United States,2016.0,139,54,71,264
12450,United States,1996.0,159,48,52,259
12451,United States,1928.0,53,30,19,102
12452,United States,2000.0,130,61,51,242
12453,United States,2004.0,117,75,71,263
12454,United States,1956.0,63,61,25,149
12455,United States,1956.0,63,61,25,149
12456,United States,1956.0,63,61,25,149
12457,United States,1980.0,24,4,2,30
12458,United States,1988.0,89,67,58,214
12459,United States,1920.0,111,45,38,194
12460,United States,1998.0,25,4,5,34
12461,United States,2000.0,130,61,51,242
12462,United States,2000.0,130,61,51,242
12463,United States,1976.0,73,61,41,175
12464,United States,1984.0,190,121,50,361
12465,United States,1988.0,89,67,58,214
12466,United States,2008.0,127,110,80,317
12467,United States,1988.0,89,67,58,214
12468,United States,1904.0,128,141,125,394
12469,United States,1906.0,12,6,6,24
12470,United States,1998.0,25,4,5,34
12471,United States,2002.0,11,58,15,84
12472,United States,2000.0,130,61,51,242
12473,United States,1998.0,25,4,5,34
12474,United States,1984.0,190,121,50,361
12475,United States,1996.0,159,48,52,259
12476,United States,1976.0,73,61,41,175
12477,United States,2016.0,139,54,71,264
12478,United States,2016.0,139,54,71,264
12479,Atalanta Boat Club-1,1904.0,128,141,125,394
12480,Atalanta Boat Club-2,1904.0,128,141,125,394
12481,United States,1920.0,111,45,38,194
12482,United States,1952.0,87,48,29,164
12483,United States,1984.0,190,121,50,361
12484,United States,1920.0,111,45,38,194
12485,United States,1960.0,100,27,25,152
12486,United States,1984.0,190,121,50,361
12487,United States,1992.0,94,57,87,238
12488,United States,2000.0,130,61,51,242
12489,United States,1964.0,96,39,42,177
12490,United States,2004.0,117,75,71,263
12491,New York Athletic Club,1904.0,128,141,125,394
12492,United States,2000.0,130,61,51,242
12493,United States,2000.0,130,61,51,242
12494,United States,2004.0,117,75,71,263
12495,United States,1956.0,63,61,25,149
12496,United States,1920.0,111,45,38,194
12497,United States,1924.0,98,46,50,194
12498,United States,1976.0,73,61,41,175
12499,United States,2016.0,139,54,71,264
12500,United States,1952.0,87,48,29,164
12501,United States,1932.0,91,68,64,223
12502,United States,1912.0,46,25,36,107
12503,United States,1972.0,72,77,46,195
12504,United States,1972.0,72,77,46,195
12505,United States,2016.0,139,54,71,264
12506,United States,2016.0,139,54,71,264
12507,United States,2016.0,139,54,71,264
12508,United States,2016.0,139,54,71,264
12509,United States,2000.0,130,61,51,242
12510,St. Louis Amateur Athletic Association,1904.0,128,141,125,394
12511,United States,1920.0,111,45,38,194
12512,United States,2012.0,145,57,46,248
12513,United States,2016.0,139,54,71,264
12514,United States,2016.0,139,54,71,264
12515,United States,1920.0,111,45,38,194
12516,United States,1920.0,111,45,38,194
12517,United States,1928.0,53,30,19,102
12518,United States,1932.0,91,68,64,223
12519,United States,1952.0,87,48,29,164
12520,United States,1956.0,63,61,25,149
12521,United States,1960.0,100,27,25,152
12522,United States,1960.0,100,27,25,152
12523,United States,1984.0,190,121,50,361
12524,United States,1988.0,89,67,58,214
12525,United States,1976.0,73,61,41,175
12526,United States,1976.0,73,61,41,175
12527,United States,1976.0,73,61,41,175
12528,United States,1976.0,73,61,41,175
12529,United States,1976.0,73,61,41,175
12530,United States,2016.0,139,54,71,264
12531,United States,1992.0,94,57,87,238
12532,United States,1992.0,94,57,87,238
12533,United States,1992.0,94,57,87,238
12534,United States,1992.0,94,57,87,238
12535,United States,1996.0,159,48,52,259
12536,United States,2000.0,130,61,51,242
12537,United States,1960.0,100,27,25,152
12538,United States,1964.0,96,39,42,177
12539,United States,1972.0,72,77,46,195
12540,Century Boat Club-1,1904.0,128,141,125,394
12541,United States,2008.0,127,110,80,317
12542,United States,2012.0,145,57,46,248
12543,United States,2016.0,139,54,71,264
12544,United States,2000.0,130,61,51,242
12545,United States,1972.0,72,77,46,195
12546,United States,1972.0,72,77,46,195
12547,United States,1972.0,72,77,46,195
12548,United States,2012.0,145,57,46,248
12549,United States,2000.0,130,61,51,242
12550,United States,2004.0,117,75,71,263
12551,United States,1976.0,73,61,41,175
12552,United States,1912.0,46,25,36,107
12553,United States,1964.0,96,39,42,177
12554,United States,1968.0,100,37,36,173
12555,United States,1968.0,100,37,36,173
12556,United States,2004.0,117,75,71,263
12557,United States,1904.0,128,141,125,394
12558,United States,1932.0,91,68,64,223
12559,United States,1932.0,91,68,64,223
12560,United States,2004.0,117,75,71,263
12561,United States,1968.0,100,37,36,173
12562,United States,2016.0,139,54,71,264
12563,United States,2008.0,127,110,80,317
12564,United States,2008.0,127,110,80,317
12565,United States,1976.0,73,61,41,175
12566,United States,1976.0,73,61,41,175
12567,United States,1904.0,128,141,125,394
12568,United States,1904.0,128,141,125,394
12569,New York Athletic Club,1904.0,128,141,125,394
12570,United States,1924.0,98,46,50,194
12571,United States,1904.0,128,141,125,394
12572,Trans-Mississippi Golf Association-2,1904.0,128,141,125,394
12573,United States,1956.0,63,61,25,149
12574,United States,1960.0,100,27,25,152
12575,United States,1904.0,128,141,125,394
12576,United States,1984.0,190,121,50,361
12577,United States,1984.0,190,121,50,361
12578,United States,2008.0,127,110,80,317
12579,United States,1984.0,190,121,50,361
12580,United States,2008.0,127,110,80,317
12581,United States,1952.0,87,48,29,164
12582,United States,1984.0,190,121,50,361
12583,United States,1924.0,98,46,50,194
12584,United States,1988.0,89,67,58,214
12585,United States,1984.0,190,121,50,361
12586,United States,1924.0,98,46,50,194
12587,United States,1928.0,53,30,19,102
12588,United States,1928.0,53,30,19,102
12589,Aphrodite,1964.0,96,39,42,177
12590,United States,1968.0,100,37,36,173
12591,United States,1972.0,72,77,46,195
12592,United States,1976.0,73,61,41,175
12593,United States,1924.0,98,46,50,194
12594,United States,1920.0,111,45,38,194
12595,United States,1924.0,98,46,50,194
12596,United States,1992.0,94,57,87,238
12597,United States,1996.0,159,48,52,259
12598,United States,2000.0,130,61,51,242
12599,United States,2000.0,130,61,51,242
12600,United States,1920.0,111,45,38,194
12601,United States,1920.0,111,45,38,194
12602,United States,1920.0,111,45,38,194
12603,United States,1920.0,111,45,38,194
12604,United States,1920.0,111,45,38,194
12605,United States,1968.0,100,37,36,173
12606,United States,2000.0,130,61,51,242
12607,United States,2004.0,117,75,71,263
12608,United States,2008.0,127,110,80,317
12609,United States,1948.0,93,34,41,168
12610,United States,2008.0,127,110,80,317
12611,United States,1996.0,159,48,52,259
12612,United States,1936.0,53,29,30,112
12613,United States-1,1928.0,53,30,19,102
12614,United States-1,1932.0,91,68,64,223
12615,United States,1932.0,91,68,64,223
12616,United States,1984.0,190,121,50,361
12617,United States,1952.0,87,48,29,164
12618,United States,1956.0,63,61,25,149
12619,United States,1960.0,100,27,25,152
12620,United States,1996.0,159,48,52,259
12621,United States,2000.0,130,61,51,242
12622,United States,2004.0,117,75,71,263
12623,United States,1924.0,98,46,50,194
12624,United States,1980.0,24,4,2,30
12625,St. Rose-2,1904.0,128,141,125,394
12626,United States-1,1976.0,73,61,41,175
12627,United States,1996.0,159,48,52,259
12628,United States,2000.0,130,61,51,242
12629,United States,2000.0,130,61,51,242
12630,United States,1976.0,73,61,41,175
12631,United States,1924.0,98,46,50,194
12632,United States,1924.0,98,46,50,194
12633,United States,1932.0,91,68,64,223
12634,United States,1904.0,128,141,125,394
12635,United States,2012.0,145,57,46,248
12636,United States,1988.0,89,67,58,214
12637,Minotaur,1960.0,100,27,25,152
12638,United States,1992.0,94,57,87,238
12639,United States,1992.0,94,57,87,238
12640,United States,2004.0,117,75,71,263
12641,United States,1956.0,63,61,25,149
12642,United States,1960.0,100,27,25,152
12643,United States,1964.0,96,39,42,177
12644,United States,1968.0,100,37,36,173
12645,United States,2004.0,117,75,71,263
12646,United States,2012.0,145,57,46,248
12647,United States,2002.0,11,58,15,84
12648,United States,2002.0,11,58,15,84
12649,United States,2006.0,9,11,32,52
12650,United States,2006.0,9,11,32,52
12651,United States,2006.0,9,11,32,52
12652,United States,2010.0,12,63,22,97
12653,United States,2010.0,12,63,22,97
12654,United States,2010.0,12,63,22,97
12655,United States,1996.0,159,48,52,259
12656,United States,2004.0,117,75,71,263
12657,United States,1992.0,94,57,87,238
12658,United States,2016.0,139,54,71,264
12659,United States,1996.0,159,48,52,259
12660,United States,1972.0,72,77,46,195
12661,United States,2008.0,127,110,80,317
12662,United States Golf Association-3,1904.0,128,141,125,394
12663,United States,1992.0,94,57,87,238
12664,United States,1992.0,94,57,87,238
12665,United States,1992.0,94,57,87,238
12666,United States,1996.0,159,48,52,259
12667,United States,1996.0,159,48,52,259
12668,United States-1,2010.0,12,63,22,97
12669,United States,1948.0,93,34,41,168
12670,United States,1952.0,87,48,29,164
12671,Milwaukee Athletic Club-1,1904.0,128,141,125,394
12672,United States,1956.0,63,61,25,149
12673,United States,1960.0,100,27,25,152
12674,United States,1996.0,159,48,52,259
12675,United States,1920.0,111,45,38,194
12676,United States,1924.0,98,46,50,194
12677,United States-1,1988.0,89,67,58,214
12678,United States,1988.0,89,67,58,214
12679,United States,2004.0,117,75,71,263
12680,United States,2008.0,127,110,80,317
12681,United States,2012.0,145,57,46,248
12682,United States,2010.0,12,63,22,97
12683,United States,1992.0,94,57,87,238
12684,Missouri Athletic Club-3,1904.0,128,141,125,394
12685,Missouri Athletic Club-3,1904.0,128,141,125,394
12686,United States,2000.0,130,61,51,242
12687,United States,1984.0,190,121,50,361
12688,United States,1968.0,100,37,36,173
12689,United States,1924.0,98,46,50,194
12690,United States,1924.0,98,46,50,194
12691,United States,1912.0,46,25,36,107
12692,United States,1912.0,46,25,36,107
12693,United States,1912.0,46,25,36,107
12694,United States,1912.0,46,25,36,107
12695,United States,1920.0,111,45,38,194
12696,United States,1920.0,111,45,38,194
12697,United States,1920.0,111,45,38,194
12698,United States,1920.0,111,45,38,194
12699,United States,1920.0,111,45,38,194
12700,United States,1920.0,111,45,38,194
12701,United States,1924.0,98,46,50,194
12702,United States,1932.0,91,68,64,223
12703,United States,1928.0,53,30,19,102
12704,United States,1928.0,53,30,19,102
12705,United States,1952.0,87,48,29,164
12706,United States,2004.0,117,75,71,263
12707,United States,2008.0,127,110,80,317
12708,United States,1904.0,128,141,125,394
12709,United States,1904.0,128,141,125,394
12710,United States,2000.0,130,61,51,242
12711,United States,2000.0,130,61,51,242
12712,United States,1996.0,159,48,52,259
12713,United States,1960.0,100,27,25,152
12714,United States,1936.0,53,29,30,112
12715,United States,1936.0,53,29,30,112
12716,United States,1936.0,53,29,30,112
12717,United States,1936.0,53,29,30,112
12718,United States,1952.0,87,48,29,164
12719,United States,1960.0,100,27,25,152
12720,United States-2,2010.0,12,63,22,97
12721,United States,1976.0,73,61,41,175
12722,United States,1984.0,190,121,50,361
12723,United States,1988.0,89,67,58,214
12724,United States,2002.0,11,58,15,84
12725,United States,1920.0,111,45,38,194
12726,United States,1920.0,111,45,38,194
12727,United States,1920.0,111,45,38,194
12728,United States,1924.0,98,46,50,194
12729,United States,1984.0,190,121,50,361
12730,United States,1964.0,96,39,42,177
12731,United States,1968.0,100,37,36,173
12732,United States,1968.0,100,37,36,173
12733,United States,2016.0,139,54,71,264
12734,United States,1896.0,11,7,2,20
12735,United States,1896.0,11,7,2,20
12736,United States,1896.0,11,7,2,20
12737,United States,1960.0,100,27,25,152
12738,United States,1932.0,91,68,64,223
12739,United States,1988.0,89,67,58,214
12740,United States,2010.0,12,63,22,97
12741,United States-2,1928.0,53,30,19,102
12742,United States,2008.0,127,110,80,317
12743,United States,2012.0,145,57,46,248
12744,United States,1988.0,89,67,58,214
12745,United States,1936.0,53,29,30,112
12746,United States,1972.0,72,77,46,195
12747,Shrew II,1960.0,100,27,25,152
12748,United States,1976.0,73,61,41,175
12749,United States,1996.0,159,48,52,259
12750,United States,2000.0,130,61,51,242
12751,United States,2004.0,117,75,71,263
12752,United States,1996.0,159,48,52,259
12753,United States,2002.0,11,58,15,84
12754,United States,2002.0,11,58,15,84
12755,United States,2002.0,11,58,15,84
12756,United States,2006.0,9,11,32,52
12757,United States,1988.0,89,67,58,214
12758,United States,1992.0,94,57,87,238
12759,St. Louis Amateur Athletic Association,1904.0,128,141,125,394
12760,St. Louis Amateur Athletic Association,1904.0,128,141,125,394
12761,St. Louis Amateur Athletic Association,1904.0,128,141,125,394
12762,United States,1920.0,111,45,38,194
12763,United States,1924.0,98,46,50,194
12764,United States,2004.0,117,75,71,263
12765,United States,2004.0,117,75,71,263
12766,United States,2004.0,117,75,71,263
12767,United States,1952.0,87,48,29,164
12768,United States,1948.0,93,34,41,168
12769,United States,2004.0,117,75,71,263
12770,United States,1948.0,93,34,41,168
12771,United States,1948.0,93,34,41,168
12772,United States,1988.0,89,67,58,214
12773,United States,2008.0,127,110,80,317
12774,United States,2012.0,145,57,46,248
12775,United States,1996.0,159,48,52,259
12776,United States,1980.0,24,4,2,30
12777,United States,2010.0,12,63,22,97
12778,United States,2008.0,127,110,80,317
12779,United States,2000.0,130,61,51,242
12780,United States,1920.0,111,45,38,194
12781,United States,1996.0,159,48,52,259
12782,United States,2000.0,130,61,51,242
12783,United States,1932.0,91,68,64,223
12784,United States,2000.0,130,61,51,242
12785,United States,2004.0,117,75,71,263
12786,United States,2008.0,127,110,80,317
12787,United States,2012.0,145,57,46,248
12788,United States,1920.0,111,45,38,194
12789,United States,1996.0,159,48,52,259
12790,United States,1968.0,100,37,36,173
12791,United States,1968.0,100,37,36,173
12792,United States,1968.0,100,37,36,173
12793,United States,1968.0,100,37,36,173
12794,United States,1996.0,159,48,52,259
12795,United States,2004.0,117,75,71,263
12796,United States,2000.0,130,61,51,242
12797,United States,2004.0,117,75,71,263
12798,United States,2004.0,117,75,71,263
12799,United States,2004.0,117,75,71,263
12800,United States,2008.0,127,110,80,317
12801,United States,2008.0,127,110,80,317
12802,United States,2008.0,127,110,80,317
12803,United States,1968.0,100,37,36,173
12804,United States,1920.0,111,45,38,194
12805,United States,1984.0,190,121,50,361
12806,United States,2012.0,145,57,46,248
12807,United States,1948.0,93,34,41,168
12808,United States,1984.0,190,121,50,361
12809,United States,1964.0,96,39,42,177
12810,United States,2000.0,130,61,51,242
12811,United States,2016.0,139,54,71,264
12812,United States,1988.0,89,67,58,214
12813,United States,1964.0,96,39,42,177
12814,United States,2008.0,127,110,80,317
12815,United States,1996.0,159,48,52,259
12816,United States,2016.0,139,54,71,264
12817,United States,1992.0,94,57,87,238
12818,United States,1994.0,6,8,5,19
12819,United States,1994.0,6,8,5,19
12820,United States,1968.0,100,37,36,173
12821,United States,1972.0,72,77,46,195
12822,United States,1976.0,73,61,41,175
12823,United States,2010.0,12,63,22,97
12824,United States,1972.0,72,77,46,195
12825,United States,1976.0,73,61,41,175
12826,United States,2000.0,130,61,51,242
12827,United States,2004.0,117,75,71,263
12828,United States,2008.0,127,110,80,317
12829,United States,2012.0,145,57,46,248
12830,United States,1956.0,63,61,25,149
12831,United States,1972.0,72,77,46,195
12832,United States,1976.0,73,61,41,175
12833,United States,1996.0,159,48,52,259
12834,United States,1996.0,159,48,52,259
12835,Western Golf Association-1,1904.0,128,141,125,394
12836,United States,2004.0,117,75,71,263
12837,United States,2004.0,117,75,71,263
12838,United States,2004.0,117,75,71,263
12839,United States,2004.0,117,75,71,263
12840,United States,2004.0,117,75,71,263
12841,United States,2004.0,117,75,71,263
12842,United States,2004.0,117,75,71,263
12843,United States,2004.0,117,75,71,263
12844,United States,2008.0,127,110,80,317
12845,United States,2008.0,127,110,80,317
12846,United States,2008.0,127,110,80,317
12847,United States,2008.0,127,110,80,317
12848,United States,2008.0,127,110,80,317
12849,United States,2008.0,127,110,80,317
12850,United States,2008.0,127,110,80,317
12851,United States,2008.0,127,110,80,317
12852,United States,2012.0,145,57,46,248
12853,United States,2012.0,145,57,46,248
12854,United States,2012.0,145,57,46,248
12855,United States,2012.0,145,57,46,248
12856,United States,2012.0,145,57,46,248
12857,United States,2012.0,145,57,46,248
12858,United States,2016.0,139,54,71,264
12859,United States,2016.0,139,54,71,264
12860,United States,2016.0,139,54,71,264
12861,United States,2016.0,139,54,71,264
12862,United States,2016.0,139,54,71,264
12863,United States,2016.0,139,54,71,264
12864,United States,2000.0,130,61,51,242
12865,United States,1988.0,89,67,58,214
12866,United States,2004.0,117,75,71,263
12867,United States,1984.0,190,121,50,361
12868,United States,1964.0,96,39,42,177
12869,United States,2014.0,10,30,24,64
12870,United States,1992.0,94,57,87,238
12871,United States,2016.0,139,54,71,264
12872,United States,1912.0,46,25,36,107
12873,United States,2014.0,10,30,24,64
12874,New York Athletic Club,1904.0,128,141,125,394
12875,United States,1906.0,12,6,6,24
12876,United States,1906.0,12,6,6,24
12877,United States,1956.0,63,61,25,149
12878,United States,1920.0,111,45,38,194
12879,United States,1920.0,111,45,38,194
12880,United States,1924.0,98,46,50,194
12881,United States,1924.0,98,46,50,194
12882,United States,2004.0,117,75,71,263
12883,United States,1936.0,53,29,30,112
12884,United States,1992.0,94,57,87,238
12885,United States,1996.0,159,48,52,259
12886,United States,1952.0,87,48,29,164
12887,Margaret,1948.0,93,34,41,168
12888,United States,1960.0,100,27,25,152
12889,United States,1960.0,100,27,25,152
12890,United States,1964.0,96,39,42,177
12891,United States,1948.0,93,34,41,168
12892,United States,1984.0,190,121,50,361
12893,United States,1924.0,98,46,50,194
12894,United States,1964.0,96,39,42,177
12895,United States,1968.0,100,37,36,173
12896,United States,1972.0,72,77,46,195
12897,United States,1976.0,73,61,41,175
12898,United States,1976.0,73,61,41,175
12899,United States,1984.0,190,121,50,361
12900,United States,2016.0,139,54,71,264
12901,United States,2016.0,139,54,71,264
12902,United States,1904.0,128,141,125,394
12903,United States,1904.0,128,141,125,394
12904,United States,2016.0,139,54,71,264
12905,United States,1936.0,53,29,30,112
12906,United States,1904.0,128,141,125,394
12907,United States,1904.0,128,141,125,394
12908,Cincinnati Archers,1904.0,128,141,125,394
12909,United States,2006.0,9,11,32,52
12910,United States,2008.0,127,110,80,317
12911,United States,1964.0,96,39,42,177
12912,United States,1920.0,111,45,38,194
12913,United States,1932.0,91,68,64,223
12914,United States,1948.0,93,34,41,168
12915,United States,1908.0,34,16,15,65
12916,United States,2016.0,139,54,71,264
12917,United States,2002.0,11,58,15,84
12918,Trans-Mississippi Golf Association-2,1904.0,128,141,125,394
12919,United States,1976.0,73,61,41,175
12920,United States,1992.0,94,57,87,238
12921,United States,1976.0,73,61,41,175
12922,United States,1980.0,24,4,2,30
12923,United States,1980.0,24,4,2,30
12924,United States,1976.0,73,61,41,175
12925,United States,1984.0,190,121,50,361
12926,United States,1988.0,89,67,58,214
12927,United States,1992.0,94,57,87,238
12928,United States,2008.0,127,110,80,317
12929,United States,1984.0,190,121,50,361
12930,United States,1998.0,25,4,5,34
12931,United States,2002.0,11,58,15,84
12932,United States,1928.0,53,30,19,102
12933,United States,1932.0,91,68,64,223
12934,United States,1936.0,53,29,30,112
12935,United States,1936.0,53,29,30,112
12936,United States,1900.0,30,16,17,63
12937,United States,2016.0,139,54,71,264
12938,Comanche,1952.0,87,48,29,164
12939,United States Golf Association-3,1904.0,128,141,125,394
12940,United States,1952.0,87,48,29,164
12941,United States,2008.0,127,110,80,317
12942,United States,2016.0,139,54,71,264
12943,United States,1920.0,111,45,38,194
12944,United States,2008.0,127,110,80,317
12945,United States,1900.0,30,16,17,63
12946,United States,1900.0,30,16,17,63
12947,United States,1904.0,128,141,125,394
12948,United States,1904.0,128,141,125,394
12949,United States,1906.0,12,6,6,24
12950,United States,1952.0,87,48,29,164
12951,United States,2014.0,10,30,24,64
12952,United States,1948.0,93,34,41,168
12953,United States,1956.0,63,61,25,149
12954,United States,1996.0,159,48,52,259
12955,United States,2000.0,130,61,51,242
12956,United States,2000.0,130,61,51,242
12957,United States,2008.0,127,110,80,317
12958,United States,1928.0,53,30,19,102
12959,United States,1956.0,63,61,25,149
12960,United States,2002.0,11,58,15,84
12961,United States,2010.0,12,63,22,97
12962,United States,1936.0,53,29,30,112
12963,United States Golf Association-3,1904.0,128,141,125,394
12964,United States,2008.0,127,110,80,317
12965,United States,2012.0,145,57,46,248
12966,United States,2012.0,145,57,46,248
12967,United States,2012.0,145,57,46,248
12968,United States,2016.0,139,54,71,264
12969,United States,2016.0,139,54,71,264
12970,United States,2016.0,139,54,71,264
12971,United States-1,2016.0,139,54,71,264
12972,United States,1964.0,96,39,42,177
12973,United States,1964.0,96,39,42,177
12974,United States,1956.0,63,61,25,149
12975,United States,1980.0,24,4,2,30
12976,United States,1964.0,96,39,42,177
12977,United States,1976.0,73,61,41,175
12978,United States,1936.0,53,29,30,112
12979,United States,2012.0,145,57,46,248
12980,United States,1984.0,190,121,50,361
12981,United States,1984.0,190,121,50,361
12982,Christian Brothers' College-1,1904.0,128,141,125,394
12983,United States,1972.0,72,77,46,195
12984,United States,2000.0,130,61,51,242
12985,United States,2000.0,130,61,51,242
12986,Independent Rowing Club-3,1904.0,128,141,125,394
12987,United States,1932.0,91,68,64,223
12988,United States,1936.0,53,29,30,112
12989,United States,1936.0,53,29,30,112
12990,United States,2000.0,130,61,51,242
12991,United States,1924.0,98,46,50,194
12992,United States-1,2012.0,145,57,46,248
12993,United States,1972.0,72,77,46,195
12994,United States,1920.0,111,45,38,194
12995,United States,2004.0,117,75,71,263
12996,"Philadelphia Turngemeinde, Philadelphia",1904.0,128,141,125,394
12997,United States,1908.0,34,16,15,65
12998,United States,1932.0,91,68,64,223
12999,United States,2008.0,127,110,80,317
13000,United States,2004.0,117,75,71,263
13001,United States,2012.0,145,57,46,248
13002,United States,1924.0,98,46,50,194
13003,United States,1964.0,96,39,42,177
13004,United States,2012.0,145,57,46,248
13005,United States,2016.0,139,54,71,264
13006,United States,1992.0,94,57,87,238
13007,United States,2016.0,139,54,71,264
13008,United States,1996.0,159,48,52,259
13009,United States,1988.0,89,67,58,214
13010,Comanche,1952.0,87,48,29,164
13011,United States,1912.0,46,25,36,107
13012,United States,1912.0,46,25,36,107
13013,United States,1984.0,190,121,50,361
13014,United States,1920.0,111,45,38,194
13015,United States,1952.0,87,48,29,164
13016,United States,1952.0,87,48,29,164
13017,United States,1948.0,93,34,41,168
13018,United States,1968.0,100,37,36,173
13019,United States,1968.0,100,37,36,173
13020,United States,2006.0,9,11,32,52
13021,United States,1984.0,190,121,50,361
13022,United States,1984.0,190,121,50,361
13023,United States,1984.0,190,121,50,361
13024,United States,1984.0,190,121,50,361
13025,United States,1984.0,190,121,50,361
13026,United States,2010.0,12,63,22,97
13027,United States,2010.0,12,63,22,97
13028,Missouri Athletic Club-3,1904.0,128,141,125,394
13029,Missouri Athletic Club-3,1904.0,128,141,125,394
13030,United States,1988.0,89,67,58,214
13031,United States,1988.0,89,67,58,214
13032,United States,1988.0,89,67,58,214
13033,United States,1992.0,94,57,87,238
13034,United States,2000.0,130,61,51,242
13035,United States,1996.0,159,48,52,259
13036,United States,2000.0,130,61,51,242
13037,United States,2004.0,117,75,71,263
13038,United States,2008.0,127,110,80,317
13039,United States,2012.0,145,57,46,248
13040,United States,2016.0,139,54,71,264
13041,United States,1924.0,98,46,50,194
13042,United States,1908.0,34,16,15,65
13043,United States,1912.0,46,25,36,107
13044,United States,1948.0,93,34,41,168
13045,United States,1952.0,87,48,29,164
13046,United States,1956.0,63,61,25,149
13047,United States,1924.0,98,46,50,194
13048,United States-2,1924.0,98,46,50,194
13049,United States-2,1924.0,98,46,50,194
13050,United States,2004.0,117,75,71,263
13051,United States,2008.0,127,110,80,317
13052,United States,2008.0,127,110,80,317
13053,United States,2012.0,145,57,46,248
13054,United States,2012.0,145,57,46,248
13055,United States,1996.0,159,48,52,259
13056,United States,2000.0,130,61,51,242
13057,Boston Archers,1904.0,128,141,125,394
13058,United States,1908.0,34,16,15,65
13059,United States,2012.0,145,57,46,248
13060,United States,1984.0,190,121,50,361
13061,United States,2000.0,130,61,51,242
13062,United States,1964.0,96,39,42,177
13063,United States,1988.0,89,67,58,214
13064,United States,1996.0,159,48,52,259
13065,United States,2002.0,11,58,15,84
13066,United States,1976.0,73,61,41,175
13067,United States,1984.0,190,121,50,361
13068,Llanoria,1952.0,87,48,29,164
13069,United States,1976.0,73,61,41,175
13070,United States,1936.0,53,29,30,112
13071,United States,1956.0,63,61,25,149
13072,United States,1920.0,111,45,38,194
13073,United States,1924.0,98,46,50,194
13074,United States,1924.0,98,46,50,194
13075,United States,1932.0,91,68,64,223
13076,United States,1932.0,91,68,64,223
13077,United States,1920.0,111,45,38,194
13078,United States,1924.0,98,46,50,194
13079,United States,1932.0,91,68,64,223
13080,United States,2004.0,117,75,71,263
13081,United States-2,1948.0,93,34,41,168
13082,United States,1948.0,93,34,41,168
13083,United States,1948.0,93,34,41,168
13084,United States,1988.0,89,67,58,214
13085,United States,2012.0,145,57,46,248
13086,United States,1960.0,100,27,25,152
13087,United States,1976.0,73,61,41,175
13088,United States,2016.0,139,54,71,264
13089,United States,1996.0,159,48,52,259
13090,United States,1976.0,73,61,41,175
13091,United States,1984.0,190,121,50,361
13092,United States,1984.0,190,121,50,361
13093,United States,1988.0,89,67,58,214
13094,United States,1904.0,128,141,125,394
13095,United States,1906.0,12,6,6,24
13096,United States,1906.0,12,6,6,24
13097,United States,1960.0,100,27,25,152
13098,United States,1956.0,63,61,25,149
13099,United States,1964.0,96,39,42,177
13100,United States,1968.0,100,37,36,173
13101,United States,1968.0,100,37,36,173
13102,United States,1968.0,100,37,36,173
13103,United States,1972.0,72,77,46,195
13104,United States,1976.0,73,61,41,175
13105,United States,1928.0,53,30,19,102
13106,United States,1928.0,53,30,19,102
13107,United States,1936.0,53,29,30,112
13108,United States,1988.0,89,67,58,214
13109,United States,1992.0,94,57,87,238
13110,United States,1996.0,159,48,52,259
13111,United States,2008.0,127,110,80,317
13112,United States,1948.0,93,34,41,168
13113,United States,2016.0,139,54,71,264
13114,United States,1936.0,53,29,30,112
13115,United States,2004.0,117,75,71,263
13116,United States,1988.0,89,67,58,214
13117,United States,2016.0,139,54,71,264
13118,United States,1976.0,73,61,41,175
13119,United States,1976.0,73,61,41,175
13120,United States,1976.0,73,61,41,175
13121,United States,2004.0,117,75,71,263
13122,United States,1924.0,98,46,50,194
13123,St. Louis Southwest Turnverein #1-2,1904.0,128,141,125,394
13124,United States,1956.0,63,61,25,149
13125,United States,1960.0,100,27,25,152
13126,United States,2008.0,127,110,80,317
13127,United States,2012.0,145,57,46,248
13128,United States,2002.0,11,58,15,84
13129,United States,2002.0,11,58,15,84
13130,United States,1988.0,89,67,58,214
13131,United States,1924.0,98,46,50,194
13132,United States,1904.0,128,141,125,394
13133,United States,2002.0,11,58,15,84
13134,United States,1992.0,94,57,87,238
13135,United States,1994.0,6,8,5,19
13136,United States,1932.0,91,68,64,223
13137,United States,1936.0,53,29,30,112
13138,Aphrodite,1964.0,96,39,42,177
13139,United States,1948.0,93,34,41,168
13140,United States,2008.0,127,110,80,317
13141,United States-1,2008.0,127,110,80,317
13142,United States,1924.0,98,46,50,194
13143,United States-1,2006.0,9,11,32,52
13144,United States,1984.0,190,121,50,361
13145,United States,1976.0,73,61,41,175
13146,United States,2006.0,9,11,32,52
13147,United States,1960.0,100,27,25,152
13148,United States,2016.0,139,54,71,264
13149,United States,1948.0,93,34,41,168
13150,United States,2002.0,11,58,15,84
13151,United States,1952.0,87,48,29,164
13152,United States,2008.0,127,110,80,317
13153,Union des Socits Franais de Sports Athletiques,1900.0,30,16,17,63
13154,Llanoria,1952.0,87,48,29,164
13155,United States,1936.0,53,29,30,112
13156,United States,1988.0,89,67,58,214
13157,United States,1932.0,91,68,64,223
13158,United States,1956.0,63,61,25,149
13159,St. Louis Southwest Turnverein #1-2,1904.0,128,141,125,394
13160,United States,1904.0,128,141,125,394
13161,United States,1904.0,128,141,125,394
13162,United States,1904.0,128,141,125,394
13163,United States,1908.0,34,16,15,65
13164,United States,1912.0,46,25,36,107
13165,United States,1912.0,46,25,36,107
13166,"New York Turnverein, New York",1904.0,128,141,125,394
13167,United States-2,2012.0,145,57,46,248
13168,United States-1,2016.0,139,54,71,264
13169,United States,2012.0,145,57,46,248
13170,United States,1920.0,111,45,38,194
13171,United States,1920.0,111,45,38,194
13172,United States,1920.0,111,45,38,194
13173,St. Louis Amateur Athletic Association,1904.0,128,141,125,394
13174,United States,1936.0,53,29,30,112
13175,United States,1952.0,87,48,29,164
13176,United States,1964.0,96,39,42,177
13177,United States,1932.0,91,68,64,223
13178,United States,1932.0,91,68,64,223
13179,United States,1972.0,72,77,46,195
13180,United States,1972.0,72,77,46,195
13181,United States,1920.0,111,45,38,194
13182,United States,1920.0,111,45,38,194
13183,United States,1976.0,73,61,41,175
13184,United States,1992.0,94,57,87,238
13185,United States,1992.0,94,57,87,238
13186,United States,1996.0,159,48,52,259
13187,United States,1996.0,159,48,52,259
13188,United States,1996.0,159,48,52,259
13189,United States,2008.0,127,110,80,317
13190,United States,1936.0,53,29,30,112
13191,United States,1984.0,190,121,50,361
13192,New York Athletic Club-1,1904.0,128,141,125,394
13193,New York Athletic Club #1-1,1904.0,128,141,125,394
13194,United States,1956.0,63,61,25,149
13195,United States,1960.0,100,27,25,152
13196,United States,1960.0,100,27,25,152
13197,United States,1960.0,100,27,25,152
13198,United States,1998.0,25,4,5,34
13199,United States,2002.0,11,58,15,84
13200,United States,2006.0,9,11,32,52
13201,United States,2010.0,12,63,22,97
13202,United States,1984.0,190,121,50,361
13203,United States,1984.0,190,121,50,361
13204,United States,1988.0,89,67,58,214
13205,United States,2004.0,117,75,71,263
13206,United States,2012.0,145,57,46,248
13207,United States,2012.0,145,57,46,248
13208,United States,2016.0,139,54,71,264
13209,United States,2012.0,145,57,46,248
13210,United States,2016.0,139,54,71,264
13211,United States,1988.0,89,67,58,214
13212,United States,2016.0,139,54,71,264
13213,United States,1956.0,63,61,25,149
13214,United States,1968.0,100,37,36,173
13215,United States,1968.0,100,37,36,173
13216,United States,1928.0,53,30,19,102
13217,United States,1952.0,87,48,29,164
13218,United States,1956.0,63,61,25,149
13219,United States,1956.0,63,61,25,149
13220,United States,1960.0,100,27,25,152
13221,United States,2010.0,12,63,22,97
13222,United States,1936.0,53,29,30,112
13223,Seawanhaka Boat Club-1,1904.0,128,141,125,394
13224,United States,1920.0,111,45,38,194
13225,United States,1920.0,111,45,38,194
13226,United States,1972.0,72,77,46,195
13227,United States,1976.0,73,61,41,175
13228,United States,1968.0,100,37,36,173
13229,United States,1964.0,96,39,42,177
13230,United States,1964.0,96,39,42,177
13231,United States,2008.0,127,110,80,317
13232,United States,1984.0,190,121,50,361
13233,United States,1948.0,93,34,41,168
13234,United States,1924.0,98,46,50,194
13235,United States,1932.0,91,68,64,223
13236,United States,1932.0,91,68,64,223
13237,United States,1932.0,91,68,64,223
13238,United States,1996.0,159,48,52,259
13239,United States,2008.0,127,110,80,317
13240,United States,1984.0,190,121,50,361
13241,United States,1956.0,63,61,25,149
13242,United States,1904.0,128,141,125,394
13243,United States,1928.0,53,30,19,102
13244,United States,1992.0,94,57,87,238
13245,United States,1920.0,111,45,38,194
13246,United States,2000.0,130,61,51,242
13247,United States,2004.0,117,75,71,263
13248,United States,2004.0,117,75,71,263
13249,United States,2004.0,117,75,71,263
13250,United States,2016.0,139,54,71,264
13251,United States,2000.0,130,61,51,242
13252,United States,1952.0,87,48,29,164
13253,United States,1968.0,100,37,36,173
13254,United States,1972.0,72,77,46,195
13255,United States,1992.0,94,57,87,238
13256,United States,1992.0,94,57,87,238
13257,United States,1992.0,94,57,87,238
13258,United States,1992.0,94,57,87,238
13259,United States,1972.0,72,77,46,195
13260,United States,1992.0,94,57,87,238
13261,United States,2004.0,117,75,71,263
13262,United States,1900.0,30,16,17,63
13263,United States,1976.0,73,61,41,175
13264,United States,1972.0,72,77,46,195
13265,United States,1988.0,89,67,58,214
13266,United States,1992.0,94,57,87,238
13267,United States,1992.0,94,57,87,238
13268,United States,1964.0,96,39,42,177
13269,United States,1964.0,96,39,42,177
13270,United States,2012.0,145,57,46,248
13271,United States,1968.0,100,37,36,173
13272,United States,1984.0,190,121,50,361
13273,United States,1988.0,89,67,58,214
13274,United States,1996.0,159,48,52,259
13275,United States,1996.0,159,48,52,259
13276,Western Golf Association-1,1904.0,128,141,125,394
13277,United States,1960.0,100,27,25,152
13278,United States,2012.0,145,57,46,248
13279,United States,1920.0,111,45,38,194
13280,United States,1932.0,91,68,64,223
13281,United States,2010.0,12,63,22,97
13282,United States,2014.0,10,30,24,64
13283,Vesper Boat Club,1904.0,128,141,125,394
13284,United States,1948.0,93,34,41,168
13285,United States,1952.0,87,48,29,164
13286,United States,1960.0,100,27,25,152
13287,United States,1964.0,96,39,42,177
13288,United States,1988.0,89,67,58,214
13289,United States,2008.0,127,110,80,317
13290,United States,1948.0,93,34,41,168
13291,United States,1904.0,128,141,125,394
13292,United States,2014.0,10,30,24,64
13293,United States,2016.0,139,54,71,264
13294,United States,1998.0,25,4,5,34
13295,United States,2002.0,11,58,15,84
13296,United States,2006.0,9,11,32,52
13297,United States,2010.0,12,63,22,97
13298,United States,1972.0,72,77,46,195
13299,United States,1964.0,96,39,42,177
13300,United States,1964.0,96,39,42,177
13301,United States,1972.0,72,77,46,195
13302,United States,1976.0,73,61,41,175
13303,United States,1936.0,53,29,30,112
13304,United States,2008.0,127,110,80,317
13305,United States,2012.0,145,57,46,248
13306,United States,2012.0,145,57,46,248
13307,United States,2012.0,145,57,46,248
13308,United States,2012.0,145,57,46,248
13309,United States,2012.0,145,57,46,248
13310,United States,2016.0,139,54,71,264
13311,United States,2016.0,139,54,71,264
13312,United States,1928.0,53,30,19,102
13313,"New York Turnverein, New York",1904.0,128,141,125,394
13314,United States,1980.0,24,4,2,30
13315,United States,1996.0,159,48,52,259
13316,United States,1996.0,159,48,52,259
13317,United States,2008.0,127,110,80,317
13318,United States,1972.0,72,77,46,195
13319,Complex II,1952.0,87,48,29,164
13320,United States,1952.0,87,48,29,164
13321,United States,1964.0,96,39,42,177
13322,United States,1964.0,96,39,42,177
13323,United States,1964.0,96,39,42,177
13324,United States,1964.0,96,39,42,177
13325,United States,1968.0,100,37,36,173
13326,United States,1968.0,100,37,36,173
13327,United States,1968.0,100,37,36,173
13328,United States,1968.0,100,37,36,173
13329,United States,1920.0,111,45,38,194
13330,United States,1924.0,98,46,50,194
13331,United States,1924.0,98,46,50,194
13332,United States,1920.0,111,45,38,194
13333,United States,1924.0,98,46,50,194
13334,United States,1968.0,100,37,36,173
13335,Missouri Athletic Club-3,1904.0,128,141,125,394
13336,United States,1920.0,111,45,38,194
13337,United States,1920.0,111,45,38,194
13338,United States,1920.0,111,45,38,194
13339,United States,1984.0,190,121,50,361
13340,United States,1988.0,89,67,58,214
13341,United States,1984.0,190,121,50,361
13342,United States,1988.0,89,67,58,214
13343,United States,1920.0,111,45,38,194
13344,United States,1920.0,111,45,38,194
13345,United States,1920.0,111,45,38,194
13346,United States,1924.0,98,46,50,194
13347,United States,1948.0,93,34,41,168
13348,United States-1,2002.0,11,58,15,84
13349,United States,1964.0,96,39,42,177
13350,United States,1904.0,128,141,125,394
13351,United States,1960.0,100,27,25,152
13352,United States,1960.0,100,27,25,152
13353,United States,1932.0,91,68,64,223
13354,United States,1964.0,96,39,42,177
13355,United States,1984.0,190,121,50,361
13356,United States,1984.0,190,121,50,361
13357,United States,1996.0,159,48,52,259
13358,United States,1996.0,159,48,52,259
13359,"Central Turnverein, Chicago",1904.0,128,141,125,394
13360,United States,1912.0,46,25,36,107
13361,United States,1912.0,46,25,36,107
13362,United States,1932.0,91,68,64,223
13363,Missouri Athletic Club-3,1904.0,128,141,125,394
13364,United States,1996.0,159,48,52,259
13365,United States,2000.0,130,61,51,242
13366,United States,1996.0,159,48,52,259
13367,United States,1996.0,159,48,52,259
13368,United States,2000.0,130,61,51,242
13369,United States,1968.0,100,37,36,173
13370,United States,1948.0,93,34,41,168
13371,United States,2012.0,145,57,46,248
13372,United States,1912.0,46,25,36,107
13373,United States,2008.0,127,110,80,317
13374,United States,2012.0,145,57,46,248
13375,Bingo,1964.0,96,39,42,177
13376,United States,1996.0,159,48,52,259
13377,United States,2004.0,117,75,71,263
13378,United States,1968.0,100,37,36,173
13379,United States,1972.0,72,77,46,195
13380,United States,1972.0,72,77,46,195
13381,United States,1912.0,46,25,36,107
13382,United States,1956.0,63,61,25,149
13383,United States,1972.0,72,77,46,195
13384,United States,1920.0,111,45,38,194
13385,United States,1992.0,94,57,87,238
13386,United States,2000.0,130,61,51,242
13387,United States,1952.0,87,48,29,164
13388,United States,1988.0,89,67,58,214
13389,United States,1996.0,159,48,52,259
13390,United States,2000.0,130,61,51,242
13391,United States,2004.0,117,75,71,263
13392,United States,2012.0,145,57,46,248
13393,United States,2016.0,139,54,71,264
13394,United States,1956.0,63,61,25,149
13395,Milwaukee Athletic Club-1,1904.0,128,141,125,394
13396,St. Louis Southwest Turnverein #1-2,1904.0,128,141,125,394
13397,United States,2000.0,130,61,51,242
13398,Trans-Mississippi Golf Association-2,1904.0,128,141,125,394
13399,United States,2000.0,130,61,51,242
13400,United States,1904.0,128,141,125,394
13401,United States,1984.0,190,121,50,361
13402,United States,2004.0,117,75,71,263
13403,United States,2004.0,117,75,71,263
13404,United States,1932.0,91,68,64,223
13405,United States,1948.0,93,34,41,168
13406,United States,1988.0,89,67,58,214
13407,United States,1952.0,87,48,29,164
13408,United States,1956.0,63,61,25,149
13409,United States,2012.0,145,57,46,248
13410,United States,1972.0,72,77,46,195
13411,United States,1972.0,72,77,46,195
13412,United States,1924.0,98,46,50,194
13413,United States-2,2002.0,11,58,15,84
13414,United States,1936.0,53,29,30,112
13415,United States,1908.0,34,16,15,65
13416,United States,1976.0,73,61,41,175
13417,United States,1976.0,73,61,41,175
13418,United States,1984.0,190,121,50,361
13419,United States,1932.0,91,68,64,223
13420,United States,1932.0,91,68,64,223
13421,United States,2002.0,11,58,15,84
13422,United States,1932.0,91,68,64,223
13423,United States,2000.0,130,61,51,242
13424,United States,2000.0,130,61,51,242
13425,United States,1932.0,91,68,64,223
13426,United States,2000.0,130,61,51,242
13427,United States,1972.0,72,77,46,195
13428,United States-1,1998.0,25,4,5,34
13429,United States,1972.0,72,77,46,195
13430,United States,2000.0,130,61,51,242
13431,United States,1952.0,87,48,29,164
13432,United States,1924.0,98,46,50,194
13433,United States,1900.0,30,16,17,63
13434,United States,1900.0,30,16,17,63
13435,United States,1904.0,128,141,125,394
13436,United States,1900.0,30,16,17,63
13437,United States,1900.0,30,16,17,63
13438,United States,1984.0,190,121,50,361
13439,United States,1956.0,63,61,25,149
13440,United States,1908.0,34,16,15,65
13441,United States,1908.0,34,16,15,65
13442,United States,1908.0,34,16,15,65
13443,United States,1912.0,46,25,36,107
13444,United States,1912.0,46,25,36,107
13445,United States,1976.0,73,61,41,175
13446,United States,1904.0,128,141,125,394
13447,United States,1906.0,12,6,6,24
13448,United States,1906.0,12,6,6,24
13449,United States,1906.0,12,6,6,24
13450,United States,1906.0,12,6,6,24
13451,United States,1906.0,12,6,6,24
13452,United States,1908.0,34,16,15,65
13453,United States,1908.0,34,16,15,65
13454,United States,1908.0,34,16,15,65
13455,United States,1964.0,96,39,42,177
13456,United States,1904.0,128,141,125,394
13457,United States,2012.0,145,57,46,248
13458,United States,2016.0,139,54,71,264
13459,United States,1920.0,111,45,38,194
13460,United States,1920.0,111,45,38,194
13461,United States,1968.0,100,37,36,173
13462,United States,1968.0,100,37,36,173
13463,United States,2016.0,139,54,71,264
13464,United States,2014.0,10,30,24,64
13465,United States,1932.0,91,68,64,223
13466,United States-2,2002.0,11,58,15,84
13467,United States,1976.0,73,61,41,175
13468,United States,1964.0,96,39,42,177
13469,United States,2014.0,10,30,24,64
13470,United States,2016.0,139,54,71,264
13471,United States,2016.0,139,54,71,264
13472,United States,2008.0,127,110,80,317
13473,United States,1972.0,72,77,46,195
13474,United States,1976.0,73,61,41,175
13475,United States,1972.0,72,77,46,195
13476,United States,1956.0,63,61,25,149
13477,United States,1988.0,89,67,58,214
13478,United States,2006.0,9,11,32,52
13479,United States,1936.0,53,29,30,112
13480,"Central Turnverein, Chicago",1904.0,128,141,125,394
13481,United States,1976.0,73,61,41,175
13482,United States,1980.0,24,4,2,30
13483,United States,1924.0,98,46,50,194
13484,United States,1976.0,73,61,41,175
13485,United States,1968.0,100,37,36,173
13486,United States,2008.0,127,110,80,317
13487,United States,1972.0,72,77,46,195
13488,United States,1984.0,190,121,50,361
13489,United States,1960.0,100,27,25,152
13490,United States,2016.0,139,54,71,264
13491,United States,2000.0,130,61,51,242
13492,United States,1948.0,93,34,41,168
13493,United States,1952.0,87,48,29,164
13494,United States,1996.0,159,48,52,259
13495,United States,1908.0,34,16,15,65
13496,United States,1948.0,93,34,41,168
13497,United States,1956.0,63,61,25,149
13498,United States,1992.0,94,57,87,238
13499,United States,1932.0,91,68,64,223
13500,United States,1976.0,73,61,41,175
13501,United States,2008.0,127,110,80,317
13502,United States,1964.0,96,39,42,177
13503,United States,1924.0,98,46,50,194
13504,United States,1988.0,89,67,58,214
13505,United States,1972.0,72,77,46,195
13506,United States,1920.0,111,45,38,194
13507,United States,1924.0,98,46,50,194
13508,United States,1924.0,98,46,50,194
13509,United States,1972.0,72,77,46,195
13510,United States,2000.0,130,61,51,242
13511,United States,2008.0,127,110,80,317
13512,United States,1924.0,98,46,50,194
13513,United States,2008.0,127,110,80,317
13514,Hilarius,1948.0,93,34,41,168
13515,United States,2008.0,127,110,80,317
13516,Hilarius,1948.0,93,34,41,168
13517,United States,2008.0,127,110,80,317
13518,United States,2008.0,127,110,80,317
13519,United States,1960.0,100,27,25,152
13520,United States,1952.0,87,48,29,164
13521,United States,1948.0,93,34,41,168
13522,United States,1948.0,93,34,41,168
13523,United States,1984.0,190,121,50,361
13524,United States,1988.0,89,67,58,214
13525,United States,1924.0,98,46,50,194
13526,Gallant,1932.0,91,68,64,223
13527,United States,1988.0,89,67,58,214
13528,United States,2016.0,139,54,71,264
13529,Minotaur,1960.0,100,27,25,152
13530,United States,2016.0,139,54,71,264
13531,United States,1952.0,87,48,29,164
13532,United States,1932.0,91,68,64,223
13533,United States,1936.0,53,29,30,112
13534,United States,1948.0,93,34,41,168
13535,United States,1932.0,91,68,64,223
13536,United States,1932.0,91,68,64,223
13537,Llanoria,1948.0,93,34,41,168
13538,United States,2008.0,127,110,80,317
13539,United States,1988.0,89,67,58,214
13540,United States,1992.0,94,57,87,238
13541,United States,1984.0,190,121,50,361
13542,United States,1988.0,89,67,58,214
13543,United States,1996.0,159,48,52,259
13544,United States,1948.0,93,34,41,168
13545,United States,2000.0,130,61,51,242
13546,United States,2004.0,117,75,71,263
13547,United States,2008.0,127,110,80,317
13548,United States,1996.0,159,48,52,259
13549,United States,2016.0,139,54,71,264
13550,United States,2016.0,139,54,71,264
13551,United States,1984.0,190,121,50,361
13552,United States,1996.0,159,48,52,259
13553,United States,2000.0,130,61,51,242
13554,United States,1992.0,94,57,87,238
13555,United States,1968.0,100,37,36,173
13556,United States,2002.0,11,58,15,84
13557,United States,2006.0,9,11,32,52
13558,United States,2000.0,130,61,51,242
13559,United States,1968.0,100,37,36,173
13560,United States,1984.0,190,121,50,361
13561,United States,1988.0,89,67,58,214
13562,United States,1908.0,34,16,15,65
13563,United States,2016.0,139,54,71,264
13564,Western Golf Association-1,1904.0,128,141,125,394
13565,United States,1984.0,190,121,50,361
13566,United States,1992.0,94,57,87,238
13567,United States,1960.0,100,27,25,152
13568,United States,1920.0,111,45,38,194
13569,United States,1920.0,111,45,38,194
13570,United States,2016.0,139,54,71,264
13571,United States,2016.0,139,54,71,264
13572,United States,2000.0,130,61,51,242
13573,United States,2004.0,117,75,71,263
13574,United States,2008.0,127,110,80,317
13575,United States-2,2016.0,139,54,71,264
13576,United States-2,2016.0,139,54,71,264
13577,United States,1948.0,93,34,41,168
13578,United States,2008.0,127,110,80,317
13579,United States,2012.0,145,57,46,248
13580,United States,2008.0,127,110,80,317
13581,United States,2008.0,127,110,80,317
13582,United States,2008.0,127,110,80,317
13583,United States,2012.0,145,57,46,248
13584,United States,2012.0,145,57,46,248
13585,United States,2012.0,145,57,46,248
13586,United States,1956.0,63,61,25,149
13587,United States,1936.0,53,29,30,112
13588,United States,1968.0,100,37,36,173
13589,United States,1904.0,128,141,125,394
13590,United States,1904.0,128,141,125,394
13591,United States,1948.0,93,34,41,168
13592,United States,1924.0,98,46,50,194
13593,United States,2016.0,139,54,71,264
13594,United States,1928.0,53,30,19,102
13595,Potomac Archers,1904.0,128,141,125,394
13596,United States,1960.0,100,27,25,152
13597,United States,1960.0,100,27,25,152
13598,United States,2010.0,12,63,22,97
13599,United States,2010.0,12,63,22,97
13600,United States,2010.0,12,63,22,97
13601,United States,1976.0,73,61,41,175
13602,United States,1976.0,73,61,41,175
13603,United States,1968.0,100,37,36,173
13604,United States,1968.0,100,37,36,173
13605,United States,1968.0,100,37,36,173
13606,United States,1968.0,100,37,36,173
13607,United States,1972.0,72,77,46,195
13608,United States,1972.0,72,77,46,195
13609,United States,1972.0,72,77,46,195
13610,United States,1972.0,72,77,46,195
13611,United States,1972.0,72,77,46,195
13612,United States,1972.0,72,77,46,195
13613,United States,1972.0,72,77,46,195
13614,United States,1924.0,98,46,50,194
13615,United States,1920.0,111,45,38,194
13616,United States,1920.0,111,45,38,194
13617,United States,1920.0,111,45,38,194
13618,United States,1920.0,111,45,38,194
13619,United States,1920.0,111,45,38,194
13620,United States,1920.0,111,45,38,194
13621,United States,1920.0,111,45,38,194
13622,United States,1912.0,46,25,36,107
13623,United States,1904.0,128,141,125,394
13624,United States,2008.0,127,110,80,317
13625,United States,1984.0,190,121,50,361
13626,United States,1912.0,46,25,36,107
13627,United States,1912.0,46,25,36,107
13628,United States,1912.0,46,25,36,107
13629,United States,1984.0,190,121,50,361
13630,United States,2004.0,117,75,71,263
13631,United States,1948.0,93,34,41,168
13632,United States,1948.0,93,34,41,168
13633,United States,2010.0,12,63,22,97
13634,United States,2014.0,10,30,24,64
13635,United States,1904.0,128,141,125,394
13636,United States,1904.0,128,141,125,394
13637,United States,1976.0,73,61,41,175
13638,United States,1928.0,53,30,19,102
13639,United States,1996.0,159,48,52,259
13640,United States,2000.0,130,61,51,242
13641,United States,2004.0,117,75,71,263
13642,United States,1952.0,87,48,29,164
13643,United States,1972.0,72,77,46,195
13644,United States,1972.0,72,77,46,195
13645,United States,1972.0,72,77,46,195
13646,United States,1948.0,93,34,41,168
13647,United States,1952.0,87,48,29,164
13648,United States,1952.0,87,48,29,164
13649,United States,1952.0,87,48,29,164
13650,United States,1956.0,63,61,25,149
13651,United States,1904.0,128,141,125,394
13652,United States,1904.0,128,141,125,394
13653,United States,1948.0,93,34,41,168
13654,United States,2008.0,127,110,80,317
13655,United States,1952.0,87,48,29,164
13656,United States,2010.0,12,63,22,97
13657,United States,1984.0,190,121,50,361
13658,United States,1984.0,190,121,50,361
13659,Glider,1964.0,96,39,42,177
13660,United States,1964.0,96,39,42,177
13661,United States,2014.0,10,30,24,64
13662,United States,1996.0,159,48,52,259
13663,United States,1924.0,98,46,50,194
13664,United States-2,2002.0,11,58,15,84
13665,United States,1984.0,190,121,50,361
13666,United States,1948.0,93,34,41,168
13667,New York Athletic Club-1,1904.0,128,141,125,394
13668,United States,1932.0,91,68,64,223
13669,Chicago Athletic Association-2,1904.0,128,141,125,394
13670,"New York Turnverein, New York",1904.0,128,141,125,394
13671,United States,2008.0,127,110,80,317
13672,United States,2012.0,145,57,46,248
13673,United States,2012.0,145,57,46,248
13674,United States,2016.0,139,54,71,264
13675,United States-1,1996.0,159,48,52,259
13676,United States,1912.0,46,25,36,107
13677,United States,1984.0,190,121,50,361
13678,United States,1952.0,87,48,29,164
13679,United States,1960.0,100,27,25,152
13680,United States,1968.0,100,37,36,173
13681,United States,1972.0,72,77,46,195
13682,United States,1984.0,190,121,50,361
13683,United States,1984.0,190,121,50,361
13684,United States,1984.0,190,121,50,361
13685,United States,1984.0,190,121,50,361
13686,United States,1952.0,87,48,29,164
13687,United States,1936.0,53,29,30,112
13688,United States,1936.0,53,29,30,112
13689,United States,2006.0,9,11,32,52
13690,United States,1976.0,73,61,41,175
13691,United States,1984.0,190,121,50,361
13692,United States,1988.0,89,67,58,214
13693,United States,1988.0,89,67,58,214
13694,United States-1,1932.0,91,68,64,223
13695,United States,1952.0,87,48,29,164
13696,United States-1,1932.0,91,68,64,223
13697,United States,2008.0,127,110,80,317
13698,United States-2,1932.0,91,68,64,223
13699,United States,1992.0,94,57,87,238
13700,United States,1996.0,159,48,52,259
13701,United States,2016.0,139,54,71,264
13702,United States,1924.0,98,46,50,194
13703,United States,2016.0,139,54,71,264
13704,United States,2004.0,117,75,71,263
13705,United States,2016.0,139,54,71,264
13706,United States,1992.0,94,57,87,238
13707,United States,1992.0,94,57,87,238
13708,United States,1992.0,94,57,87,238
13709,United States,1964.0,96,39,42,177
13710,Trans-Mississippi Golf Association-2,1904.0,128,141,125,394
13711,Trans-Mississippi Golf Association-2,1904.0,128,141,125,394
13712,United States,1984.0,190,121,50,361
13713,United States,1984.0,190,121,50,361
13714,United States,2000.0,130,61,51,242
13715,United States,1984.0,190,121,50,361
13716,United States,1984.0,190,121,50,361
13717,United States,1960.0,100,27,25,152
13718,Century Boat Club-1,1904.0,128,141,125,394
13719,United States,1992.0,94,57,87,238
13720,United States,1996.0,159,48,52,259
13721,United States,1924.0,98,46,50,194
13722,United States,1996.0,159,48,52,259
13723,United States,1924.0,98,46,50,194
13724,United States,1924.0,98,46,50,194
13725,United States,2016.0,139,54,71,264
13726,United States,1998.0,25,4,5,34
13727,United States,1972.0,72,77,46,195
13728,United States,1976.0,73,61,41,175
13729,United States,1988.0,89,67,58,214
13730,United States,1992.0,94,57,87,238
13731,United States,1964.0,96,39,42,177
13732,United States,1984.0,190,121,50,361
13733,United States,2004.0,117,75,71,263
13734,United States,1964.0,96,39,42,177
13735,United States,1964.0,96,39,42,177
13736,United States,1964.0,96,39,42,177
13737,United States,1964.0,96,39,42,177
13738,United States,1952.0,87,48,29,164
13739,United States,1956.0,63,61,25,149
13740,United States,1964.0,96,39,42,177
13741,United States,2000.0,130,61,51,242
13742,United States,1976.0,73,61,41,175
13743,United States,2008.0,127,110,80,317
13744,United States-1,1992.0,94,57,87,238
13745,United States,1904.0,128,141,125,394
13746,United States,1994.0,6,8,5,19
13747,United States,1998.0,25,4,5,34
13748,United States,1904.0,128,141,125,394
13749,United States,1968.0,100,37,36,173
13750,United States,1980.0,24,4,2,30
13751,United States,1912.0,46,25,36,107
13752,United States,1932.0,91,68,64,223
13753,United States,1984.0,190,121,50,361
13754,United States,1992.0,94,57,87,238
13755,United States,1996.0,159,48,52,259
13756,United States,1936.0,53,29,30,112
13757,United States,2008.0,127,110,80,317
13758,United States,2012.0,145,57,46,248
13759,United States,1924.0,98,46,50,194
13760,United States,1992.0,94,57,87,238
13761,United States,1956.0,63,61,25,149
13762,United States,1904.0,128,141,125,394
13763,United States,1984.0,190,121,50,361
13764,United States,1996.0,159,48,52,259
13765,Mound City Rowing Club-2,1904.0,128,141,125,394
13766,St. Louis Amateur Athletic Association,1904.0,128,141,125,394
13767,United States,1984.0,190,121,50,361
13768,United States,1984.0,190,121,50,361
13769,United States,2002.0,11,58,15,84
13770,United States,1980.0,24,4,2,30
13771,United States,2010.0,12,63,22,97
13772,Angelita,1932.0,91,68,64,223
13773,United States,1984.0,190,121,50,361
13774,United States,1968.0,100,37,36,173
13775,United States,1968.0,100,37,36,173
13776,United States,2000.0,130,61,51,242
13777,United States,1988.0,89,67,58,214
13778,United States,1936.0,53,29,30,112
13779,Chicago Athletic Association-2,1904.0,128,141,125,394
13780,United States,1996.0,159,48,52,259
13781,United States,2000.0,130,61,51,242
13782,United States,2004.0,117,75,71,263
13783,United States,2008.0,127,110,80,317
13784,United States,1920.0,111,45,38,194
13785,United States,1924.0,98,46,50,194
13786,United States,1912.0,46,25,36,107
13787,United States,1912.0,46,25,36,107
13788,United States,1984.0,190,121,50,361
13789,United States,2012.0,145,57,46,248
13790,United States,2008.0,127,110,80,317
13791,United States,1956.0,63,61,25,149
13792,United States,1988.0,89,67,58,214
13793,United States,1996.0,159,48,52,259
13794,United States,1992.0,94,57,87,238
13795,United States,2000.0,130,61,51,242
13796,United States,2000.0,130,61,51,242
13797,United States,2012.0,145,57,46,248
13798,United States,2004.0,117,75,71,263
13799,United States,2008.0,127,110,80,317
13800,United States,1996.0,159,48,52,259
13801,United States,2012.0,145,57,46,248
13802,United States,1984.0,190,121,50,361
13803,St. Rose-2,1904.0,128,141,125,394
13804,United States,1976.0,73,61,41,175
13805,United States,1904.0,128,141,125,394
13806,United States,1904.0,128,141,125,394
13807,United States,1904.0,128,141,125,394
13808,United States,2004.0,117,75,71,263
13809,United States,2008.0,127,110,80,317
13810,United States,2012.0,145,57,46,248
13811,United States,2016.0,139,54,71,264
13812,United States,1976.0,73,61,41,175
13813,United States,2000.0,130,61,51,242
13814,United States,2008.0,127,110,80,317
13815,United States,2008.0,127,110,80,317
13816,United States,2012.0,145,57,46,248
13817,United States,1972.0,72,77,46,195
13818,United States,2012.0,145,57,46,248
13819,United States,2016.0,139,54,71,264
13820,United States,1952.0,87,48,29,164
13821,United States,2000.0,130,61,51,242
13822,United States,1908.0,34,16,15,65
13823,Cincinnati Archers,1904.0,128,141,125,394
13824,United States,1984.0,190,121,50,361
13825,United States,1924.0,98,46,50,194
13826,United States,1928.0,53,30,19,102
13827,United States,1932.0,91,68,64,223
13828,United States,1972.0,72,77,46,195
13829,United States,1972.0,72,77,46,195
13830,United States,2008.0,127,110,80,317
13831,United States,1920.0,111,45,38,194
13832,United States,1932.0,91,68,64,223
13833,United States,1936.0,53,29,30,112
13834,United States,1972.0,72,77,46,195
13835,United States,1984.0,190,121,50,361
13836,United States,1904.0,128,141,125,394
13837,United States,2006.0,9,11,32,52
13838,United States,2010.0,12,63,22,97
13839,United States,1988.0,89,67,58,214
13840,United States,1996.0,159,48,52,259
13841,United States,2000.0,130,61,51,242
13842,United States,1912.0,46,25,36,107
13843,United States,1900.0,30,16,17,63
13844,United States,1900.0,30,16,17,63
13845,United States,1900.0,30,16,17,63
13846,United States,1900.0,30,16,17,63
13847,United States,1900.0,30,16,17,63
13848,United States,2010.0,12,63,22,97
13849,St. Louis Southwest Turnverein #2-3,1904.0,128,141,125,394
13850,United States,1996.0,159,48,52,259
13851,United States,2012.0,145,57,46,248
13852,United States,2012.0,145,57,46,248
13853,United States,1988.0,89,67,58,214
13854,United States,2002.0,11,58,15,84
13855,United States,1992.0,94,57,87,238
13856,United States,1960.0,100,27,25,152
13857,United States,1964.0,96,39,42,177
13858,United States,2010.0,12,63,22,97
13859,United States,1928.0,53,30,19,102
13860,United States,2000.0,130,61,51,242
13861,United States,2012.0,145,57,46,248
13862,United States,2016.0,139,54,71,264
13863,United States,2008.0,127,110,80,317
13864,United States,1992.0,94,57,87,238
13865,United States,1992.0,94,57,87,238
13866,United States,1992.0,94,57,87,238
13867,United States,1996.0,159,48,52,259
13868,United States,1996.0,159,48,52,259
13869,United States,1996.0,159,48,52,259
13870,United States,2000.0,130,61,51,242
13871,United States,2000.0,130,61,51,242
13872,United States,2000.0,130,61,51,242
13873,United States,2000.0,130,61,51,242
13874,United States,2004.0,117,75,71,263
13875,United States,2004.0,117,75,71,263
13876,United States,2016.0,139,54,71,264
13877,United States,2004.0,117,75,71,263
13878,United States,2008.0,127,110,80,317
13879,United States,1948.0,93,34,41,168
13880,United States,1904.0,128,141,125,394
13881,United States,1904.0,128,141,125,394
13882,Potomac Archers,1904.0,128,141,125,394
13883,United States,1932.0,91,68,64,223
13884,United States,1932.0,91,68,64,223
13885,United States,1936.0,53,29,30,112
13886,United States,1948.0,93,34,41,168
13887,United States,1948.0,93,34,41,168
13888,Chicago Athletic Association-2,1904.0,128,141,125,394
13889,United States-1,1998.0,25,4,5,34
13890,United States-1,2002.0,11,58,15,84
13891,United States,1912.0,46,25,36,107
13892,United States,1912.0,46,25,36,107
13893,United States,1984.0,190,121,50,361
13894,United States,2016.0,139,54,71,264
13895,United States,1936.0,53,29,30,112
13896,United States,1924.0,98,46,50,194
13897,United States,1980.0,24,4,2,30
13898,United States,2008.0,127,110,80,317
13899,United States,1920.0,111,45,38,194
13900,United States,1984.0,190,121,50,361
13901,United States,1984.0,190,121,50,361
13902,United States,1988.0,89,67,58,214
13903,United States,1992.0,94,57,87,238
13904,United States,1972.0,72,77,46,195
13905,United States,2012.0,145,57,46,248
13906,United States,1984.0,190,121,50,361
13907,United States,1904.0,128,141,125,394
13908,United States,2002.0,11,58,15,84
13909,United States,1956.0,63,61,25,149
13910,United States,1960.0,100,27,25,152
13911,United States,1960.0,100,27,25,152
13912,Missouri Athletic Club-3,1904.0,128,141,125,394
13913,United States,1932.0,91,68,64,223
13914,United States,1932.0,91,68,64,223
13915,United States,2008.0,127,110,80,317
13916,United States,2012.0,145,57,46,248
13917,United States,1948.0,93,34,41,168
13918,United States-1,2010.0,12,63,22,97
13919,United States-1,2014.0,10,30,24,64
13920,United States,1948.0,93,34,41,168
13921,United States,1956.0,63,61,25,149
13922,United States,1968.0,100,37,36,173
13923,United States,1924.0,98,46,50,194
13924,United States,2004.0,117,75,71,263
13925,United States,1932.0,91,68,64,223
13926,United States,1992.0,94,57,87,238
13927,United States,1992.0,94,57,87,238
13928,United States,1992.0,94,57,87,238
13929,United States,1996.0,159,48,52,259
13930,United States,1996.0,159,48,52,259
13931,United States,1984.0,190,121,50,361
13932,United States,1988.0,89,67,58,214
13933,United States,1988.0,89,67,58,214
13934,United States,1992.0,94,57,87,238
13935,United States,2000.0,130,61,51,242
13936,United States,2000.0,130,61,51,242
13937,United States,2000.0,130,61,51,242
13938,United States,2000.0,130,61,51,242
13939,United States,2000.0,130,61,51,242
13940,United States,2008.0,127,110,80,317
13941,United States,2008.0,127,110,80,317
13942,United States,2008.0,127,110,80,317
13943,United States,1956.0,63,61,25,149
13944,Margaret,1948.0,93,34,41,168
13945,United States,1972.0,72,77,46,195
13946,United States,2008.0,127,110,80,317
13947,United States,1932.0,91,68,64,223
13948,United States,1936.0,53,29,30,112
13949,United States,1964.0,96,39,42,177
13950,United States,1904.0,128,141,125,394
13951,United States,2000.0,130,61,51,242
13952,United States,2004.0,117,75,71,263
13953,United States,2000.0,130,61,51,242
13954,United States,1984.0,190,121,50,361
13955,United States,1924.0,98,46,50,194
13956,United States,1920.0,111,45,38,194
13957,United States,1920.0,111,45,38,194
13958,United States,1992.0,94,57,87,238
13959,United States,2004.0,117,75,71,263
13960,United States,2012.0,145,57,46,248
13961,United States,2012.0,145,57,46,248
13962,United States,1960.0,100,27,25,152
13963,United States,1960.0,100,27,25,152
13964,United States,2016.0,139,54,71,264
13965,United States,1908.0,34,16,15,65
13966,United States,2004.0,117,75,71,263
13967,United States,1920.0,111,45,38,194
13968,United States-2,1928.0,53,30,19,102
13969,United States,1996.0,159,48,52,259
13970,United States,2000.0,130,61,51,242
13971,United States,1998.0,25,4,5,34
13972,United States,2002.0,11,58,15,84
13973,United States,1984.0,190,121,50,361
13974,United States,2008.0,127,110,80,317
13975,United States,1924.0,98,46,50,194
13976,United States,1992.0,94,57,87,238
13977,United States,1992.0,94,57,87,238
13978,United States,1994.0,6,8,5,19
13979,United States,1994.0,6,8,5,19
13980,United States,1948.0,93,34,41,168
13981,United States,1948.0,93,34,41,168
13982,United States,2008.0,127,110,80,317
13983,United States,1984.0,190,121,50,361
13984,United States,1984.0,190,121,50,361
13985,Chicago Athletic Association-2,1904.0,128,141,125,394
13986,Chicago Athletic Association-2,1904.0,128,141,125,394
13987,United States,1932.0,91,68,64,223
13988,United States,1932.0,91,68,64,223
13989,United States,1984.0,190,121,50,361
13990,United States,1992.0,94,57,87,238
13991,United States,1896.0,11,7,2,20
13992,United States-1,1956.0,63,61,25,149
13993,United States,1996.0,159,48,52,259
13994,United States-2,1948.0,93,34,41,168
13995,United States,1972.0,72,77,46,195
13996,United States,1964.0,96,39,42,177
13997,United States,1964.0,96,39,42,177
13998,United States,1968.0,100,37,36,173
13999,United States,1968.0,100,37,36,173
14000,United States,1952.0,87,48,29,164
14001,United States,1998.0,25,4,5,34
14002,New York Athletic Club,1904.0,128,141,125,394
14003,St. Louis Southwest Turnverein #1-2,1904.0,128,141,125,394
14004,United States,1984.0,190,121,50,361
14005,United States,1972.0,72,77,46,195
14006,United States,2016.0,139,54,71,264
14007,United States,1924.0,98,46,50,194
14008,United States,1904.0,128,141,125,394
14009,New York Athletic Club,1904.0,128,141,125,394
14010,United States,1996.0,159,48,52,259
14011,United States,1988.0,89,67,58,214
14012,United States,1992.0,94,57,87,238
14013,United States,1952.0,87,48,29,164
14014,Formosa,1900.0,30,16,17,63
14015,New York Athletic Club-1,1904.0,128,141,125,394
14016,United States,1996.0,159,48,52,259
14017,United States,1996.0,159,48,52,259
14018,United States,1996.0,159,48,52,259
14019,United States,1996.0,159,48,52,259
14020,United States,2000.0,130,61,51,242
14021,United States,2000.0,130,61,51,242
14022,United States,1904.0,128,141,125,394
14023,United States,2008.0,127,110,80,317
14024,United States,1932.0,91,68,64,223
14025,United States,1904.0,128,141,125,394
14026,United States,1904.0,128,141,125,394
14027,United States,1904.0,128,141,125,394
14028,United States,1904.0,128,141,125,394
14029,United States,1904.0,128,141,125,394
14030,United States,1932.0,91,68,64,223
14031,United States,1936.0,53,29,30,112
14032,United States,2008.0,127,110,80,317
14033,United States,2004.0,117,75,71,263
14034,United States,2008.0,127,110,80,317
14035,United States,2008.0,127,110,80,317
14036,United States,2012.0,145,57,46,248
14037,United States,2008.0,127,110,80,317
14038,United States,1984.0,190,121,50,361
14039,Atalanta Boat Club-1,1904.0,128,141,125,394
14040,Atalanta Boat Club-2,1904.0,128,141,125,394
14041,United States,2012.0,145,57,46,248
14042,United States,2000.0,130,61,51,242
14043,United States,2004.0,117,75,71,263
14044,United States,2008.0,127,110,80,317
14045,St. Louis Amateur Athletic Association,1904.0,128,141,125,394
14046,United States,2000.0,130,61,51,242
14047,United States,1996.0,159,48,52,259
14048,United States,2016.0,139,54,71,264
14049,United States,1980.0,24,4,2,30
14050,United States,1948.0,93,34,41,168
14051,United States,1904.0,128,141,125,394
14052,Chicago Athletic Association,1904.0,128,141,125,394
14053,United States,2010.0,12,63,22,97
14054,United States,2014.0,10,30,24,64
14055,United States,1992.0,94,57,87,238
14056,United States,1968.0,100,37,36,173
14057,United States,1972.0,72,77,46,195
14058,United States,1984.0,190,121,50,361
14059,United States,1984.0,190,121,50,361
14060,United States,1984.0,190,121,50,361
14061,United States,2000.0,130,61,51,242
14062,United States,2004.0,117,75,71,263
14063,United States,2008.0,127,110,80,317
14064,United States,2012.0,145,57,46,248
14065,United States,1956.0,63,61,25,149
14066,United States,1960.0,100,27,25,152
14067,United States,2000.0,130,61,51,242
14068,United States,1932.0,91,68,64,223
14069,United States,1924.0,98,46,50,194
14070,Western Rowing Club-3,1904.0,128,141,125,394
14071,United States,1976.0,73,61,41,175
14072,United States,1976.0,73,61,41,175
14073,United States,1904.0,128,141,125,394
14074,United States,1904.0,128,141,125,394
14075,United States,1904.0,128,141,125,394
14076,United States,1936.0,53,29,30,112
14077,United States,1984.0,190,121,50,361
14078,United States,2004.0,117,75,71,263
14079,United States,2012.0,145,57,46,248
14080,United States,2012.0,145,57,46,248
14081,United States,2012.0,145,57,46,248
14082,United States,2016.0,139,54,71,264
14083,United States,2016.0,139,54,71,264
14084,United States,2016.0,139,54,71,264
14085,United States,1924.0,98,46,50,194
14086,United States,2004.0,117,75,71,263
14087,United States,2008.0,127,110,80,317
14088,United States,1932.0,91,68,64,223
14089,United States,1932.0,91,68,64,223
14090,United States,1960.0,100,27,25,152
14091,United States,1960.0,100,27,25,152
14092,United States,1960.0,100,27,25,152
14093,United States,1960.0,100,27,25,152
14094,United States,2012.0,145,57,46,248
14095,United States,2004.0,117,75,71,263
14096,United States,2008.0,127,110,80,317
14097,United States,1996.0,159,48,52,259
14098,United States,2004.0,117,75,71,263
14099,United States,2008.0,127,110,80,317
14100,United States,2014.0,10,30,24,64
14101,United States,1992.0,94,57,87,238
14102,United States,1952.0,87,48,29,164
14103,United States,1956.0,63,61,25,149
14104,United States,1960.0,100,27,25,152
14105,United States,1920.0,111,45,38,194
14106,United States,1924.0,98,46,50,194
14107,United States,1984.0,190,121,50,361
14108,United States,1968.0,100,37,36,173
14109,United States,1988.0,89,67,58,214
14110,United States,2000.0,130,61,51,242
14111,United States,2000.0,130,61,51,242
14112,United States,2004.0,117,75,71,263
14113,United States,2004.0,117,75,71,263
14114,United States,2002.0,11,58,15,84
14115,United States,2006.0,9,11,32,52
14116,United States,1964.0,96,39,42,177
14117,United States,1968.0,100,37,36,173
14118,United States,1968.0,100,37,36,173
14119,United States,1904.0,128,141,125,394
14120,United States,1904.0,128,141,125,394
14121,United States,1968.0,100,37,36,173
14122,United States,2008.0,127,110,80,317
14123,United States,1956.0,63,61,25,149
14124,United States,1968.0,100,37,36,173
14125,United States,1968.0,100,37,36,173
14126,United States,1968.0,100,37,36,173
14127,United States-1,2004.0,117,75,71,263
14128,United States-1,2008.0,127,110,80,317
14129,United States-1,2012.0,145,57,46,248
14130,United States-1,2016.0,139,54,71,264
14131,United States,2008.0,127,110,80,317
14132,United States,2004.0,117,75,71,263
14133,United States,2012.0,145,57,46,248
14134,United States,1924.0,98,46,50,194
14135,United States,2004.0,117,75,71,263
14136,United States,2008.0,127,110,80,317
14137,United States,2008.0,127,110,80,317
14138,United States,2004.0,117,75,71,263
14139,United States,2008.0,127,110,80,317
14140,United States,2016.0,139,54,71,264
14141,United States,2004.0,117,75,71,263
14142,United States,2004.0,117,75,71,263
14143,United States,2008.0,127,110,80,317
14144,United States,2008.0,127,110,80,317
14145,United States,1904.0,128,141,125,394
14146,United States,1976.0,73,61,41,175
14147,United States,1960.0,100,27,25,152
14148,United States,1932.0,91,68,64,223
14149,United States-1,1936.0,53,29,30,112
14150,United States,1928.0,53,30,19,102
14151,United States,1984.0,190,121,50,361
14152,United States,2004.0,117,75,71,263
14153,United States,2008.0,127,110,80,317
14154,United States-1,1988.0,89,67,58,214
14155,United States,1964.0,96,39,42,177
14156,United States,1964.0,96,39,42,177
14157,United States,1968.0,100,37,36,173
14158,United States,1992.0,94,57,87,238
14159,United States,1992.0,94,57,87,238
14160,United States,1936.0,53,29,30,112
14161,United States,1936.0,53,29,30,112
14162,United States,1984.0,190,121,50,361
14163,United States,1984.0,190,121,50,361
14164,United States,1988.0,89,67,58,214
14165,United States,1988.0,89,67,58,214
14166,United States-4,1904.0,128,141,125,394
14167,United States-3,1904.0,128,141,125,394
14168,United States,2008.0,127,110,80,317
14169,United States,1988.0,89,67,58,214
14170,United States,1992.0,94,57,87,238
14171,United States,1984.0,190,121,50,361
14172,United States,1984.0,190,121,50,361
14173,United States,1996.0,159,48,52,259
14174,United States,1972.0,72,77,46,195
14175,United States,1992.0,94,57,87,238
14176,United States Golf Association-3,1904.0,128,141,125,394
14177,United States,2008.0,127,110,80,317
14178,United States,2008.0,127,110,80,317
14179,United States,1960.0,100,27,25,152
14180,United States,1964.0,96,39,42,177
14181,Angelita,1932.0,91,68,64,223
14182,Llanoria,1948.0,93,34,41,168
14183,United States,1924.0,98,46,50,194
14184,United States,1924.0,98,46,50,194
14185,United States,2010.0,12,63,22,97
14186,United States,2014.0,10,30,24,64
14187,United States,1920.0,111,45,38,194
14188,United States,2002.0,11,58,15,84
14189,United States,2010.0,12,63,22,97
14190,United States,1964.0,96,39,42,177
14191,United States,1976.0,73,61,41,175
14192,United States,1992.0,94,57,87,238
14193,United States,2004.0,117,75,71,263
14194,United States,2004.0,117,75,71,263
14195,United States,2012.0,145,57,46,248
14196,United States,2016.0,139,54,71,264
14197,United States,1984.0,190,121,50,361
14198,United States,1992.0,94,57,87,238
14199,United States,1924.0,98,46,50,194
14200,United States,1924.0,98,46,50,194
14201,United States,1924.0,98,46,50,194
14202,United States,1924.0,98,46,50,194
14203,United States,1928.0,53,30,19,102
14204,United States,1928.0,53,30,19,102
14205,United States,2016.0,139,54,71,264
14206,United States,2016.0,139,54,71,264
14207,United States,1972.0,72,77,46,195
14208,United States,1956.0,63,61,25,149
14209,United States,1920.0,111,45,38,194
14210,Independent Rowing Club-3,1904.0,128,141,125,394
14211,United States,2012.0,145,57,46,248
14212,United States,1980.0,24,4,2,30
14213,United States,1996.0,159,48,52,259
14214,United States,1972.0,72,77,46,195
14215,United States,1924.0,98,46,50,194
14216,United States,1912.0,46,25,36,107
14217,United States,2002.0,11,58,15,84
14218,United States,2006.0,9,11,32,52
14219,United States,2008.0,127,110,80,317
14220,United States,2012.0,145,57,46,248
14221,United States,2006.0,9,11,32,52
14222,United States,2010.0,12,63,22,97
14223,United States-3,1904.0,128,141,125,394
14224,United States,1960.0,100,27,25,152
14225,United States,1984.0,190,121,50,361
14226,United States,2012.0,145,57,46,248
14227,United States,1904.0,128,141,125,394
14228,United States,1948.0,93,34,41,168
14229,United States,2012.0,145,57,46,248
14230,United States,2016.0,139,54,71,264
14231,United States,1988.0,89,67,58,214
14232,United States,1936.0,53,29,30,112
14233,United States,2008.0,127,110,80,317
14234,United States,2004.0,117,75,71,263
14235,United States,2008.0,127,110,80,317
14236,United States,2012.0,145,57,46,248
14237,United States,1952.0,87,48,29,164
14238,United States,1984.0,190,121,50,361
14239,United States,1924.0,98,46,50,194
14240,United States,1924.0,98,46,50,194
14241,United States,1984.0,190,121,50,361
14242,Complex II,1952.0,87,48,29,164
14243,United States,1968.0,100,37,36,173
14244,United States,1936.0,53,29,30,112
14245,United States,1964.0,96,39,42,177
14246,United States,1996.0,159,48,52,259
14247,United States,2000.0,130,61,51,242
14248,United States,2006.0,9,11,32,52
14249,United States,2010.0,12,63,22,97
14250,Complex II,1952.0,87,48,29,164
14251,United States,1956.0,63,61,25,149
14252,United States,1964.0,96,39,42,177
14253,United States-1,2010.0,12,63,22,97
14254,United States-1,2014.0,10,30,24,64
14255,United States,2014.0,10,30,24,64
14256,United States,1948.0,93,34,41,168
14257,United States,1948.0,93,34,41,168
14258,United States,1948.0,93,34,41,168
14259,United States,1952.0,87,48,29,164
14260,United States,1952.0,87,48,29,164
14261,United States-2,1996.0,159,48,52,259
14262,United States,1996.0,159,48,52,259
14263,United States,1912.0,46,25,36,107
14264,United States,2010.0,12,63,22,97
14265,Llanoria,1952.0,87,48,29,164
14266,Llanoria,1948.0,93,34,41,168
14267,Llanoria,1952.0,87,48,29,164
14268,United States,1900.0,30,16,17,63
14269,United States,1998.0,25,4,5,34
14270,United States,1968.0,100,37,36,173
14271,United States,1968.0,100,37,36,173
14272,United States,2012.0,145,57,46,248
14273,United States,2000.0,130,61,51,242
14274,United States,1952.0,87,48,29,164
14275,United States,1964.0,96,39,42,177
14276,United States,1964.0,96,39,42,177
14277,United States,1972.0,72,77,46,195
14278,United States,1956.0,63,61,25,149
14279,United States-1,1924.0,98,46,50,194
14280,United States-1,1924.0,98,46,50,194
14281,United States,1972.0,72,77,46,195
14282,United States,2004.0,117,75,71,263
14283,United States,2008.0,127,110,80,317
14284,United States,1932.0,91,68,64,223
14285,United States,2008.0,127,110,80,317
14286,United States,1904.0,128,141,125,394
14287,United States,1904.0,128,141,125,394
14288,United States,1928.0,53,30,19,102
14289,United States,2000.0,130,61,51,242
14290,United States,2000.0,130,61,51,242
14291,United States,1904.0,128,141,125,394
14292,United States,1976.0,73,61,41,175
14293,United States,1984.0,190,121,50,361
14294,United States,2000.0,130,61,51,242
14295,United States,1948.0,93,34,41,168
14296,United States,1964.0,96,39,42,177
14297,United States,1924.0,98,46,50,194
14298,United States,1936.0,53,29,30,112
14299,Kathleen,1956.0,63,61,25,149
14300,United States,1996.0,159,48,52,259
14301,United States,2000.0,130,61,51,242
14302,United States,2008.0,127,110,80,317
14303,United States,2012.0,145,57,46,248
14304,United States-1,1924.0,98,46,50,194
14305,United States,1952.0,87,48,29,164
14306,United States,2008.0,127,110,80,317
14307,United States,1996.0,159,48,52,259
14308,United States,1972.0,72,77,46,195
14309,United States,2004.0,117,75,71,263
14310,United States,2004.0,117,75,71,263
14311,United States,2012.0,145,57,46,248
14312,United States-1,2014.0,10,30,24,64
14313,Glider,1964.0,96,39,42,177
14314,United States,1960.0,100,27,25,152
14315,United States,2000.0,130,61,51,242
14316,United States,1972.0,72,77,46,195
14317,United States,1976.0,73,61,41,175
14318,United States,1904.0,128,141,125,394
14319,United States,1904.0,128,141,125,394
14320,Potomac Archers,1904.0,128,141,125,394
14321,United States,2000.0,130,61,51,242
14322,United States-2,2008.0,127,110,80,317
14323,United States,2012.0,145,57,46,248
14324,United States-1,2012.0,145,57,46,248
14325,United States,2004.0,117,75,71,263
14326,United States,2000.0,130,61,51,242
14327,United States,1960.0,100,27,25,152
14328,United States,1964.0,96,39,42,177
14329,United States,2000.0,130,61,51,242
14330,United States,2000.0,130,61,51,242
14331,United States-2,2008.0,127,110,80,317
14332,United States-1,2012.0,145,57,46,248
14333,United States-1,2016.0,139,54,71,264
14334,United States,1988.0,89,67,58,214
14335,United States,2000.0,130,61,51,242
14336,United States,2004.0,117,75,71,263
14337,United States,2000.0,130,61,51,242
14338,United States,2004.0,117,75,71,263
14339,United States,2004.0,117,75,71,263
14340,United States,2008.0,127,110,80,317
14341,United States,1924.0,98,46,50,194
14342,United States-1,1924.0,98,46,50,194
14343,United States,1924.0,98,46,50,194
14344,United States,2004.0,117,75,71,263
14345,United States,2010.0,12,63,22,97
14346,United States,1984.0,190,121,50,361
14347,United States,1988.0,89,67,58,214
14348,United States,1984.0,190,121,50,361
14349,United States,1984.0,190,121,50,361
14350,United States,1976.0,73,61,41,175
14351,United States,1924.0,98,46,50,194
14352,United States,1936.0,53,29,30,112
14353,United States,1964.0,96,39,42,177
14354,United States,1996.0,159,48,52,259
14355,United States,1904.0,128,141,125,394
14356,United States,1960.0,100,27,25,152
14357,United States,1996.0,159,48,52,259
14358,United States,1908.0,34,16,15,65
14359,United States,1912.0,46,25,36,107
14360,United States,1912.0,46,25,36,107
14361,United States,1908.0,34,16,15,65
14362,United States,2008.0,127,110,80,317
14363,United States,2012.0,145,57,46,248
14364,United States,2008.0,127,110,80,317
14365,United States,1904.0,128,141,125,394
14366,United States,1904.0,128,141,125,394
14367,United States,1960.0,100,27,25,152
14368,United States,2014.0,10,30,24,64
14369,United States,2008.0,127,110,80,317
14370,United States,1948.0,93,34,41,168
14371,United States,1952.0,87,48,29,164
14372,United States,1998.0,25,4,5,34
14373,United States,1998.0,25,4,5,34
14374,United States,2002.0,11,58,15,84
14375,United States,1968.0,100,37,36,173
14376,United States,1972.0,72,77,46,195
14377,United States,1952.0,87,48,29,164
14378,United States,1976.0,73,61,41,175
14379,"New York Turnverein, New York",1904.0,128,141,125,394
14380,United States,1936.0,53,29,30,112
14381,United States,1948.0,93,34,41,168
14382,United States,1952.0,87,48,29,164
14383,United States,1932.0,91,68,64,223
14384,United States,1932.0,91,68,64,223
14385,United States,2000.0,130,61,51,242
14386,United States,1976.0,73,61,41,175
14387,United States,1960.0,100,27,25,152
14388,United States,1960.0,100,27,25,152
14389,United States,1984.0,190,121,50,361
14390,United States,1968.0,100,37,36,173
14391,Western Golf Association-1,1904.0,128,141,125,394
14392,United States,1984.0,190,121,50,361
14393,United States,1920.0,111,45,38,194
14394,United States,1920.0,111,45,38,194
14395,United States,1984.0,190,121,50,361
14396,United States,1920.0,111,45,38,194
14397,Cincinnati Archers,1904.0,128,141,125,394
14398,Cincinnati Archers,1904.0,128,141,125,394
14399,United States,1936.0,53,29,30,112
14400,St. Louis Amateur Athletic Association,1904.0,128,141,125,394
14401,United States,1968.0,100,37,36,173
14402,United States,1972.0,72,77,46,195
14403,United States,1984.0,190,121,50,361
14404,United States,2004.0,117,75,71,263
14405,United States,1952.0,87,48,29,164
14406,United States,1956.0,63,61,25,149
14407,United States,1928.0,53,30,19,102
14408,United States,2016.0,139,54,71,264
14409,United States,1948.0,93,34,41,168
14410,United States,1972.0,72,77,46,195
14411,United States,2016.0,139,54,71,264
14412,United States,1920.0,111,45,38,194
14413,United States,2008.0,127,110,80,317
14414,United States,1904.0,128,141,125,394
14415,United States-1,1904.0,128,141,125,394
14416,United States,1976.0,73,61,41,175
14417,United States,1920.0,111,45,38,194
14418,United States,1920.0,111,45,38,194
14419,United States,1948.0,93,34,41,168
14420,United States,1912.0,46,25,36,107
14421,A North American Team,1900.0,30,16,17,63
14422,United States,1968.0,100,37,36,173
14423,United States,1968.0,100,37,36,173
14424,United States,1972.0,72,77,46,195
14425,United States,2012.0,145,57,46,248
14426,United States,2000.0,130,61,51,242
14427,United States,2000.0,130,61,51,242
14428,United States,1924.0,98,46,50,194
14429,United States,1928.0,53,30,19,102
14430,United States,1928.0,53,30,19,102
14431,United States,1932.0,91,68,64,223
14432,United States,1936.0,53,29,30,112
14433,United States,1984.0,190,121,50,361
14434,United States,2004.0,117,75,71,263
14435,United States,1992.0,94,57,87,238
14436,United States,1952.0,87,48,29,164
14437,United States,1992.0,94,57,87,238
14438,United States,1960.0,100,27,25,152
14439,United States,2002.0,11,58,15,84
14440,United States,1956.0,63,61,25,149
14441,United States,1904.0,128,141,125,394
14442,United States,1936.0,53,29,30,112
14443,United States,1952.0,87,48,29,164
14444,United States,1988.0,89,67,58,214
14445,United States,1992.0,94,57,87,238
14446,United States,1928.0,53,30,19,102
14447,United States,1960.0,100,27,25,152
14448,United States,2000.0,130,61,51,242
14449,United States,1968.0,100,37,36,173
14450,United States,2004.0,117,75,71,263
14451,United States,1992.0,94,57,87,238
14452,United States,1968.0,100,37,36,173
14453,United States,1972.0,72,77,46,195
14454,United States,1932.0,91,68,64,223
14455,United States,2002.0,11,58,15,84
14456,United States,1976.0,73,61,41,175
14457,United States,1976.0,73,61,41,175
14458,United States,1976.0,73,61,41,175
14459,United States,2000.0,130,61,51,242
14460,United States,1996.0,159,48,52,259
14461,United States,1968.0,100,37,36,173
14462,United States-2,2004.0,117,75,71,263
14463,United States,2004.0,117,75,71,263
14464,United States,2008.0,127,110,80,317
14465,United States,2008.0,127,110,80,317
14466,United States,2016.0,139,54,71,264
14467,United States,2004.0,117,75,71,263
14468,United States,1932.0,91,68,64,223
14469,United States,2010.0,12,63,22,97
14470,United States,1988.0,89,67,58,214
14471,United States,1992.0,94,57,87,238
14472,United States,1992.0,94,57,87,238
14473,United States,1994.0,6,8,5,19
14474,United States,1948.0,93,34,41,168
14475,United States,1964.0,96,39,42,177
14476,United States,1904.0,128,141,125,394
14477,United States,1992.0,94,57,87,238
14478,United States,1976.0,73,61,41,175
14479,United States,1968.0,100,37,36,173
14480,Hungary,1992.0,14,23,8,45
14481,Hungary,1936.0,25,1,17,43
14482,Hungary,1988.0,20,9,15,44
14483,Hungary,1988.0,20,9,15,44
14484,Hungary,1992.0,14,23,8,45
14485,Hungary,1996.0,8,9,26,43
14486,Hungary,1964.0,42,7,7,56
14487,Hungary,1960.0,13,16,37,66
14488,Hungary,1964.0,42,7,7,56
14489,Hungary,1976.0,14,6,35,55
14490,Hungary,1952.0,53,17,34,104
14491,Hungary,1964.0,42,7,7,56
14492,Hungary,1912.0,10,17,3,30
14493,Hungary,1976.0,14,6,35,55
14494,Hungary,1980.0,8,15,40,63
14495,Hungary,1924.0,2,12,8,22
14496,Hungary,1968.0,32,20,29,81
14497,Hungary,1972.0,10,46,25,81
14498,Hungary,1972.0,10,46,25,81
14499,Hungary,1976.0,14,6,35,55
14500,Hungary,1968.0,32,20,29,81
14501,Hungary,1972.0,10,46,25,81
14502,Hungary,1968.0,32,20,29,81
14503,Hungary,1948.0,15,27,22,64
14504,Hungary,1960.0,13,16,37,66
14505,Hungary,1968.0,32,20,29,81
14506,Hungary,1968.0,32,20,29,81
14507,Hungary,1972.0,10,46,25,81
14508,Hungary,1972.0,10,46,25,81
14509,Hungary,1972.0,10,46,25,81
14510,Hungary,1976.0,14,6,35,55
14511,Hungary,1980.0,8,15,40,63
14512,Hungary,1952.0,53,17,34,104
14513,Hungary,2000.0,25,24,4,53
14514,Hungary,2000.0,25,24,4,53
14515,Hungary,1956.0,30,20,16,66
14516,Hungary,1960.0,13,16,37,66
14517,Hungary,1964.0,42,7,7,56
14518,Hungary,1928.0,10,11,0,21
14519,Hungary,1932.0,20,5,10,35
14520,Hungary,1948.0,15,27,22,64
14521,Hungary,2000.0,25,24,4,53
14522,Hungary,1928.0,10,11,0,21
14523,Hungary,1932.0,20,5,10,35
14524,Hungary,2000.0,25,24,4,53
14525,Hungary,1924.0,2,12,8,22
14526,Hungary,1968.0,32,20,29,81
14527,Hungary,1900.0,1,2,2,5
14528,Hungary,1972.0,10,46,25,81
14529,Hungary,1912.0,10,17,3,30
14530,Hungary,1964.0,42,7,7,56
14531,Hungary,1952.0,53,17,34,104
14532,Hungary,1952.0,53,17,34,104
14533,Hungary,1972.0,10,46,25,81
14534,Hungary,2000.0,25,24,4,53
14535,Hungary,2004.0,24,12,4,40
14536,Hungary,2008.0,16,8,3,27
14537,Hungary,1936.0,25,1,17,43
14538,Hungary,1948.0,15,27,22,64
14539,Hungary,1952.0,53,17,34,104
14540,Hungary,1952.0,53,17,34,104
14541,Hungary,1952.0,53,17,34,104
14542,Hungary,1992.0,14,23,8,45
14543,Hungary,1912.0,10,17,3,30
14544,Hungary,2012.0,12,8,6,26
14545,Hungary,1912.0,10,17,3,30
14546,Hungary,1924.0,2,12,8,22
14547,Hungary,1924.0,2,12,8,22
14548,Hungary,1956.0,30,20,16,66
14549,Hungary,1976.0,14,6,35,55
14550,Hungary,1936.0,25,1,17,43
14551,Hungary,2000.0,25,24,4,53
14552,Hungary,2004.0,24,12,4,40
14553,Hungary,2008.0,16,8,3,27
14554,Hungary,1948.0,15,27,22,64
14555,Hungary,2004.0,24,12,4,40
14556,Hungary,2016.0,12,3,7,22
14557,Hungary,1960.0,13,16,37,66
14558,Hungary,1964.0,42,7,7,56
14559,Hungary,1968.0,32,20,29,81
14560,Hungary,1972.0,10,46,25,81
14561,Hungary,1952.0,53,17,34,104
14562,Hungary,1952.0,53,17,34,104
14563,Hungary,1956.0,30,20,16,66
14564,Hungary,1956.0,30,20,16,66
14565,Hungary,1908.0,7,7,6,20
14566,Hungary,1932.0,20,5,10,35
14567,Hungary,1952.0,53,17,34,104
14568,Hungary,1956.0,30,20,16,66
14569,Hungary,1988.0,20,9,15,44
14570,Hungary,1956.0,30,20,16,66
14571,Hungary,1960.0,13,16,37,66
14572,Hungary,1964.0,42,7,7,56
14573,Hungary,2004.0,24,12,4,40
14574,Hungary,1972.0,10,46,25,81
14575,Hungary,1936.0,25,1,17,43
14576,Hungary,1952.0,53,17,34,104
14577,Hungary,1936.0,25,1,17,43
14578,Hungary,1948.0,15,27,22,64
14579,Hungary,1972.0,10,46,25,81
14580,Hungary,1932.0,20,5,10,35
14581,Hungary,1936.0,25,1,17,43
14582,Hungary,1952.0,53,17,34,104
14583,Hungary,1976.0,14,6,35,55
14584,Hungary,1976.0,14,6,35,55
14585,Hungary,1976.0,14,6,35,55
14586,Hungary,1988.0,20,9,15,44
14587,Hungary,1992.0,14,23,8,45
14588,Hungary,1988.0,20,9,15,44
14589,Hungary,1952.0,53,17,34,104
14590,Hungary,1936.0,25,1,17,43
14591,Hungary,1992.0,14,23,8,45
14592,Hungary,1952.0,53,17,34,104
14593,Hungary,1976.0,14,6,35,55
14594,Hungary,1980.0,8,15,40,63
14595,Hungary,1972.0,10,46,25,81
14596,Hungary,1976.0,14,6,35,55
14597,Hungary,1972.0,10,46,25,81
14598,Hungary,1968.0,32,20,29,81
14599,Hungary,1972.0,10,46,25,81
14600,Hungary,2004.0,24,12,4,40
14601,Hungary,2008.0,16,8,3,27
14602,Hungary,2008.0,16,8,3,27
14603,Hungary,2008.0,16,8,3,27
14604,Hungary,2012.0,12,8,6,26
14605,Hungary,2016.0,12,3,7,22
14606,Hungary,1952.0,53,17,34,104
14607,Hungary,1968.0,32,20,29,81
14608,Hungary,1964.0,42,7,7,56
14609,Hungary,2012.0,12,8,6,26
14610,Hungary,1972.0,10,46,25,81
14611,Hungary,1976.0,14,6,35,55
14612,Hungary,1936.0,25,1,17,43
14613,Hungary,1936.0,25,1,17,43
14614,Hungary,1948.0,15,27,22,64
14615,Hungary,1936.0,25,1,17,43
14616,Hungary,1988.0,20,9,15,44
14617,Hungary,1988.0,20,9,15,44
14618,Hungary,1992.0,14,23,8,45
14619,Hungary,1996.0,8,9,26,43
14620,Hungary,2016.0,12,3,7,22
14621,Hungary,1968.0,32,20,29,81
14622,Hungary,1996.0,8,9,26,43
14623,Hungary,2000.0,25,24,4,53
14624,Hungary,1988.0,20,9,15,44
14625,Hungary,1952.0,53,17,34,104
14626,Hungary,1992.0,14,23,8,45
14627,Hungary,1948.0,15,27,22,64
14628,Hungary,1992.0,14,23,8,45
14629,Hungary,1996.0,8,9,26,43
14630,Hungary,1952.0,53,17,34,104
14631,Hungary,1992.0,14,23,8,45
14632,Hungary,1952.0,53,17,34,104
14633,Hungary,1960.0,13,16,37,66
14634,Hungary,1896.0,2,1,3,6
14635,Hungary,1988.0,20,9,15,44
14636,Hungary,1988.0,20,9,15,44
14637,Hungary,1992.0,14,23,8,45
14638,Hungary,1992.0,14,23,8,45
14639,Hungary,1906.0,5,5,3,13
14640,Hungary,2000.0,25,24,4,53
14641,Hungary,1960.0,13,16,37,66
14642,Hungary,1972.0,10,46,25,81
14643,Hungary,1980.0,8,15,40,63
14644,Hungary,1980.0,8,15,40,63
14645,Hungary,2012.0,12,8,6,26
14646,Hungary,1960.0,13,16,37,66
14647,Hungary,1964.0,42,7,7,56
14648,Hungary,1968.0,32,20,29,81
14649,Hungary,1960.0,13,16,37,66
14650,Hungary,1964.0,42,7,7,56
14651,Hungary,1968.0,32,20,29,81
14652,Hungary,1980.0,8,15,40,63
14653,Hungary,1992.0,14,23,8,45
14654,Hungary,1992.0,14,23,8,45
14655,Hungary,2004.0,24,12,4,40
14656,Hungary,2004.0,24,12,4,40
14657,Hungary,2008.0,16,8,3,27
14658,Hungary,2008.0,16,8,3,27
14659,Hungary,2012.0,12,8,6,26
14660,Hungary,2012.0,12,8,6,26
14661,Hungary,1964.0,42,7,7,56
14662,Hungary,1960.0,13,16,37,66
14663,Hungary,1968.0,32,20,29,81
14664,Hungary,1972.0,10,46,25,81
14665,Hungary,1972.0,10,46,25,81
14666,Hungary,1960.0,13,16,37,66
14667,Hungary,1968.0,32,20,29,81
14668,Hungary,1988.0,20,9,15,44
14669,Hungary,1988.0,20,9,15,44
14670,Hungary,1992.0,14,23,8,45
14671,Hungary,1992.0,14,23,8,45
14672,Hungary,1992.0,14,23,8,45
14673,Hungary,1996.0,8,9,26,43
14674,Hungary,1996.0,8,9,26,43
14675,Hungary,1976.0,14,6,35,55
14676,Hungary,1960.0,13,16,37,66
14677,Hungary,1936.0,25,1,17,43
14678,Hungary,1948.0,15,27,22,64
14679,Hungary,1952.0,53,17,34,104
14680,Hungary,1932.0,20,5,10,35
14681,Hungary,2000.0,25,24,4,53
14682,Hungary,1912.0,10,17,3,30
14683,Hungary,1996.0,8,9,26,43
14684,Hungary,1972.0,10,46,25,81
14685,Hungary,1906.0,5,5,3,13
14686,Hungary,1988.0,20,9,15,44
14687,Hungary,1948.0,15,27,22,64
14688,Hungary,1952.0,53,17,34,104
14689,Hungary,1988.0,20,9,15,44
14690,Hungary,1956.0,30,20,16,66
14691,Hungary,1960.0,13,16,37,66
14692,Hungary,1972.0,10,46,25,81
14693,Hungary,1976.0,14,6,35,55
14694,Hungary,1980.0,8,15,40,63
14695,Hungary,2000.0,25,24,4,53
14696,Hungary,1996.0,8,9,26,43
14697,Hungary,2000.0,25,24,4,53
14698,Hungary,1956.0,30,20,16,66
14699,Hungary,1960.0,13,16,37,66
14700,Hungary,1964.0,42,7,7,56
14701,Hungary,1992.0,14,23,8,45
14702,Hungary,1968.0,32,20,29,81
14703,Hungary,1972.0,10,46,25,81
14704,Hungary,1972.0,10,46,25,81
14705,Hungary,1976.0,14,6,35,55
14706,Hungary,1968.0,32,20,29,81
14707,Hungary,1968.0,32,20,29,81
14708,Hungary,2012.0,12,8,6,26
14709,Hungary,2016.0,12,3,7,22
14710,Hungary,1948.0,15,27,22,64
14711,Hungary,1948.0,15,27,22,64
14712,Hungary,1960.0,13,16,37,66
14713,Hungary,1964.0,42,7,7,56
14714,Hungary,1968.0,32,20,29,81
14715,Hungary,1968.0,32,20,29,81
14716,Hungary,1972.0,10,46,25,81
14717,Hungary,1972.0,10,46,25,81
14718,Hungary,1948.0,15,27,22,64
14719,Hungary,1996.0,8,9,26,43
14720,Hungary,1992.0,14,23,8,45
14721,Hungary,2000.0,25,24,4,53
14722,Hungary,2004.0,24,12,4,40
14723,Hungary,2008.0,16,8,3,27
14724,Hungary,1908.0,7,7,6,20
14725,Hungary,1912.0,10,17,3,30
14726,Hungary,1948.0,15,27,22,64
14727,Hungary,1952.0,53,17,34,104
14728,Hungary,1964.0,42,7,7,56
14729,Hungary,1968.0,32,20,29,81
14730,Hungary,1972.0,10,46,25,81
14731,Hungary,1980.0,8,15,40,63
14732,Hungary,1912.0,10,17,3,30
14733,Hungary,1976.0,14,6,35,55
14734,Hungary,1976.0,14,6,35,55
14735,Hungary,1908.0,7,7,6,20
14736,Hungary,1908.0,7,7,6,20
14737,Hungary,1912.0,10,17,3,30
14738,Hungary,1912.0,10,17,3,30
14739,Hungary,1956.0,30,20,16,66
14740,Hungary,1964.0,42,7,7,56
14741,Hungary,1924.0,2,12,8,22
14742,Hungary,1924.0,2,12,8,22
14743,Hungary,1928.0,10,11,0,21
14744,Hungary,1988.0,20,9,15,44
14745,Hungary,1988.0,20,9,15,44
14746,Hungary,1972.0,10,46,25,81
14747,Hungary,1972.0,10,46,25,81
14748,Hungary,1980.0,8,15,40,63
14749,Hungary,1980.0,8,15,40,63
14750,Hungary,1988.0,20,9,15,44
14751,Hungary,1964.0,42,7,7,56
14752,Hungary,1912.0,10,17,3,30
14753,Hungary,1948.0,15,27,22,64
14754,Hungary,1952.0,53,17,34,104
14755,Hungary,1952.0,53,17,34,104
14756,Hungary,1952.0,53,17,34,104
14757,Hungary,1908.0,7,7,6,20
14758,Hungary,1912.0,10,17,3,30
14759,Hungary,1976.0,14,6,35,55
14760,Hungary,1980.0,8,15,40,63
14761,Hungary,1932.0,20,5,10,35
14762,Hungary,1936.0,25,1,17,43
14763,Hungary,1936.0,25,1,17,43
14764,Hungary,1948.0,15,27,22,64
14765,Hungary,1948.0,15,27,22,64
14766,Hungary,1952.0,53,17,34,104
14767,Hungary,1952.0,53,17,34,104
14768,Hungary,1952.0,53,17,34,104
14769,Hungary,1956.0,30,20,16,66
14770,Hungary,1960.0,13,16,37,66
14771,Hungary,1972.0,10,46,25,81
14772,Hungary,1980.0,8,15,40,63
14773,Hungary,2004.0,24,12,4,40
14774,Hungary,2008.0,16,8,3,27
14775,Hungary,1968.0,32,20,29,81
14776,Hungary,1968.0,32,20,29,81
14777,Hungary,1928.0,10,11,0,21
14778,Hungary,1932.0,20,5,10,35
14779,Hungary,1952.0,53,17,34,104
14780,Hungary,1928.0,10,11,0,21
14781,Hungary,1900.0,1,2,2,5
14782,Hungary,1906.0,5,5,3,13
14783,Hungary,1972.0,10,46,25,81
14784,Hungary,1960.0,13,16,37,66
14785,Hungary,1936.0,25,1,17,43
14786,Hungary,1952.0,53,17,34,104
14787,Hungary,1980.0,8,15,40,63
14788,Hungary,1968.0,32,20,29,81
14789,Hungary,1948.0,15,27,22,64
14790,Hungary,1952.0,53,17,34,104
14791,Hungary,1952.0,53,17,34,104
14792,Hungary,1956.0,30,20,16,66
14793,Hungary,1956.0,30,20,16,66
14794,Hungary,1952.0,53,17,34,104
14795,Hungary,1952.0,53,17,34,104
14796,Hungary,1988.0,20,9,15,44
14797,Hungary,1996.0,8,9,26,43
14798,Hungary,1972.0,10,46,25,81
14799,Hungary,1972.0,10,46,25,81
14800,Hungary,1948.0,15,27,22,64
14801,Hungary,1952.0,53,17,34,104
14802,Hungary,1956.0,30,20,16,66
14803,Hungary,1960.0,13,16,37,66
14804,Hungary,1964.0,42,7,7,56
14805,Hungary,1948.0,15,27,22,64
14806,Hungary,1952.0,53,17,34,104
14807,Hungary,1948.0,15,27,22,64
14808,Hungary,1988.0,20,9,15,44
14809,Hungary,1988.0,20,9,15,44
14810,Hungary,1992.0,14,23,8,45
14811,Hungary,1992.0,14,23,8,45
14812,Hungary,1956.0,30,20,16,66
14813,Hungary,2004.0,24,12,4,40
14814,Hungary,2012.0,12,8,6,26
14815,Hungary,1896.0,2,1,3,6
14816,Hungary,1896.0,2,1,3,6
14817,Hungary,1924.0,2,12,8,22
14818,Hungary,1906.0,5,5,3,13
14819,Hungary,1992.0,14,23,8,45
14820,Hungary,1928.0,10,11,0,21
14821,Hungary,1932.0,20,5,10,35
14822,Hungary,1936.0,25,1,17,43
14823,Hungary,1924.0,2,12,8,22
14824,Hungary,1912.0,10,17,3,30
14825,Hungary,1980.0,8,15,40,63
14826,Hungary,1964.0,42,7,7,56
14827,Hungary,1964.0,42,7,7,56
14828,Hungary,1968.0,32,20,29,81
14829,Hungary,1956.0,30,20,16,66
14830,Hungary,1936.0,25,1,17,43
14831,Hungary,1972.0,10,46,25,81
14832,Hungary,1952.0,53,17,34,104
14833,Hungary,1956.0,30,20,16,66
14834,Hungary,2012.0,12,8,6,26
14835,Hungary,1980.0,8,15,40,63
14836,Hungary,1936.0,25,1,17,43
14837,Hungary,1972.0,10,46,25,81
14838,Hungary,1992.0,14,23,8,45
14839,Hungary,1912.0,10,17,3,30
14840,Hungary,1912.0,10,17,3,30
14841,Hungary,1956.0,30,20,16,66
14842,Hungary,1964.0,42,7,7,56
14843,Hungary,1968.0,32,20,29,81
14844,Hungary,1956.0,30,20,16,66
14845,Hungary,1960.0,13,16,37,66
14846,Hungary,1952.0,53,17,34,104
14847,Hungary,1952.0,53,17,34,104
14848,Hungary,1988.0,20,9,15,44
14849,Hungary,1996.0,8,9,26,43
14850,Hungary,1972.0,10,46,25,81
14851,Hungary,1948.0,15,27,22,64
14852,Hungary,1906.0,5,5,3,13
14853,Hungary,1928.0,10,11,0,21
14854,Hungary,1932.0,20,5,10,35
14855,Hungary,1936.0,25,1,17,43
14856,Hungary,1976.0,14,6,35,55
14857,Hungary,1980.0,8,15,40,63
14858,Hungary,1996.0,8,9,26,43
14859,Hungary,1996.0,8,9,26,43
14860,Hungary,1996.0,8,9,26,43
14861,Hungary,2000.0,25,24,4,53
14862,Hungary,2004.0,24,12,4,40
14863,Hungary,1972.0,10,46,25,81
14864,Hungary,1980.0,8,15,40,63
14865,Hungary,1960.0,13,16,37,66
14866,Hungary,1960.0,13,16,37,66
14867,Hungary,1976.0,14,6,35,55
14868,Hungary,2008.0,16,8,3,27
14869,Hungary,2016.0,12,3,7,22
14870,Hungary,2016.0,12,3,7,22
14871,Hungary,2016.0,12,3,7,22
14872,Hungary,2016.0,12,3,7,22
14873,Hungary,1956.0,30,20,16,66
14874,Hungary,2000.0,25,24,4,53
14875,Hungary,2004.0,24,12,4,40
14876,Hungary,1964.0,42,7,7,56
14877,Hungary,1996.0,8,9,26,43
14878,Hungary,2004.0,24,12,4,40
14879,Hungary,2016.0,12,3,7,22
14880,Hungary,2016.0,12,3,7,22
14881,Hungary,1988.0,20,9,15,44
14882,Hungary,1928.0,10,11,0,21
14883,Hungary,1932.0,20,5,10,35
14884,Hungary,1988.0,20,9,15,44
14885,Hungary,1988.0,20,9,15,44
14886,Hungary,1948.0,15,27,22,64
14887,Hungary,1952.0,53,17,34,104
14888,Hungary,1956.0,30,20,16,66
14889,Hungary,1960.0,13,16,37,66
14890,Hungary,1980.0,8,15,40,63
14891,Hungary,1968.0,32,20,29,81
14892,Hungary,1972.0,10,46,25,81
14893,Hungary,1960.0,13,16,37,66
14894,Hungary,1964.0,42,7,7,56
14895,Hungary,1932.0,20,5,10,35
14896,Hungary,1932.0,20,5,10,35
14897,Hungary,1936.0,25,1,17,43
14898,Hungary,1936.0,25,1,17,43
14899,Hungary,1948.0,15,27,22,64
14900,Hungary,1948.0,15,27,22,64
14901,Hungary,1972.0,10,46,25,81
14902,Hungary,1968.0,32,20,29,81
14903,Hungary,1936.0,25,1,17,43
14904,Hungary,2000.0,25,24,4,53
14905,Hungary,2000.0,25,24,4,53
14906,Hungary,2004.0,24,12,4,40
14907,Hungary,2012.0,12,8,6,26
14908,Hungary,1968.0,32,20,29,81
14909,Hungary,1972.0,10,46,25,81
14910,Hungary,1976.0,14,6,35,55
14911,Hungary,1956.0,30,20,16,66
14912,Hungary,1960.0,13,16,37,66
14913,Hungary,1964.0,42,7,7,56
14914,Hungary,1996.0,8,9,26,43
14915,Hungary,2000.0,25,24,4,53
14916,Hungary,2016.0,12,3,7,22
14917,Hungary,1948.0,15,27,22,64
14918,Hungary,1952.0,53,17,34,104
14919,Hungary,1952.0,53,17,34,104
14920,Hungary,1952.0,53,17,34,104
14921,Hungary,1956.0,30,20,16,66
14922,Hungary,1960.0,13,16,37,66
14923,Hungary,1964.0,42,7,7,56
14924,Hungary,1932.0,20,5,10,35
14925,Hungary,1936.0,25,1,17,43
14926,Hungary,1948.0,15,27,22,64
14927,Hungary,1952.0,53,17,34,104
14928,Hungary,1956.0,30,20,16,66
14929,Hungary,1956.0,30,20,16,66
14930,Hungary,1960.0,13,16,37,66
14931,Hungary,1960.0,13,16,37,66
14932,Hungary,2000.0,25,24,4,53
14933,Hungary,2004.0,24,12,4,40
14934,Hungary,2008.0,16,8,3,27
14935,Hungary,1972.0,10,46,25,81
14936,Hungary,1960.0,13,16,37,66
14937,Hungary,1964.0,42,7,7,56
14938,Hungary,1964.0,42,7,7,56
14939,Hungary,1968.0,32,20,29,81
14940,Hungary-1,1948.0,15,27,22,64
14941,Hungary,1972.0,10,46,25,81
14942,Hungary,1980.0,8,15,40,63
14943,Hungary,1952.0,53,17,34,104
14944,Hungary,1952.0,53,17,34,104
14945,Hungary,1952.0,53,17,34,104
14946,Hungary,1952.0,53,17,34,104
14947,Hungary,1956.0,30,20,16,66
14948,Hungary,1956.0,30,20,16,66
14949,Hungary,1956.0,30,20,16,66
14950,Hungary,1956.0,30,20,16,66
14951,Hungary,1956.0,30,20,16,66
14952,Hungary,1956.0,30,20,16,66
14953,Hungary,1896.0,2,1,3,6
14954,Hungary,1960.0,13,16,37,66
14955,Hungary,2016.0,12,3,7,22
14956,Hungary,1976.0,14,6,35,55
14957,Hungary,1956.0,30,20,16,66
14958,Hungary,1924.0,2,12,8,22
14959,Hungary,1928.0,10,11,0,21
14960,Hungary,1912.0,10,17,3,30
14961,Hungary,1956.0,30,20,16,66
14962,Hungary,1956.0,30,20,16,66
14963,Hungary,1972.0,10,46,25,81
14964,Hungary,1928.0,10,11,0,21
14965,Hungary,1932.0,20,5,10,35
14966,Hungary,1928.0,10,11,0,21
14967,Hungary,1932.0,20,5,10,35
14968,Hungary,1980.0,8,15,40,63
14969,Hungary-1,1948.0,15,27,22,64
14970,Hungary,2008.0,16,8,3,27
14971,Hungary,1968.0,32,20,29,81
14972,Hungary,1996.0,8,9,26,43
14973,Hungary,1972.0,10,46,25,81
14974,Hungary,2000.0,25,24,4,53
14975,Hungary,2004.0,24,12,4,40
14976,Hungary,2008.0,16,8,3,27
14977,Hungary,1904.0,2,1,1,4
14978,Hungary,1904.0,2,1,1,4
14979,Hungary,1906.0,5,5,3,13
14980,Hungary,1980.0,8,15,40,63
14981,Hungary,1956.0,30,20,16,66
14982,Hungary,2008.0,16,8,3,27
14983,Hungary,1968.0,32,20,29,81
14984,Hungary,1972.0,10,46,25,81
14985,Hungary,1988.0,20,9,15,44
14986,Hungary,1992.0,14,23,8,45
14987,Hungary,1992.0,14,23,8,45
14988,Hungary,1992.0,14,23,8,45
14989,Hungary,1996.0,8,9,26,43
14990,Hungary,2000.0,25,24,4,53
14991,Hungary,1928.0,10,11,0,21
14992,Hungary,1996.0,8,9,26,43
14993,Hungary,1980.0,8,15,40,63
14994,Hungary,1968.0,32,20,29,81
14995,Hungary,1972.0,10,46,25,81
14996,Hungary,1952.0,53,17,34,104
14997,Hungary,1912.0,10,17,3,30
14998,Hungary,1996.0,8,9,26,43
14999,Hungary,2000.0,25,24,4,53
15000,Hungary,2012.0,12,8,6,26
15001,Hungary,1980.0,8,15,40,63
15002,Hungary,1992.0,14,23,8,45
15003,Hungary,1996.0,8,9,26,43
15004,Hungary,1996.0,8,9,26,43
15005,Hungary,2000.0,25,24,4,53
15006,Hungary,2004.0,24,12,4,40
15007,Hungary,1988.0,20,9,15,44
15008,Hungary,1964.0,42,7,7,56
15009,Hungary,1968.0,32,20,29,81
15010,Hungary,1972.0,10,46,25,81
15011,Hungary,1976.0,14,6,35,55
15012,Hungary,1960.0,13,16,37,66
15013,Hungary,1964.0,42,7,7,56
15014,Hungary,1968.0,32,20,29,81
15015,Hungary,1952.0,53,17,34,104
15016,Hungary,1952.0,53,17,34,104
15017,Hungary,1952.0,53,17,34,104
15018,Hungary,1952.0,53,17,34,104
15019,Hungary,1952.0,53,17,34,104
15020,Hungary,1952.0,53,17,34,104
15021,Hungary,1956.0,30,20,16,66
15022,Hungary,1956.0,30,20,16,66
15023,Hungary,2000.0,25,24,4,53
15024,Hungary,1976.0,14,6,35,55
15025,Hungary,1996.0,8,9,26,43
15026,Hungary,2000.0,25,24,4,53
15027,Hungary,1992.0,14,23,8,45
15028,Hungary,1976.0,14,6,35,55
15029,Hungary,1980.0,8,15,40,63
15030,Hungary,1988.0,20,9,15,44
15031,Hungary,1960.0,13,16,37,66
15032,Hungary,1952.0,53,17,34,104
15033,Hungary,1992.0,14,23,8,45
15034,Hungary,1996.0,8,9,26,43
15035,Hungary,1980.0,8,15,40,63
15036,Hungary,1992.0,14,23,8,45
15037,Hungary,2004.0,24,12,4,40
15038,Hungary,1956.0,30,20,16,66
15039,Hungary,1972.0,10,46,25,81
15040,Hungary,2000.0,25,24,4,53
15041,Hungary,2000.0,25,24,4,53
15042,Hungary,2004.0,24,12,4,40
15043,Hungary,2004.0,24,12,4,40
15044,Hungary,2008.0,16,8,3,27
15045,Hungary,2008.0,16,8,3,27
15046,Hungary,2012.0,12,8,6,26
15047,Hungary,2012.0,12,8,6,26
15048,Hungary,1936.0,25,1,17,43
15049,Hungary,1948.0,15,27,22,64
15050,Hungary,1948.0,15,27,22,64
15051,Hungary,1952.0,53,17,34,104
15052,Hungary,1952.0,53,17,34,104
15053,Hungary,1956.0,30,20,16,66
15054,Hungary,1960.0,13,16,37,66
15055,Hungary,1980.0,8,15,40,63
15056,Hungary,1968.0,32,20,29,81
15057,Hungary,1972.0,10,46,25,81
15058,Hungary,1988.0,20,9,15,44
15059,Hungary,1968.0,32,20,29,81
15060,Hungary,1952.0,53,17,34,104
15061,Hungary,2004.0,24,12,4,40
15062,Hungary,1992.0,14,23,8,45
15063,Hungary,1996.0,8,9,26,43
15064,Hungary,1948.0,15,27,22,64
15065,Hungary,1952.0,53,17,34,104
15066,Hungary,1952.0,53,17,34,104
15067,Hungary,2008.0,16,8,3,27
15068,Hungary,2012.0,12,8,6,26
15069,Hungary,2012.0,12,8,6,26
15070,Hungary,2016.0,12,3,7,22
15071,Hungary,2016.0,12,3,7,22
15072,Hungary,2016.0,12,3,7,22
15073,Hungary,1964.0,42,7,7,56
15074,Hungary,1968.0,32,20,29,81
15075,Hungary,1972.0,10,46,25,81
15076,Hungary,2004.0,24,12,4,40
15077,Hungary,2008.0,16,8,3,27
15078,Hungary,1912.0,10,17,3,30
15079,Hungary,2004.0,24,12,4,40
15080,Hungary,1972.0,10,46,25,81
15081,Hungary,2000.0,25,24,4,53
15082,Hungary,1960.0,13,16,37,66
15083,Hungary,1964.0,42,7,7,56
15084,Hungary,1968.0,32,20,29,81
15085,Hungary,1964.0,42,7,7,56
15086,Hungary,1968.0,32,20,29,81
15087,Hungary,1968.0,32,20,29,81
15088,Hungary,1972.0,10,46,25,81
15089,Hungary,1972.0,10,46,25,81
15090,Hungary,1976.0,14,6,35,55
15091,Hungary,1992.0,14,23,8,45
15092,Hungary,2004.0,24,12,4,40
15093,Hungary,2012.0,12,8,6,26
15094,Hungary,1952.0,53,17,34,104
15095,Hungary,1980.0,8,15,40,63
15096,Hungary,1936.0,25,1,17,43
15097,Hungary,1952.0,53,17,34,104
15098,Hungary,1924.0,2,12,8,22
15099,Hungary,1948.0,15,27,22,64
15100,Hungary,1952.0,53,17,34,104
15101,Hungary,1936.0,25,1,17,43
15102,Hungary,1980.0,8,15,40,63
15103,Hungary,1908.0,7,7,6,20
15104,Hungary,1924.0,2,12,8,22
15105,Hungary,1952.0,53,17,34,104
15106,Hungary,1952.0,53,17,34,104
15107,Hungary,1936.0,25,1,17,43
15108,Hungary,2012.0,12,8,6,26
15109,Hungary,1968.0,32,20,29,81
15110,Hungary,2000.0,25,24,4,53
15111,Hungary,2004.0,24,12,4,40
15112,Hungary,2008.0,16,8,3,27
15113,Hungary,1936.0,25,1,17,43
15114,Hungary,1972.0,10,46,25,81
15115,Hungary,1956.0,30,20,16,66
15116,Hungary,1976.0,14,6,35,55
15117,Hungary,1980.0,8,15,40,63
15118,Hungary,1980.0,8,15,40,63
15119,Hungary,2004.0,24,12,4,40
15120,Hungary,1964.0,42,7,7,56
15121,Hungary,1932.0,20,5,10,35
15122,Hungary,1976.0,14,6,35,55
15123,Hungary,1980.0,8,15,40,63
15124,Hungary,2000.0,25,24,4,53
15125,Hungary,1952.0,53,17,34,104
15126,Hungary,1956.0,30,20,16,66
15127,Hungary,1960.0,13,16,37,66
15128,Hungary,2000.0,25,24,4,53
15129,Hungary,1976.0,14,6,35,55
15130,Hungary,1980.0,8,15,40,63
15131,Hungary,1980.0,8,15,40,63
15132,Hungary,2012.0,12,8,6,26
15133,Hungary,1956.0,30,20,16,66
15134,Hungary,1956.0,30,20,16,66
15135,Hungary,1964.0,42,7,7,56
15136,Hungary,1968.0,32,20,29,81
15137,Hungary,1972.0,10,46,25,81
15138,Hungary,1972.0,10,46,25,81
15139,Hungary,1952.0,53,17,34,104
15140,Hungary,1988.0,20,9,15,44
15141,Hungary,1988.0,20,9,15,44
15142,Hungary,1996.0,8,9,26,43
15143,Hungary,2016.0,12,3,7,22
15144,Hungary,1960.0,13,16,37,66
15145,Hungary,1948.0,15,27,22,64
15146,Hungary,1952.0,53,17,34,104
15147,Hungary,1996.0,8,9,26,43
15148,Hungary,1996.0,8,9,26,43
15149,Hungary,1956.0,30,20,16,66
15150,Hungary,1960.0,13,16,37,66
15151,Hungary,1964.0,42,7,7,56
15152,Hungary,1968.0,32,20,29,81
15153,Hungary,1972.0,10,46,25,81
15154,Hungary,1996.0,8,9,26,43
15155,Hungary,1968.0,32,20,29,81
15156,Hungary,1968.0,32,20,29,81
15157,Hungary,1968.0,32,20,29,81
15158,Hungary,1960.0,13,16,37,66
15159,Hungary,1988.0,20,9,15,44
15160,Hungary,1988.0,20,9,15,44
15161,Hungary,1992.0,14,23,8,45
15162,Hungary,1912.0,10,17,3,30
15163,Hungary,1912.0,10,17,3,30
15164,Hungary,1936.0,25,1,17,43
15165,Hungary,1960.0,13,16,37,66
15166,Hungary,1960.0,13,16,37,66
15167,Hungary,1968.0,32,20,29,81
15168,Hungary,1928.0,10,11,0,21
15169,Hungary,2008.0,16,8,3,27
15170,Hungary,1948.0,15,27,22,64
15171,Hungary,1948.0,15,27,22,64
15172,Hungary,1992.0,14,23,8,45
15173,Hungary,1988.0,20,9,15,44
15174,Hungary,1992.0,14,23,8,45
15175,Hungary,2012.0,12,8,6,26
15176,Hungary,1948.0,15,27,22,64
15177,Hungary,1948.0,15,27,22,64
15178,Hungary,1948.0,15,27,22,64
15179,Hungary,1948.0,15,27,22,64
15180,Hungary,1956.0,30,20,16,66
15181,Hungary,1968.0,32,20,29,81
15182,Hungary,1972.0,10,46,25,81
15183,Hungary,1976.0,14,6,35,55
15184,Hungary,1980.0,8,15,40,63
15185,Hungary,1936.0,25,1,17,43
15186,Hungary,2000.0,25,24,4,53
15187,Hungary,2004.0,24,12,4,40
15188,Hungary,2008.0,16,8,3,27
15189,Hungary,1968.0,32,20,29,81
15190,Hungary,1906.0,5,5,3,13
15191,Hungary,1906.0,5,5,3,13
15192,Hungary,1908.0,7,7,6,20
15193,Hungary,1956.0,30,20,16,66
15194,Hungary,1996.0,8,9,26,43
15195,Hungary,2000.0,25,24,4,53
15196,Hungary,1932.0,20,5,10,35
15197,Hungary,1976.0,14,6,35,55
15198,Hungary,1960.0,13,16,37,66
15199,Hungary,1960.0,13,16,37,66
15200,Hungary,1964.0,42,7,7,56
15201,Hungary,1908.0,7,7,6,20
15202,Hungary,1968.0,32,20,29,81
15203,Hungary-1,1952.0,53,17,34,104
15204,Hungary,1956.0,30,20,16,66
15205,Hungary-1,1952.0,53,17,34,104
15206,Hungary,1956.0,30,20,16,66
15207,Hungary,1968.0,32,20,29,81
15208,Hungary,2000.0,25,24,4,53
15209,Hungary,2004.0,24,12,4,40
15210,Hungary,1972.0,10,46,25,81
15211,Hungary,1976.0,14,6,35,55
15212,Hungary,1936.0,25,1,17,43
15213,Hungary,1948.0,15,27,22,64
15214,Hungary,1996.0,8,9,26,43
15215,Hungary,1980.0,8,15,40,63
15216,Hungary,1988.0,20,9,15,44
15217,Hungary,1992.0,14,23,8,45
15218,Hungary,1980.0,8,15,40,63
15219,Hungary,2004.0,24,12,4,40
15220,Hungary,1964.0,42,7,7,56
15221,Hungary,1968.0,32,20,29,81
15222,Hungary,1960.0,13,16,37,66
15223,Hungary,1960.0,13,16,37,66
15224,Hungary,1996.0,8,9,26,43
15225,Hungary,1948.0,15,27,22,64
15226,Hungary,1952.0,53,17,34,104
15227,Hungary,1932.0,20,5,10,35
15228,Hungary,1936.0,25,1,17,43
15229,Hungary,1976.0,14,6,35,55
15230,Hungary,1976.0,14,6,35,55
15231,Hungary,1968.0,32,20,29,81
15232,Hungary,1964.0,42,7,7,56
15233,Hungary,1968.0,32,20,29,81
15234,Hungary,1960.0,13,16,37,66
15235,Hungary,1964.0,42,7,7,56
15236,Hungary,1968.0,32,20,29,81
15237,Hungary,2000.0,25,24,4,53
15238,Hungary,1952.0,53,17,34,104
15239,Hungary,1952.0,53,17,34,104
15240,Hungary,1980.0,8,15,40,63
15241,Hungary,1960.0,13,16,37,66
15242,Hungary,1948.0,15,27,22,64
15243,Hungary,1992.0,14,23,8,45
15244,Hungary,1992.0,14,23,8,45
15245,Hungary,1906.0,5,5,3,13
15246,Hungary,1964.0,42,7,7,56
15247,Hungary,1972.0,10,46,25,81
15248,Hungary,1960.0,13,16,37,66
15249,Hungary,1972.0,10,46,25,81
15250,Hungary,1980.0,8,15,40,63
15251,Hungary,1976.0,14,6,35,55
15252,Hungary,1996.0,8,9,26,43
15253,Hungary,2000.0,25,24,4,53
15254,Hungary,1960.0,13,16,37,66
15255,Hungary,2000.0,25,24,4,53
15256,Hungary,1952.0,53,17,34,104
15257,Hungary,1964.0,42,7,7,56
15258,Hungary,1936.0,25,1,17,43
15259,Hungary,1952.0,53,17,34,104
15260,Hungary,1968.0,32,20,29,81
15261,Hungary,1972.0,10,46,25,81
15262,Hungary,1948.0,15,27,22,64
15263,Hungary,1952.0,53,17,34,104
15264,Hungary,1972.0,10,46,25,81
15265,Hungary,1948.0,15,27,22,64
15266,Hungary,1952.0,53,17,34,104
15267,Hungary,1956.0,30,20,16,66
15268,Hungary,1928.0,10,11,0,21
15269,Hungary,2012.0,12,8,6,26
15270,Hungary,1952.0,53,17,34,104
15271,Hungary,1956.0,30,20,16,66
15272,Hungary,1960.0,13,16,37,66
15273,Hungary,1912.0,10,17,3,30
15274,Hungary,1948.0,15,27,22,64
15275,Hungary,1948.0,15,27,22,64
15276,Hungary,1948.0,15,27,22,64
15277,Hungary,2012.0,12,8,6,26
15278,Hungary,1912.0,10,17,3,30
15279,Hungary,1932.0,20,5,10,35
15280,Hungary,1932.0,20,5,10,35
15281,Hungary,1932.0,20,5,10,35
15282,Hungary,1932.0,20,5,10,35
15283,Hungary,1976.0,14,6,35,55
15284,Hungary,1968.0,32,20,29,81
15285,Hungary,1928.0,10,11,0,21
15286,Hungary,1928.0,10,11,0,21
15287,Hungary,1932.0,20,5,10,35
15288,Hungary,1964.0,42,7,7,56
15289,Hungary,1968.0,32,20,29,81
15290,Hungary,1968.0,32,20,29,81
15291,Hungary,1972.0,10,46,25,81
15292,Hungary,1968.0,32,20,29,81
15293,Hungary,1972.0,10,46,25,81
15294,Hungary,1976.0,14,6,35,55
15295,Hungary,2000.0,25,24,4,53
15296,Hungary,1932.0,20,5,10,35
15297,Hungary,1932.0,20,5,10,35
15298,Hungary,1964.0,42,7,7,56
15299,Hungary,1968.0,32,20,29,81
15300,Hungary,1972.0,10,46,25,81
15301,Hungary,1948.0,15,27,22,64
15302,Hungary,1952.0,53,17,34,104
15303,Hungary,1956.0,30,20,16,66
15304,Hungary,1960.0,13,16,37,66
15305,Hungary,1964.0,42,7,7,56
15306,Hungary,1924.0,2,12,8,22
15307,Hungary,1924.0,2,12,8,22
15308,Hungary,1924.0,2,12,8,22
15309,Hungary,1912.0,10,17,3,30
15310,Hungary,1996.0,8,9,26,43
15311,Hungary,2000.0,25,24,4,53
15312,Hungary,1952.0,53,17,34,104
15313,Hungary,1980.0,8,15,40,63
15314,Hungary,1908.0,7,7,6,20
15315,Hungary,2000.0,25,24,4,53
15316,Hungary,1924.0,2,12,8,22
15317,Hungary,1928.0,10,11,0,21
15318,Hungary,1936.0,25,1,17,43
15319,Hungary,1948.0,15,27,22,64
15320,Hungary,1952.0,53,17,34,104
15321,Hungary,1936.0,25,1,17,43
15322,Hungary,1996.0,8,9,26,43
15323,Hungary,1976.0,14,6,35,55
15324,Hungary,1976.0,14,6,35,55
15325,Hungary,1960.0,13,16,37,66
15326,Hungary,1980.0,8,15,40,63
15327,Hungary,1988.0,20,9,15,44
15328,Hungary,1972.0,10,46,25,81
15329,Hungary,1976.0,14,6,35,55
15330,Hungary,2016.0,12,3,7,22
15331,Hungary,1980.0,8,15,40,63
15332,Hungary,1960.0,13,16,37,66
15333,Hungary,1964.0,42,7,7,56
15334,Hungary,1964.0,42,7,7,56
15335,Hungary,1968.0,32,20,29,81
15336,Hungary,1968.0,32,20,29,81
15337,Hungary,1972.0,10,46,25,81
15338,Hungary,1976.0,14,6,35,55
15339,Hungary,1992.0,14,23,8,45
15340,Hungary,1956.0,30,20,16,66
15341,Hungary,1912.0,10,17,3,30
15342,Hungary,2012.0,12,8,6,26
15343,Hungary,1952.0,53,17,34,104
15344,Hungary,1972.0,10,46,25,81
15345,Hungary,1972.0,10,46,25,81
15346,Hungary-1,1932.0,20,5,10,35
15347,Hungary-1,1936.0,25,1,17,43
15348,Hungary,1992.0,14,23,8,45
15349,Hungary,1992.0,14,23,8,45
15350,Hungary,1996.0,8,9,26,43
15351,Hungary,1960.0,13,16,37,66
15352,Hungary,1956.0,30,20,16,66
15353,Hungary,1960.0,13,16,37,66
15354,Hungary,1964.0,42,7,7,56
15355,Hungary,1968.0,32,20,29,81
15356,Hungary,1952.0,53,17,34,104
15357,Hungary,1956.0,30,20,16,66
15358,Hungary,1956.0,30,20,16,66
15359,Hungary,1980.0,8,15,40,63
15360,Hungary,1948.0,15,27,22,64
15361,Hungary,1932.0,20,5,10,35
15362,Hungary,1936.0,25,1,17,43
15363,Hungary,1968.0,32,20,29,81
15364,Hungary,1968.0,32,20,29,81
15365,Hungary,1968.0,32,20,29,81
15366,Hungary,1972.0,10,46,25,81
15367,Hungary,1976.0,14,6,35,55
15368,Hungary,1976.0,14,6,35,55
15369,Hungary,1960.0,13,16,37,66
15370,Hungary,1912.0,10,17,3,30
15371,Hungary,1924.0,2,12,8,22
15372,Hungary,1924.0,2,12,8,22
15373,Hungary,1968.0,32,20,29,81
15374,Hungary,1972.0,10,46,25,81
15375,Hungary,1972.0,10,46,25,81
15376,Hungary,1976.0,14,6,35,55
15377,Hungary,1976.0,14,6,35,55
15378,Hungary,1980.0,8,15,40,63
15379,Hungary,1980.0,8,15,40,63
15380,Hungary,1988.0,20,9,15,44
15381,Hungary,2000.0,25,24,4,53
15382,Hungary,1908.0,7,7,6,20
15383,Hungary,1996.0,8,9,26,43
15384,Hungary,2000.0,25,24,4,53
15385,Hungary,1960.0,13,16,37,66
15386,Hungary,2016.0,12,3,7,22
15387,Hungary,1924.0,2,12,8,22
15388,Hungary,1908.0,7,7,6,20
15389,Hungary,1956.0,30,20,16,66
15390,Hungary,1932.0,20,5,10,35
15391,Hungary,1980.0,8,15,40,63
15392,Hungary,1988.0,20,9,15,44
15393,Hungary,2004.0,24,12,4,40
15394,Hungary,2000.0,25,24,4,53
15395,Hungary,2004.0,24,12,4,40
15396,Hungary,1968.0,32,20,29,81
15397,Hungary,1976.0,14,6,35,55
15398,Hungary,2000.0,25,24,4,53
15399,Hungary,2000.0,25,24,4,53
15400,Hungary,2004.0,24,12,4,40
15401,Hungary,1976.0,14,6,35,55
15402,Hungary,1980.0,8,15,40,63
15403,Hungary,1932.0,20,5,10,35
15404,Hungary,1988.0,20,9,15,44
15405,Hungary,1992.0,14,23,8,45
15406,Hungary,1992.0,14,23,8,45
15407,Hungary,1996.0,8,9,26,43
15408,Hungary,2008.0,16,8,3,27
15409,Hungary,2012.0,12,8,6,26
15410,Hungary,2016.0,12,3,7,22
15411,Hungary,2016.0,12,3,7,22
15412,Hungary,1976.0,14,6,35,55
15413,Hungary,1980.0,8,15,40,63
15414,Hungary,1988.0,20,9,15,44
15415,Hungary,2000.0,25,24,4,53
15416,Hungary,2000.0,25,24,4,53
15417,Hungary,2004.0,24,12,4,40
15418,Hungary,1992.0,14,23,8,45
15419,Hungary,1980.0,8,15,40,63
15420,Hungary,1968.0,32,20,29,81
15421,Hungary,1996.0,8,9,26,43
15422,Hungary,1996.0,8,9,26,43
15423,Hungary,1968.0,32,20,29,81
15424,Hungary,2016.0,12,3,7,22
15425,Hungary,1948.0,15,27,22,64
15426,Hungary,1924.0,2,12,8,22
15427,Hungary,2000.0,25,24,4,53
15428,Hungary,2004.0,24,12,4,40
15429,Hungary,2008.0,16,8,3,27
15430,Hungary,1932.0,20,5,10,35
15431,Hungary,2000.0,25,24,4,53
15432,Hungary,1952.0,53,17,34,104
15433,Hungary,1956.0,30,20,16,66
15434,Hungary,1988.0,20,9,15,44
15435,Hungary,1988.0,20,9,15,44
15436,Hungary,1948.0,15,27,22,64
15437,Hungary,1960.0,13,16,37,66
15438,Hungary,1960.0,13,16,37,66
15439,Hungary,1964.0,42,7,7,56
15440,Hungary,1928.0,10,11,0,21
15441,Hungary,1964.0,42,7,7,56
15442,Hungary,2012.0,12,8,6,26
15443,Hungary,2016.0,12,3,7,22
15444,Hungary,1996.0,8,9,26,43
15445,Hungary,1948.0,15,27,22,64
15446,Hungary,1952.0,53,17,34,104
15447,Hungary,1948.0,15,27,22,64
15448,Hungary,1952.0,53,17,34,104
15449,Hungary,1968.0,32,20,29,81
15450,Hungary,1972.0,10,46,25,81
15451,Hungary,1976.0,14,6,35,55
15452,Hungary,1980.0,8,15,40,63
15453,Hungary,1948.0,15,27,22,64
15454,Hungary,1952.0,53,17,34,104
15455,Hungary,1956.0,30,20,16,66
15456,Hungary,1980.0,8,15,40,63
15457,Hungary,1988.0,20,9,15,44
15458,Hungary,1952.0,53,17,34,104
15459,Hungary,1952.0,53,17,34,104
15460,Hungary,1896.0,2,1,3,6
15461,Hungary-1,1932.0,20,5,10,35
15462,Hungary-1,1936.0,25,1,17,43
15463,Hungary,1960.0,13,16,37,66
15464,Hungary,1960.0,13,16,37,66
15465,Hungary,1968.0,32,20,29,81
15466,Hungary,1972.0,10,46,25,81
15467,Hungary,1980.0,8,15,40,63
15468,Hungary,1980.0,8,15,40,63
15469,Hungary,1952.0,53,17,34,104
15470,Hungary,1952.0,53,17,34,104
15471,Hungary,1976.0,14,6,35,55
15472,Hungary,1906.0,5,5,3,13
15473,Hungary,1972.0,10,46,25,81
15474,Hungary,1968.0,32,20,29,81
15475,Hungary,1972.0,10,46,25,81
15476,Hungary,1912.0,10,17,3,30
15477,Hungary,1948.0,15,27,22,64
15478,Hungary,1952.0,53,17,34,104
15479,Hungary,1896.0,2,1,3,6
15480,Hungary,1936.0,25,1,17,43
15481,Hungary,1948.0,15,27,22,64
15482,Hungary,1952.0,53,17,34,104
15483,Hungary,1952.0,53,17,34,104
15484,Hungary,1956.0,30,20,16,66
15485,Hungary,1956.0,30,20,16,66
15486,Hungary,1956.0,30,20,16,66
15487,Hungary,1968.0,32,20,29,81
15488,Hungary,1952.0,53,17,34,104
15489,Hungary,1952.0,53,17,34,104
15490,Hungary,1912.0,10,17,3,30
15491,Hungary,1952.0,53,17,34,104
15492,Hungary,1956.0,30,20,16,66
15493,Hungary,1968.0,32,20,29,81
15494,Hungary,1968.0,32,20,29,81
15495,Hungary,1976.0,14,6,35,55
15496,Hungary,1960.0,13,16,37,66
15497,Hungary,1964.0,42,7,7,56
15498,Hungary,1964.0,42,7,7,56
15499,Hungary,1968.0,32,20,29,81
15500,Hungary,1960.0,13,16,37,66
15501,Hungary,1960.0,13,16,37,66
15502,Hungary,1964.0,42,7,7,56
15503,Hungary,1936.0,25,1,17,43
15504,Hungary,1996.0,8,9,26,43
15505,Hungary,2012.0,12,8,6,26
15506,Hungary,1948.0,15,27,22,64
15507,Hungary,1964.0,42,7,7,56
15508,Hungary,1956.0,30,20,16,66
15509,Hungary,1980.0,8,15,40,63
15510,Hungary,1936.0,25,1,17,43
15511,Hungary,1972.0,10,46,25,81
15512,Hungary,1948.0,15,27,22,64
15513,Hungary,1906.0,5,5,3,13
15514,Hungary,1908.0,7,7,6,20
15515,Hungary,1912.0,10,17,3,30
15516,Hungary,1976.0,14,6,35,55
15517,Hungary,1976.0,14,6,35,55
15518,Hungary,1992.0,14,23,8,45
15519,Hungary,1912.0,10,17,3,30
15520,Hungary,1956.0,30,20,16,66
15521,Hungary,1976.0,14,6,35,55
15522,Hungary,1932.0,20,5,10,35
15523,Hungary,1988.0,20,9,15,44
15524,Hungary,1980.0,8,15,40,63
15525,Hungary,1924.0,2,12,8,22
15526,Hungary,2012.0,12,8,6,26
15527,Hungary,1956.0,30,20,16,66
15528,Hungary,2004.0,24,12,4,40
15529,Hungary,2008.0,16,8,3,27
15530,Hungary,1980.0,8,15,40,63
15531,Hungary,1976.0,14,6,35,55
15532,Hungary,1980.0,8,15,40,63
15533,Hungary,1972.0,10,46,25,81
15534,Hungary,1952.0,53,17,34,104
15535,Hungary,1912.0,10,17,3,30
15536,Hungary,2008.0,16,8,3,27
15537,Hungary,2008.0,16,8,3,27
15538,Hungary,1952.0,53,17,34,104
15539,Hungary,1968.0,32,20,29,81
15540,Hungary,1980.0,8,15,40,63
15541,Hungary,2004.0,24,12,4,40
15542,Hungary,2008.0,16,8,3,27
15543,Hungary,1964.0,42,7,7,56
15544,Hungary,2000.0,25,24,4,53
15545,Hungary,1960.0,13,16,37,66
15546,Hungary,2000.0,25,24,4,53
15547,Hungary,2004.0,24,12,4,40
15548,Hungary,1964.0,42,7,7,56
15549,Hungary,1948.0,15,27,22,64
15550,Hungary,1948.0,15,27,22,64
15551,Hungary,1980.0,8,15,40,63
15552,Hungary,1972.0,10,46,25,81
15553,Hungary,2000.0,25,24,4,53
15554,Hungary,2000.0,25,24,4,53
15555,Hungary,2004.0,24,12,4,40
15556,Hungary,1960.0,13,16,37,66
15557,Hungary,1964.0,42,7,7,56
15558,Hungary,1980.0,8,15,40,63
15559,Hungary,1980.0,8,15,40,63
15560,Hungary,1980.0,8,15,40,63
15561,Hungary,1928.0,10,11,0,21
15562,Hungary,1932.0,20,5,10,35
15563,Hungary,1972.0,10,46,25,81
15564,Hungary,1960.0,13,16,37,66
15565,Hungary,1972.0,10,46,25,81
15566,Hungary,2000.0,25,24,4,53
15567,Hungary,2004.0,24,12,4,40
15568,Hungary,1952.0,53,17,34,104
15569,Hungary,1936.0,25,1,17,43
15570,Hungary,1900.0,1,2,2,5
15571,Hungary,1900.0,1,2,2,5
15572,Hungary,1900.0,1,2,2,5
15573,Hungary,1904.0,2,1,1,4
15574,Hungary,1904.0,2,1,1,4
15575,Hungary,1906.0,5,5,3,13
15576,Hungary,1906.0,5,5,3,13
15577,Hungary,1908.0,7,7,6,20
15578,Hungary,1908.0,7,7,6,20
15579,Hungary,1908.0,7,7,6,20
15580,Hungary,1936.0,25,1,17,43
15581,Hungary,1924.0,2,12,8,22
15582,Hungary,1924.0,2,12,8,22
15583,Hungary,1928.0,10,11,0,21
15584,Hungary,1928.0,10,11,0,21
15585,Hungary,2004.0,24,12,4,40
15586,Hungary,1932.0,20,5,10,35
15587,Hungary,1948.0,15,27,22,64
15588,Hungary,1952.0,53,17,34,104
15589,Hungary,1952.0,53,17,34,104
15590,Hungary,1908.0,7,7,6,20
15591,Hungary,1908.0,7,7,6,20
15592,Hungary,1912.0,10,17,3,30
15593,Hungary,1968.0,32,20,29,81
15594,Hungary,1972.0,10,46,25,81
15595,Hungary,1976.0,14,6,35,55
15596,Hungary,1956.0,30,20,16,66
15597,Hungary,1908.0,7,7,6,20
15598,Hungary,1980.0,8,15,40,63
15599,Hungary,1908.0,7,7,6,20
15600,Hungary,1956.0,30,20,16,66
15601,Hungary,1988.0,20,9,15,44
15602,Hungary,1952.0,53,17,34,104
15603,Hungary,1980.0,8,15,40,63
15604,Hungary,1992.0,14,23,8,45
15605,Hungary,1996.0,8,9,26,43
15606,Hungary,1952.0,53,17,34,104
15607,Hungary,1948.0,15,27,22,64
15608,Hungary,1932.0,20,5,10,35
15609,Hungary,1936.0,25,1,17,43
15610,Hungary,1948.0,15,27,22,64
15611,Hungary,1960.0,13,16,37,66
15612,Hungary,1964.0,42,7,7,56
15613,Hungary,1968.0,32,20,29,81
15614,Hungary,1908.0,7,7,6,20
15615,Thessalonki-1,1906.0,24,48,30,102
15616,"Large boat, Central Naval Prep School ""Poros""-1",1906.0,24,48,30,102
15617,Greece,2000.0,4,6,8,18
15618,Greece,1906.0,24,48,30,102
15619,Greece,1896.0,10,18,20,48
15620,Greece,1896.0,10,18,20,48
15621,Greece,2004.0,8,18,5,31
15622,Greece,1996.0,4,4,0,8
15623,Greece-1,1906.0,24,48,30,102
15624,"Life boat naval ship ""Spetsai""-1",1906.0,24,48,30,102
15625,Greece,2004.0,8,18,5,31
15626,Greece,2008.0,0,3,4,7
15627,Greece,2004.0,8,18,5,31
15628,Greece,1980.0,1,0,4,5
15629,Greece,1896.0,10,18,20,48
15630,Greece-1,1896.0,10,18,20,48
15631,Greece-2,1906.0,24,48,30,102
15632,Greece-1,1906.0,24,48,30,102
15633,"Life boat naval ship ""Spetsai""-1",1906.0,24,48,30,102
15634,Greece,1896.0,10,18,20,48
15635,"Life boat naval ship ""Spetsai""-1",1906.0,24,48,30,102
15636,Greece,2004.0,8,18,5,31
15637,Greece,2008.0,0,3,4,7
15638,Greece,1906.0,24,48,30,102
15639,Greece,1992.0,2,0,0,2
15640,Greece,1996.0,4,4,0,8
15641,Greece,2000.0,4,6,8,18
15642,Greece,2004.0,8,18,5,31
15643,Greece,1924.0,1,0,0,1
15644,"Phalainis ton Thorichtou ""Hydra""-2",1906.0,24,48,30,102
15645,"Phalainis ton Thorichtou ""Hydra""-2",1906.0,24,48,30,102
15646,Greece,1896.0,10,18,20,48
15647,Greece,1906.0,24,48,30,102
15648,Greece,1908.0,0,3,1,4
15649,"Large boat, Central Naval Prep School ""Poros""-1",1906.0,24,48,30,102
15650,Greece,1896.0,10,18,20,48
15651,Greece,2004.0,8,18,5,31
15652,Nirefs,1960.0,3,0,0,3
15653,"Phalainis ton Thorichtou ""Hydra""-2",1906.0,24,48,30,102
15654,"Phalainis ton Thorichtou ""Hydra""-2",1906.0,24,48,30,102
15655,Greece,1896.0,10,18,20,48
15656,Greece,1896.0,10,18,20,48
15657,Greece,1896.0,10,18,20,48
15658,Greece,1968.0,0,0,1,1
15659,Greece,1972.0,0,2,0,2
15660,Greece,1980.0,1,0,4,5
15661,Greece,1904.0,1,0,1,2
15662,Greece,1906.0,24,48,30,102
15663,Greece,1906.0,24,48,30,102
15664,Greece,1906.0,24,48,30,102
15665,"Large boat, Central Naval Prep School ""Poros""-1",1906.0,24,48,30,102
15666,Greece,2000.0,4,6,8,18
15667,Greece,1896.0,10,18,20,48
15668,Greece,1906.0,24,48,30,102
15669,Greece,1906.0,24,48,30,102
15670,Greece,2016.0,3,1,3,7
15671,Greece,2012.0,0,0,3,3
15672,Greece,1896.0,10,18,20,48
15673,Greece,1896.0,10,18,20,48
15674,"Phalainis ton Thorichtou ""Hydra""-2",1906.0,24,48,30,102
15675,"Phalainis ton Thorichtou ""Hydra""-2",1906.0,24,48,30,102
15676,Greece,2004.0,8,18,5,31
15677,Greece,2012.0,0,0,3,3
15678,Greece,2016.0,3,1,3,7
15679,"Large boat, Central Naval Prep School ""Poros""-1",1906.0,24,48,30,102
15680,Greece,1996.0,4,4,0,8
15681,Greece,2000.0,4,6,8,18
15682,Greece,1996.0,4,4,0,8
15683,Greece,2004.0,8,18,5,31
15684,"Large boat, Central Naval Prep School ""Poros""-1",1906.0,24,48,30,102
15685,Greece,1904.0,1,0,1,2
15686,"Phalainis ton Thorichtou ""Hydra""-2",1906.0,24,48,30,102
15687,Greece,2004.0,8,18,5,31
15688,Greece,1896.0,10,18,20,48
15689,Thessalonki-1,1906.0,24,48,30,102
15690,"Large boat, Central Naval Prep School ""Poros""-1",1906.0,24,48,30,102
15691,Greece,2004.0,8,18,5,31
15692,Greece,1896.0,10,18,20,48
15693,Greece,2000.0,4,6,8,18
15694,"Life boat naval ship ""Spetsai""-1",1906.0,24,48,30,102
15695,Ethnikos Gymnastikos Syllogos,1896.0,10,18,20,48
15696,Greece,2000.0,4,6,8,18
15697,"Phalainis ton Thorichtou ""Hydra""-2",1906.0,24,48,30,102
15698,"Large boat, Central Naval Prep School ""Poros""-1",1906.0,24,48,30,102
15699,Greece,2000.0,4,6,8,18
15700,Greece,2004.0,8,18,5,31
15701,Greece,2000.0,4,6,8,18
15702,"Phalainis ton Thorichtou ""Hydra""-2",1906.0,24,48,30,102
15703,Greece,2004.0,8,18,5,31
15704,Greece,1980.0,1,0,4,5
15705,Greece,2000.0,4,6,8,18
15706,Greece,1972.0,0,2,0,2
15707,Greece,1896.0,10,18,20,48
15708,Greece,1984.0,0,1,1,2
15709,Greece,1988.0,0,0,1,1
15710,Greece,1896.0,10,18,20,48
15711,"Phalainis ton Thorichtou ""Hydra""-2",1906.0,24,48,30,102
15712,Greece,2000.0,4,6,8,18
15713,Greece,1896.0,10,18,20,48
15714,Greece,2004.0,8,18,5,31
15715,Greece,1996.0,4,4,0,8
15716,Greece,1896.0,10,18,20,48
15717,Greece,1896.0,10,18,20,48
15718,Nirefs,1960.0,3,0,0,3
15719,Greece,2016.0,3,1,3,7
15720,Greece,2016.0,3,1,3,7
15721,Greece,1906.0,24,48,30,102
15722,Greece,1906.0,24,48,30,102
15723,Greece,2004.0,8,18,5,31
15724,Greece,2008.0,0,3,4,7
15725,"Life boat naval ship ""Spetsai""-1",1906.0,24,48,30,102
15726,Thessalonki-1,1906.0,24,48,30,102
15727,"Large boat, Central Naval Prep School ""Poros""-1",1906.0,24,48,30,102
15728,Greece,2004.0,8,18,5,31
15729,Omas Helliniki P. S.,1906.0,24,48,30,102
15730,Omas Helliniki P. S.,1906.0,24,48,30,102
15731,"Phalainis ton Thorichtou ""Hydra""-2",1906.0,24,48,30,102
15732,Greece,1996.0,4,4,0,8
15733,Greece,2004.0,8,18,5,31
15734,"Phalainis ton Thorichtou ""Hydra""-2",1906.0,24,48,30,102
15735,Greece,1896.0,10,18,20,48
15736,"Large boat, Central Naval Prep School ""Poros""-1",1906.0,24,48,30,102
15737,Ethnikos Gymnastikos Syllogos,1896.0,10,18,20,48
15738,Greece,1896.0,10,18,20,48
15739,Greece,2000.0,4,6,8,18
15740,Greece,2004.0,8,18,5,31
15741,Greece,2016.0,3,1,3,7
15742,Greece,1906.0,24,48,30,102
15743,Greece-1,1906.0,24,48,30,102
15744,"Phalainis ton Thorichtou ""Hydra""-2",1906.0,24,48,30,102
15745,Greece-2,1906.0,24,48,30,102
15746,Greece,2004.0,8,18,5,31
15747,Greece,1996.0,4,4,0,8
15748,Greece,1906.0,24,48,30,102
15749,Greece,1908.0,0,3,1,4
15750,"Phalainis ton Thorichtou ""Hydra""-2",1906.0,24,48,30,102
15751,"Large boat, Central Naval Prep School ""Poros""-1",1906.0,24,48,30,102
15752,Thessalonki-1,1906.0,24,48,30,102
15753,"Phalainis ton Thorichtou ""Hydra""-2",1906.0,24,48,30,102
15754,"Large boat, Central Naval Prep School ""Poros""-1",1906.0,24,48,30,102
15755,"Life boat naval ship ""Spetsai""-1",1906.0,24,48,30,102
15756,Greece,1896.0,10,18,20,48
15757,Greece,2000.0,4,6,8,18
15758,Greece,2004.0,8,18,5,31
15759,Greece,2004.0,8,18,5,31
15760,Greece,1920.0,0,5,0,5
15761,Greece,2008.0,0,3,4,7
15762,"Large boat, Central Naval Prep School ""Poros""-1",1906.0,24,48,30,102
15763,Greece,2000.0,4,6,8,18
15764,Greece,1980.0,1,0,4,5
15765,Greece,2004.0,8,18,5,31
15766,Greece,2004.0,8,18,5,31
15767,Greece,2004.0,8,18,5,31
15768,Greece,2008.0,0,3,4,7
15769,Greece,1896.0,10,18,20,48
15770,Greece,1896.0,10,18,20,48
15771,Greece,1896.0,10,18,20,48
15772,"Phalainis ton Thorichtou ""Hydra""-2",1906.0,24,48,30,102
15773,"Phalainis ton Thorichtou ""Hydra""-2",1906.0,24,48,30,102
15774,Greece,2004.0,8,18,5,31
15775,Greece,1896.0,10,18,20,48
15776,Greece,1896.0,10,18,20,48
15777,Greece,1906.0,24,48,30,102
15778,Greece,2000.0,4,6,8,18
15779,Greece,2008.0,0,3,4,7
15780,"Phalainis ton Thorichtou ""Hydra""-2",1906.0,24,48,30,102
15781,Omas Helliniki P. S.,1906.0,24,48,30,102
15782,"Phalainis ton Thorichtou ""Hydra""-2",1906.0,24,48,30,102
15783,Greece,1896.0,10,18,20,48
15784,Greece,1896.0,10,18,20,48
15785,Greece,1906.0,24,48,30,102
15786,Greece,1896.0,10,18,20,48
15787,Greece,1992.0,2,0,0,2
15788,Greece,1896.0,10,18,20,48
15789,Thessalonki-1,1906.0,24,48,30,102
15790,Greece,1896.0,10,18,20,48
15791,Greece,1906.0,24,48,30,102
15792,Greece,1896.0,10,18,20,48
15793,Greece,1896.0,10,18,20,48
15794,Greece-1,1896.0,10,18,20,48
15795,Greece,2016.0,3,1,3,7
15796,"Large boat, Central Naval Prep School ""Poros""-1",1906.0,24,48,30,102
15797,Greece,1896.0,10,18,20,48
15798,"Large boat, Central Naval Prep School ""Poros""-1",1906.0,24,48,30,102
15799,Thessalonki-1,1906.0,24,48,30,102
15800,Greece,2000.0,4,6,8,18
15801,Greece,2004.0,8,18,5,31
15802,Greece,2008.0,0,3,4,7
15803,Omas Helliniki P. S.,1906.0,24,48,30,102
15804,Omas Helliniki P. S.,1906.0,24,48,30,102
15805,Royal Club Nautique de Gand,1906.0,24,48,30,102
15806,"Phalainis ton Thorichtou ""Hydra""-2",1906.0,24,48,30,102
15807,Greece,1896.0,10,18,20,48
15808,Greece,1906.0,24,48,30,102
15809,Greece,1906.0,24,48,30,102
15810,Greece,1906.0,24,48,30,102
15811,Greece,1906.0,24,48,30,102
15812,Greece,1980.0,1,0,4,5
15813,Greece,1956.0,0,0,1,1
15814,Greece,2004.0,8,18,5,31
15815,Greece,1996.0,4,4,0,8
15816,Greece,2000.0,4,6,8,18
15817,Greece,1906.0,24,48,30,102
15818,Greece,1920.0,0,5,0,5
15819,Greece,1906.0,24,48,30,102
15820,Thessalonki-1,1906.0,24,48,30,102
15821,Greece,1906.0,24,48,30,102
15822,Greece-1,1906.0,24,48,30,102
15823,Greece,2004.0,8,18,5,31
15824,Greece,1906.0,24,48,30,102
15825,Greece,2004.0,8,18,5,31
15826,Greece,1906.0,24,48,30,102
15827,"Large boat, Central Naval Prep School ""Poros""-1",1906.0,24,48,30,102
15828,Thessalonki-1,1906.0,24,48,30,102
15829,"Phalainis ton Thorichtou ""Hydra""-2",1906.0,24,48,30,102
15830,Greece,1906.0,24,48,30,102
15831,Greece,2016.0,3,1,3,7
15832,"Phalainis ton Thorichtou ""Hydra""-2",1906.0,24,48,30,102
15833,"Phalainis ton Thorichtou ""Hydra""-2",1906.0,24,48,30,102
15834,Greece,2000.0,4,6,8,18
15835,Greece,2004.0,8,18,5,31
15836,Thessalonki-1,1906.0,24,48,30,102
15837,Greece,1984.0,0,1,1,2
15838,Greece,2000.0,4,6,8,18
15839,Greece,1896.0,10,18,20,48
15840,Greece,1906.0,24,48,30,102
15841,Greece,1920.0,0,5,0,5
15842,Greece,1920.0,0,5,0,5
15843,Greece,1906.0,24,48,30,102
15844,Greece,1896.0,10,18,20,48
15845,Omas Helliniki P. S.,1906.0,24,48,30,102
15846,Greece,2012.0,0,0,3,3
15847,Greece,1908.0,0,3,1,4
15848,Greece,1908.0,0,3,1,4
15849,Greece,1912.0,1,0,1,2
15850,Greece,1912.0,1,0,1,2
15851,"Phalainis ton Thorichtou ""Hydra""-2",1906.0,24,48,30,102
15852,"Large boat, Central Naval Prep School ""Poros""-1",1906.0,24,48,30,102
15853,Omas Helliniki P. S.,1906.0,24,48,30,102
15854,Greece,1896.0,10,18,20,48
15855,Greece,2004.0,8,18,5,31
15856,Greece,2004.0,8,18,5,31
15857,Thessalonki-1,1906.0,24,48,30,102
15858,Greece,1896.0,10,18,20,48
15859,Omas Helliniki P. S.,1906.0,24,48,30,102
15860,"Large boat, Central Naval Prep School ""Poros""-1",1906.0,24,48,30,102
15861,Greece,1896.0,10,18,20,48
15862,Greece,1896.0,10,18,20,48
15863,"Life boat naval ship ""Spetsai""-1",1906.0,24,48,30,102
15864,Greece,1896.0,10,18,20,48
15865,Greece,1920.0,0,5,0,5
15866,Greece,1896.0,10,18,20,48
15867,Nirefs,1960.0,3,0,0,3
15868,Thessalonki-1,1906.0,24,48,30,102
15869,Greece,1906.0,24,48,30,102
15870,Australia,2008.0,31,42,76,149
15871,Australia,2016.0,23,34,25,82
15872,Australia,1956.0,28,13,26,67
15873,Australia,1992.0,14,27,16,57
15874,Australia,1996.0,32,16,84,132
15875,Australia,2000.0,60,69,54,183
15876,Australia,2000.0,60,69,54,183
15877,Australia,2000.0,60,69,54,183
15878,Australia,2004.0,49,77,31,157
15879,Australia,2008.0,31,42,76,149
15880,Australia,1964.0,8,6,30,44
15881,Australia,2004.0,49,77,31,157
15882,Australia,1952.0,7,2,11,20
15883,Australia,1972.0,11,7,2,20
15884,Australia,1984.0,7,14,31,52
15885,Australia,1972.0,11,7,2,20
15886,Australia,1992.0,14,27,16,57
15887,Australia,1960.0,11,24,11,46
15888,Australia,1960.0,11,24,11,46
15889,Australia,1996.0,32,16,84,132
15890,Australia,1996.0,32,16,84,132
15891,Australia,2000.0,60,69,54,183
15892,Australia,1992.0,14,27,16,57
15893,Australia,1988.0,18,6,11,35
15894,Australia,1988.0,18,6,11,35
15895,Australia,2000.0,60,69,54,183
15896,Australia,1948.0,2,9,5,16
15897,Australia,2008.0,31,42,76,149
15898,Australia,2016.0,23,34,25,82
15899,Australia,1948.0,2,9,5,16
15900,Australia,2004.0,49,77,31,157
15901,Australia,2004.0,49,77,31,157
15902,Australia,2008.0,31,42,76,149
15903,Australia,2012.0,18,37,59,114
15904,Australia,2000.0,60,69,54,183
15905,Australia,2004.0,49,77,31,157
15906,Australia,1952.0,7,2,11,20
15907,Australia,1906.0,0,0,3,3
15908,Australia,1906.0,0,0,3,3
15909,Australia,2004.0,49,77,31,157
15910,Australia,2008.0,31,42,76,149
15911,Australia,2012.0,18,37,59,114
15912,Australia,2012.0,18,37,59,114
15913,Australia,2016.0,23,34,25,82
15914,Australia,2004.0,49,77,31,157
15915,Australia,2008.0,31,42,76,149
15916,Australia,2012.0,18,37,59,114
15917,Australia,1984.0,7,14,31,52
15918,Australia,2004.0,49,77,31,157
15919,Australia,2004.0,49,77,31,157
15920,Australia,2008.0,31,42,76,149
15921,Australia,2012.0,18,37,59,114
15922,Australia,1996.0,32,16,84,132
15923,Australia,1920.0,0,6,1,7
15924,Australia,1920.0,0,6,1,7
15925,Australia,1924.0,4,5,2,11
15926,Australia,1924.0,4,5,2,11
15927,Australia,2016.0,23,34,25,82
15928,Australia,1960.0,11,24,11,46
15929,Australia,2006.0,1,0,1,2
15930,Australia,2010.0,2,1,0,3
15931,Australia,1988.0,18,6,11,35
15932,Australia,2012.0,18,37,59,114
15933,Australia,2016.0,23,34,25,82
15934,Australia,1976.0,0,15,8,23
15935,Australia,1964.0,8,6,30,44
15936,Australia,1968.0,5,35,11,51
15937,Australia,2008.0,31,42,76,149
15938,Australia,2016.0,23,34,25,82
15939,Australia,1956.0,28,13,26,67
15940,Australia,1976.0,0,15,8,23
15941,Australia,1984.0,7,14,31,52
15942,Australia,1960.0,11,24,11,46
15943,Australia,1964.0,8,6,30,44
15944,Australia,1964.0,8,6,30,44
15945,Australia,1976.0,0,15,8,23
15946,Australia,1992.0,14,27,16,57
15947,Australia,2008.0,31,42,76,149
15948,Australia,2016.0,23,34,25,82
15949,Australia,1992.0,14,27,16,57
15950,Australia,2012.0,18,37,59,114
15951,Australia,1964.0,8,6,30,44
15952,Australia,2000.0,60,69,54,183
15953,Australia,2012.0,18,37,59,114
15954,Australia,2016.0,23,34,25,82
15955,Australia,1992.0,14,27,16,57
15956,Australia,2016.0,23,34,25,82
15957,Australia,1992.0,14,27,16,57
15958,Australia,1996.0,32,16,84,132
15959,Australia,1996.0,32,16,84,132
15960,Australia,2000.0,60,69,54,183
15961,Australia,1964.0,8,6,30,44
15962,Australia,2008.0,31,42,76,149
15963,Australia,1988.0,18,6,11,35
15964,Australia,1996.0,32,16,84,132
15965,Australia,2000.0,60,69,54,183
15966,Australia,1956.0,28,13,26,67
15967,Australia,1968.0,5,35,11,51
15968,Australia,1972.0,11,7,2,20
15969,Australia,1972.0,11,7,2,20
15970,Australia,1994.0,0,0,4,4
15971,Australia,2002.0,2,0,0,2
15972,Australia,2004.0,49,77,31,157
15973,Australia,1984.0,7,14,31,52
15974,Australia,2000.0,60,69,54,183
15975,Australia,2004.0,49,77,31,157
15976,Australia,2008.0,31,42,76,149
15977,Australia,1980.0,6,2,5,13
15978,Australia,2004.0,49,77,31,157
15979,Australia,2010.0,2,1,0,3
15980,Australia,2014.0,0,2,1,3
15981,Australia,2008.0,31,42,76,149
15982,Australia,2012.0,18,37,59,114
15983,Australia,2008.0,31,42,76,149
15984,Australia,2008.0,31,42,76,149
15985,Australia,1996.0,32,16,84,132
15986,Australia,2000.0,60,69,54,183
15987,Australia,1996.0,32,16,84,132
15988,Australia,2000.0,60,69,54,183
15989,Australia,2004.0,49,77,31,157
15990,Australia,1980.0,6,2,5,13
15991,Australia,1984.0,7,14,31,52
15992,Australia,1984.0,7,14,31,52
15993,Australia,2004.0,49,77,31,157
15994,Australia,2008.0,31,42,76,149
15995,Australia,1968.0,5,35,11,51
15996,Australia,2004.0,49,77,31,157
15997,Australia,2004.0,49,77,31,157
15998,Australia,1976.0,0,15,8,23
15999,Australia,1996.0,32,16,84,132
16000,Australia,2000.0,60,69,54,183
16001,Australia,2008.0,31,42,76,149
16002,Australia,2012.0,18,37,59,114
16003,Australia,1956.0,28,13,26,67
16004,Australia,1956.0,28,13,26,67
16005,Australia,1976.0,0,15,8,23
16006,Australia,1948.0,2,9,5,16
16007,Australia,1984.0,7,14,31,52
16008,Australia,1984.0,7,14,31,52
16009,Australia,1988.0,18,6,11,35
16010,Australia,2000.0,60,69,54,183
16011,Australia,2008.0,31,42,76,149
16012,Australia,2012.0,18,37,59,114
16013,Australia,2000.0,60,69,54,183
16014,Australia,2004.0,49,77,31,157
16015,Australia,2000.0,60,69,54,183
16016,Australia,2000.0,60,69,54,183
16017,Australia,2004.0,49,77,31,157
16018,Australia,2016.0,23,34,25,82
16019,Australia,2016.0,23,34,25,82
16020,Australia,1960.0,11,24,11,46
16021,Australia,2004.0,49,77,31,157
16022,Australia,2012.0,18,37,59,114
16023,Buraddoo,1956.0,28,13,26,67
16024,Australia,1968.0,5,35,11,51
16025,Australia,1984.0,7,14,31,52
16026,Australia,2000.0,60,69,54,183
16027,Australia,2008.0,31,42,76,149
16028,Australia,2000.0,60,69,54,183
16029,Australia,2012.0,18,37,59,114
16030,Australia,2016.0,23,34,25,82
16031,Australia,2008.0,31,42,76,149
16032,Australia,2008.0,31,42,76,149
16033,Australia,2012.0,18,37,59,114
16034,Australia,2016.0,23,34,25,82
16035,Australia,2016.0,23,34,25,82
16036,Australia,2002.0,2,0,0,2
16037,Australia,2006.0,1,0,1,2
16038,Australia,1988.0,18,6,11,35
16039,Australia,1988.0,18,6,11,35
16040,Australia,1988.0,18,6,11,35
16041,Australia,1992.0,14,27,16,57
16042,Australia,2004.0,49,77,31,157
16043,Australia,2004.0,49,77,31,157
16044,Australia,2012.0,18,37,59,114
16045,Australia,1960.0,11,24,11,46
16046,Australia,1996.0,32,16,84,132
16047,Australia,2016.0,23,34,25,82
16048,Australia,2000.0,60,69,54,183
16049,Australia,1952.0,7,2,11,20
16050,Australia,2016.0,23,34,25,82
16051,Australia,2016.0,23,34,25,82
16052,Australia,2016.0,23,34,25,82
16053,Australia,1996.0,32,16,84,132
16054,Australia,1952.0,7,2,11,20
16055,Australia,1956.0,28,13,26,67
16056,Australia,1956.0,28,13,26,67
16057,Australia,2012.0,18,37,59,114
16058,Australia,1984.0,7,14,31,52
16059,Australia,1976.0,0,15,8,23
16060,Australia,1924.0,4,5,2,11
16061,Australia,1924.0,4,5,2,11
16062,Australia,1924.0,4,5,2,11
16063,Australia,1928.0,1,2,1,4
16064,Australia,1928.0,1,2,1,4
16065,Australia,1988.0,18,6,11,35
16066,Australia,2016.0,23,34,25,82
16067,Australia,1952.0,7,2,11,20
16068,Australia,1996.0,32,16,84,132
16069,Australia,1924.0,4,5,2,11
16070,Australia,2012.0,18,37,59,114
16071,Australia,1972.0,11,7,2,20
16072,Australia,1964.0,8,6,30,44
16073,Australia,2012.0,18,37,59,114
16074,Australia,1988.0,18,6,11,35
16075,Australia,1968.0,5,35,11,51
16076,Australia,2008.0,31,42,76,149
16077,Australia,1996.0,32,16,84,132
16078,Australia,2000.0,60,69,54,183
16079,Australia,1960.0,11,24,11,46
16080,Australia,2000.0,60,69,54,183
16081,Australia-1,1996.0,32,16,84,132
16082,Australia-1,2000.0,60,69,54,183
16083,Australia,2016.0,23,34,25,82
16084,Australia,1996.0,32,16,84,132
16085,Australia,2004.0,49,77,31,157
16086,Australia,1976.0,0,15,8,23
16087,Australia,1992.0,14,27,16,57
16088,Australia,1972.0,11,7,2,20
16089,Australia,1996.0,32,16,84,132
16090,Australia,1992.0,14,27,16,57
16091,Australia,1992.0,14,27,16,57
16092,Australia,2012.0,18,37,59,114
16093,Australia,2012.0,18,37,59,114
16094,Australia,2012.0,18,37,59,114
16095,Australia,2012.0,18,37,59,114
16096,Australia,2012.0,18,37,59,114
16097,Australia,1952.0,7,2,11,20
16098,Australia,1952.0,7,2,11,20
16099,Australia,2008.0,31,42,76,149
16100,Australia,1996.0,32,16,84,132
16101,Australia,1960.0,11,24,11,46
16102,Australia,1956.0,28,13,26,67
16103,Australia,1956.0,28,13,26,67
16104,Australia,1956.0,28,13,26,67
16105,Australia,1960.0,11,24,11,46
16106,Australia,2008.0,31,42,76,149
16107,Australia,1956.0,28,13,26,67
16108,Australia,2008.0,31,42,76,149
16109,Australia,1964.0,8,6,30,44
16110,Australia,2012.0,18,37,59,114
16111,Australia,2012.0,18,37,59,114
16112,Australia,2016.0,23,34,25,82
16113,Australia,1996.0,32,16,84,132
16114,Australia,2004.0,49,77,31,157
16115,Australia,2008.0,31,42,76,149
16116,Australia,1972.0,11,7,2,20
16117,Australia,2004.0,49,77,31,157
16118,Australia,2012.0,18,37,59,114
16119,Australia,1968.0,5,35,11,51
16120,Australia,1956.0,28,13,26,67
16121,Australia,1956.0,28,13,26,67
16122,Australia,1956.0,28,13,26,67
16123,Australia,1964.0,8,6,30,44
16124,Australia,2016.0,23,34,25,82
16125,Australia,1976.0,0,15,8,23
16126,Australia,2016.0,23,34,25,82
16127,Australia,2008.0,31,42,76,149
16128,Australia,1988.0,18,6,11,35
16129,Australia,1952.0,7,2,11,20
16130,Australia,1948.0,2,9,5,16
16131,Australia,1992.0,14,27,16,57
16132,Australia,1996.0,32,16,84,132
16133,Australia,2000.0,60,69,54,183
16134,Australia,2008.0,31,42,76,149
16135,Australia,2004.0,49,77,31,157
16136,Australia,2004.0,49,77,31,157
16137,Australia,2008.0,31,42,76,149
16138,Australia,2012.0,18,37,59,114
16139,Australia,2004.0,49,77,31,157
16140,Australia,1964.0,8,6,30,44
16141,Australia,1968.0,5,35,11,51
16142,Australia,2012.0,18,37,59,114
16143,Australia,2008.0,31,42,76,149
16144,Australia,1984.0,7,14,31,52
16145,Australia,1984.0,7,14,31,52
16146,Australia,1996.0,32,16,84,132
16147,Australia,1932.0,3,1,1,5
16148,Australia,2012.0,18,37,59,114
16149,Australia,2012.0,18,37,59,114
16150,Australia,1956.0,28,13,26,67
16151,Australia,1956.0,28,13,26,67
16152,Australia,1960.0,11,24,11,46
16153,Australia,1960.0,11,24,11,46
16154,Australia,1996.0,32,16,84,132
16155,Australia,1996.0,32,16,84,132
16156,Australia,2000.0,60,69,54,183
16157,Australia,1960.0,11,24,11,46
16158,Australia,1964.0,8,6,30,44
16159,Australia,1964.0,8,6,30,44
16160,Australia,1968.0,5,35,11,51
16161,Australia,1996.0,32,16,84,132
16162,Australia,2000.0,60,69,54,183
16163,Australia,1992.0,14,27,16,57
16164,Australia,1996.0,32,16,84,132
16165,Australia,2000.0,60,69,54,183
16166,Australia,2012.0,18,37,59,114
16167,Australia,1964.0,8,6,30,44
16168,Australia,1996.0,32,16,84,132
16169,Australia,2000.0,60,69,54,183
16170,Australia,2008.0,31,42,76,149
16171,Australia,2004.0,49,77,31,157
16172,Australia,1988.0,18,6,11,35
16173,Australia,1968.0,5,35,11,51
16174,Australia,1968.0,5,35,11,51
16175,Australia,1956.0,28,13,26,67
16176,Australia,1992.0,14,27,16,57
16177,Australia,1996.0,32,16,84,132
16178,Australia,2000.0,60,69,54,183
16179,Australia,2000.0,60,69,54,183
16180,Australia,2012.0,18,37,59,114
16181,Australia,2016.0,23,34,25,82
16182,Australia,1988.0,18,6,11,35
16183,Australia,1996.0,32,16,84,132
16184,Australia,2000.0,60,69,54,183
16185,Australia,1968.0,5,35,11,51
16186,Australia,2004.0,49,77,31,157
16187,Australia,2008.0,31,42,76,149
16188,Australia,2012.0,18,37,59,114
16189,Australia,2004.0,49,77,31,157
16190,Australia,2000.0,60,69,54,183
16191,Australia,1996.0,32,16,84,132
16192,Australia,2000.0,60,69,54,183
16193,Australia,2004.0,49,77,31,157
16194,Australia,2016.0,23,34,25,82
16195,Australia,2012.0,18,37,59,114
16196,Australia,1984.0,7,14,31,52
16197,Australia,1996.0,32,16,84,132
16198,Australia,2000.0,60,69,54,183
16199,Australia,2004.0,49,77,31,157
16200,Australia,2004.0,49,77,31,157
16201,Australia,2000.0,60,69,54,183
16202,Australia,2004.0,49,77,31,157
16203,Australia,1960.0,11,24,11,46
16204,Australia,2000.0,60,69,54,183
16205,Australia,1992.0,14,27,16,57
16206,Australia,1996.0,32,16,84,132
16207,Australia,2012.0,18,37,59,114
16208,Australia,2012.0,18,37,59,114
16209,Australia,2012.0,18,37,59,114
16210,Australia,2016.0,23,34,25,82
16211,Australia,2016.0,23,34,25,82
16212,Australia,2016.0,23,34,25,82
16213,Australia,2016.0,23,34,25,82
16214,Australia,2012.0,18,37,59,114
16215,Australia,1992.0,14,27,16,57
16216,Australia,1980.0,6,2,5,13
16217,Australia,1980.0,6,2,5,13
16218,Australia,1984.0,7,14,31,52
16219,Australia,1984.0,7,14,31,52
16220,Australia,1964.0,8,6,30,44
16221,Australia,1968.0,5,35,11,51
16222,Australia,1984.0,7,14,31,52
16223,Australia,1924.0,4,5,2,11
16224,Australia,1960.0,11,24,11,46
16225,Australia,2000.0,60,69,54,183
16226,Australia,2000.0,60,69,54,183
16227,Australia,2004.0,49,77,31,157
16228,Australia,1996.0,32,16,84,132
16229,Australia,2000.0,60,69,54,183
16230,Australia,2004.0,49,77,31,157
16231,Australia,1996.0,32,16,84,132
16232,Australia,2000.0,60,69,54,183
16233,Australia,1984.0,7,14,31,52
16234,Australia,1968.0,5,35,11,51
16235,Australia,2000.0,60,69,54,183
16236,Australia,1996.0,32,16,84,132
16237,Australia,2000.0,60,69,54,183
16238,Australia,2008.0,31,42,76,149
16239,Australia,1924.0,4,5,2,11
16240,Australia,2004.0,49,77,31,157
16241,Australia,1952.0,7,2,11,20
16242,Australia,1988.0,18,6,11,35
16243,Australia/Great Britain,1896.0,2,0,1,3
16244,Australia,1896.0,2,0,1,3
16245,Australia,1896.0,2,0,1,3
16246,Australia,1988.0,18,6,11,35
16247,Australia,2008.0,31,42,76,149
16248,Australia,2000.0,60,69,54,183
16249,Australia,1972.0,11,7,2,20
16250,Australia,1992.0,14,27,16,57
16251,Australia,2000.0,60,69,54,183
16252,Australia,1980.0,6,2,5,13
16253,Australia,1980.0,6,2,5,13
16254,Australia,2012.0,18,37,59,114
16255,Australia,2000.0,60,69,54,183
16256,Australia,2012.0,18,37,59,114
16257,Australia,2016.0,23,34,25,82
16258,Australia,1992.0,14,27,16,57
16259,Australia,1984.0,7,14,31,52
16260,Australia,1988.0,18,6,11,35
16261,Australia,2012.0,18,37,59,114
16262,Australia,2016.0,23,34,25,82
16263,Australia,2000.0,60,69,54,183
16264,Australia,1956.0,28,13,26,67
16265,Australia,1956.0,28,13,26,67
16266,Australia,1956.0,28,13,26,67
16267,Australia,1960.0,11,24,11,46
16268,Australia,1960.0,11,24,11,46
16269,Australia,1960.0,11,24,11,46
16270,Australia,1964.0,8,6,30,44
16271,Australia,1964.0,8,6,30,44
16272,Australia,1956.0,28,13,26,67
16273,Australia,2008.0,31,42,76,149
16274,Australia,2008.0,31,42,76,149
16275,Australia,2008.0,31,42,76,149
16276,Australia,1996.0,32,16,84,132
16277,Australia,2008.0,31,42,76,149
16278,Australia,1996.0,32,16,84,132
16279,Australia,2000.0,60,69,54,183
16280,Australia,1960.0,11,24,11,46
16281,Australia,2000.0,60,69,54,183
16282,Australia,1904.0,0,3,1,4
16283,Australia,1904.0,0,3,1,4
16284,Australia,1904.0,0,3,1,4
16285,Australia,1904.0,0,3,1,4
16286,Australia,2008.0,31,42,76,149
16287,Australia,2008.0,31,42,76,149
16288,Australia,1996.0,32,16,84,132
16289,Australia,1948.0,2,9,5,16
16290,Australia,1956.0,28,13,26,67
16291,Australia,1960.0,11,24,11,46
16292,Australia,1996.0,32,16,84,132
16293,Australia,2000.0,60,69,54,183
16294,Australia,2004.0,49,77,31,157
16295,Australia,2008.0,31,42,76,149
16296,Australia,1956.0,28,13,26,67
16297,Australia,1996.0,32,16,84,132
16298,Australia,2000.0,60,69,54,183
16299,Australia,1996.0,32,16,84,132
16300,Australia,2004.0,49,77,31,157
16301,Australia,2008.0,31,42,76,149
16302,Australia,2012.0,18,37,59,114
16303,Australia,1956.0,28,13,26,67
16304,Australia,2016.0,23,34,25,82
16305,Australia,1964.0,8,6,30,44
16306,Australia,1968.0,5,35,11,51
16307,Australia,2008.0,31,42,76,149
16308,Australia,2012.0,18,37,59,114
16309,Australia,1976.0,0,15,8,23
16310,Australia,2004.0,49,77,31,157
16311,Australia,1956.0,28,13,26,67
16312,Australia,1996.0,32,16,84,132
16313,Australia,2000.0,60,69,54,183
16314,Australia,1996.0,32,16,84,132
16315,Australia,2000.0,60,69,54,183
16316,Australia,1956.0,28,13,26,67
16317,Australia,1972.0,11,7,2,20
16318,Australia,1972.0,11,7,2,20
16319,Australia,1972.0,11,7,2,20
16320,Australia,1972.0,11,7,2,20
16321,Australia,1972.0,11,7,2,20
16322,Australia,2012.0,18,37,59,114
16323,Australia,2000.0,60,69,54,183
16324,Australia,1988.0,18,6,11,35
16325,Australia,1992.0,14,27,16,57
16326,Australia,1928.0,1,2,1,4
16327,Australia,1932.0,3,1,1,5
16328,Australia,1992.0,14,27,16,57
16329,Australia,1956.0,28,13,26,67
16330,Australia,2016.0,23,34,25,82
16331,Australia,1992.0,14,27,16,57
16332,Australia,1996.0,32,16,84,132
16333,Australia,1952.0,7,2,11,20
16334,Australia,1956.0,28,13,26,67
16335,Australia,1984.0,7,14,31,52
16336,Australia,1996.0,32,16,84,132
16337,Australia,1984.0,7,14,31,52
16338,Australia,2016.0,23,34,25,82
16339,Australia,2000.0,60,69,54,183
16340,Australia,2008.0,31,42,76,149
16341,Australia,1968.0,5,35,11,51
16342,Australia,2016.0,23,34,25,82
16343,Australia,2016.0,23,34,25,82
16344,Australia,2008.0,31,42,76,149
16345,Australia,1984.0,7,14,31,52
16346,Australia,2000.0,60,69,54,183
16347,Australia,2008.0,31,42,76,149
16348,Australia,2012.0,18,37,59,114
16349,Australia,2000.0,60,69,54,183
16350,Australia,2000.0,60,69,54,183
16351,Australia,2004.0,49,77,31,157
16352,Australia,2004.0,49,77,31,157
16353,Australia,2004.0,49,77,31,157
16354,Australia,2008.0,31,42,76,149
16355,Australia,2008.0,31,42,76,149
16356,Australia,1996.0,32,16,84,132
16357,Australia,1996.0,32,16,84,132
16358,Australia,1968.0,5,35,11,51
16359,Australia,1976.0,0,15,8,23
16360,Australia,1956.0,28,13,26,67
16361,Australia,2004.0,49,77,31,157
16362,Australia,2008.0,31,42,76,149
16363,Australia,1976.0,0,15,8,23
16364,Australia,2000.0,60,69,54,183
16365,Australia,2004.0,49,77,31,157
16366,Australia,2000.0,60,69,54,183
16367,Australia,1994.0,0,0,4,4
16368,Australia,1996.0,32,16,84,132
16369,Australia,2000.0,60,69,54,183
16370,Australia,2004.0,49,77,31,157
16371,Australia,2004.0,49,77,31,157
16372,Australia,2004.0,49,77,31,157
16373,Australia,2000.0,60,69,54,183
16374,Australia,2008.0,31,42,76,149
16375,Australia,1996.0,32,16,84,132
16376,Australia,2000.0,60,69,54,183
16377,Australia,2004.0,49,77,31,157
16378,Australia,2008.0,31,42,76,149
16379,Australia,2000.0,60,69,54,183
16380,Australia,2004.0,49,77,31,157
16381,Australia,2000.0,60,69,54,183
16382,Australia,2004.0,49,77,31,157
16383,Australia,2008.0,31,42,76,149
16384,Australia,2012.0,18,37,59,114
16385,Australia,1996.0,32,16,84,132
16386,Australia,2000.0,60,69,54,183
16387,Australia,1988.0,18,6,11,35
16388,Australia,1996.0,32,16,84,132
16389,Australia,2000.0,60,69,54,183
16390,Australia,1992.0,14,27,16,57
16391,Australia,1920.0,0,6,1,7
16392,Australia,1960.0,11,24,11,46
16393,Australia,1960.0,11,24,11,46
16394,Australia,2000.0,60,69,54,183
16395,Australia,1906.0,0,0,3,3
16396,Australia,1984.0,7,14,31,52
16397,Australia,2008.0,31,42,76,149
16398,Australia,2004.0,49,77,31,157
16399,Australia,2004.0,49,77,31,157
16400,Australia,1956.0,28,13,26,67
16401,Australia,1956.0,28,13,26,67
16402,Australia,1924.0,4,5,2,11
16403,Australia,2004.0,49,77,31,157
16404,Australia,2004.0,49,77,31,157
16405,Australia,2004.0,49,77,31,157
16406,Australia,2012.0,18,37,59,114
16407,Australia,2016.0,23,34,25,82
16408,Australia,1920.0,0,6,1,7
16409,Australia,2008.0,31,42,76,149
16410,Australia,1956.0,28,13,26,67
16411,Australia,1996.0,32,16,84,132
16412,Australia,2004.0,49,77,31,157
16413,Australia,2000.0,60,69,54,183
16414,Australia,2016.0,23,34,25,82
16415,Australia,2004.0,49,77,31,157
16416,Australia,2000.0,60,69,54,183
16417,Australia,2000.0,60,69,54,183
16418,Australia,1988.0,18,6,11,35
16419,Australia,1964.0,8,6,30,44
16420,Australia,2004.0,49,77,31,157
16421,Australia,1956.0,28,13,26,67
16422,Australia,1956.0,28,13,26,67
16423,Australia,1976.0,0,15,8,23
16424,Australia,1996.0,32,16,84,132
16425,Australia,2000.0,60,69,54,183
16426,Australia,1984.0,7,14,31,52
16427,Australia,1996.0,32,16,84,132
16428,Australia,2008.0,31,42,76,149
16429,Australia,2000.0,60,69,54,183
16430,Australia,2004.0,49,77,31,157
16431,Australia,2012.0,18,37,59,114
16432,Australia,2016.0,23,34,25,82
16433,Australia,1992.0,14,27,16,57
16434,Australia,1956.0,28,13,26,67
16435,Australia,1956.0,28,13,26,67
16436,Australia,1992.0,14,27,16,57
16437,Australia,1996.0,32,16,84,132
16438,Australia,2000.0,60,69,54,183
16439,Australia,2000.0,60,69,54,183
16440,Australia,1996.0,32,16,84,132
16441,Australia,2000.0,60,69,54,183
16442,Australia,2000.0,60,69,54,183
16443,Australia,2000.0,60,69,54,183
16444,Australia,2010.0,2,1,0,3
16445,Australia,2014.0,0,2,1,3
16446,Australia,2000.0,60,69,54,183
16447,Australia,1976.0,0,15,8,23
16448,Australia,2000.0,60,69,54,183
16449,Australia,2004.0,49,77,31,157
16450,Australia,2008.0,31,42,76,149
16451,Australia,2012.0,18,37,59,114
16452,Australia,1952.0,7,2,11,20
16453,Australia,1952.0,7,2,11,20
16454,Australia,2000.0,60,69,54,183
16455,Australia,2012.0,18,37,59,114
16456,Australia,2012.0,18,37,59,114
16457,Australia,2016.0,23,34,25,82
16458,Australia,1996.0,32,16,84,132
16459,Australia,2008.0,31,42,76,149
16460,Australia,1960.0,11,24,11,46
16461,Australia,2000.0,60,69,54,183
16462,Australia,2000.0,60,69,54,183
16463,Australia,2004.0,49,77,31,157
16464,Australia,2004.0,49,77,31,157
16465,Australia,2004.0,49,77,31,157
16466,Australia,2008.0,31,42,76,149
16467,Australia,2008.0,31,42,76,149
16468,Australia,2008.0,31,42,76,149
16469,Australia,2012.0,18,37,59,114
16470,Australia,2008.0,31,42,76,149
16471,Australia,2000.0,60,69,54,183
16472,Australia,1996.0,32,16,84,132
16473,Australia,1984.0,7,14,31,52
16474,Australia,2008.0,31,42,76,149
16475,Australia,2012.0,18,37,59,114
16476,Australia,2016.0,23,34,25,82
16477,Australia,1984.0,7,14,31,52
16478,Australia,1992.0,14,27,16,57
16479,Australia,2000.0,60,69,54,183
16480,Australia,2004.0,49,77,31,157
16481,Australia,1996.0,32,16,84,132
16482,Australia,1984.0,7,14,31,52
16483,Australia,1980.0,6,2,5,13
16484,Australia,1980.0,6,2,5,13
16485,Australia,1984.0,7,14,31,52
16486,Australia,1996.0,32,16,84,132
16487,Australia,1964.0,8,6,30,44
16488,Australia,1968.0,5,35,11,51
16489,Australia,2004.0,49,77,31,157
16490,Australia,1948.0,2,9,5,16
16491,Australia,2000.0,60,69,54,183
16492,Australia,2004.0,49,77,31,157
16493,Australia,2000.0,60,69,54,183
16494,Australia,1920.0,0,6,1,7
16495,Australia,1992.0,14,27,16,57
16496,Australia,1996.0,32,16,84,132
16497,Australia,2000.0,60,69,54,183
16498,Australia,2000.0,60,69,54,183
16499,Australia,2000.0,60,69,54,183
16500,Australia,2000.0,60,69,54,183
16501,Australia,2004.0,49,77,31,157
16502,Australia,2004.0,49,77,31,157
16503,Australia,2008.0,31,42,76,149
16504,Australia,2012.0,18,37,59,114
16505,Australia,2008.0,31,42,76,149
16506,Australia,2012.0,18,37,59,114
16507,Australia,2008.0,31,42,76,149
16508,Australia,1960.0,11,24,11,46
16509,Australia,1960.0,11,24,11,46
16510,Australia,1960.0,11,24,11,46
16511,Australia,1960.0,11,24,11,46
16512,Australia,1960.0,11,24,11,46
16513,Australia,1996.0,32,16,84,132
16514,Australia,1996.0,32,16,84,132
16515,Australia,1996.0,32,16,84,132
16516,Australia,2000.0,60,69,54,183
16517,Australia,2012.0,18,37,59,114
16518,Australia,2000.0,60,69,54,183
16519,Australia,2008.0,31,42,76,149
16520,Australia,1968.0,5,35,11,51
16521,Australia,2004.0,49,77,31,157
16522,Australia,1984.0,7,14,31,52
16523,Australia,1996.0,32,16,84,132
16524,Australia,1956.0,28,13,26,67
16525,Australia,1900.0,3,0,3,6
16526,Australia,1900.0,3,0,3,6
16527,Australia,2016.0,23,34,25,82
16528,Australia,2016.0,23,34,25,82
16529,Australia,2004.0,49,77,31,157
16530,Australia,1960.0,11,24,11,46
16531,Australia,2008.0,31,42,76,149
16532,Australia,2008.0,31,42,76,149
16533,Australia,2008.0,31,42,76,149
16534,Australia,1960.0,11,24,11,46
16535,Australia,1960.0,11,24,11,46
16536,Australia,1956.0,28,13,26,67
16537,Australia,2008.0,31,42,76,149
16538,Australia,1956.0,28,13,26,67
16539,Australia,1984.0,7,14,31,52
16540,Australia,1996.0,32,16,84,132
16541,Australia,1956.0,28,13,26,67
16542,Australia,1956.0,28,13,26,67
16543,Australia,1984.0,7,14,31,52
16544,Australia,2004.0,49,77,31,157
16545,Australia,2004.0,49,77,31,157
16546,Australia,2008.0,31,42,76,149
16547,Australia,2008.0,31,42,76,149
16548,Australia,2008.0,31,42,76,149
16549,Australia,2008.0,31,42,76,149
16550,Australia,2012.0,18,37,59,114
16551,Australia,1996.0,32,16,84,132
16552,Australia,2004.0,49,77,31,157
16553,Australia,1992.0,14,27,16,57
16554,Australia,1992.0,14,27,16,57
16555,Australia,1992.0,14,27,16,57
16556,Australia,1996.0,32,16,84,132
16557,Australia,2012.0,18,37,59,114
16558,Australia,2000.0,60,69,54,183
16559,Australia,2004.0,49,77,31,157
16560,Australia,1992.0,14,27,16,57
16561,Australia,1996.0,32,16,84,132
16562,Australia,1996.0,32,16,84,132
16563,Australia,2004.0,49,77,31,157
16564,Australia,2012.0,18,37,59,114
16565,Australia,2016.0,23,34,25,82
16566,Australia,2004.0,49,77,31,157
16567,Australia,2000.0,60,69,54,183
16568,Australia,1984.0,7,14,31,52
16569,Australia,1984.0,7,14,31,52
16570,Australia,1948.0,2,9,5,16
16571,Australia,2008.0,31,42,76,149
16572,Australia,1956.0,28,13,26,67
16573,Australia,1996.0,32,16,84,132
16574,Australia,2012.0,18,37,59,114
16575,Australia,2004.0,49,77,31,157
16576,Australia,1960.0,11,24,11,46
16577,Australia,2012.0,18,37,59,114
16578,Australia,2012.0,18,37,59,114
16579,Australia,2016.0,23,34,25,82
16580,Australia,1996.0,32,16,84,132
16581,Australia,1996.0,32,16,84,132
16582,Australia,2000.0,60,69,54,183
16583,Australia,1956.0,28,13,26,67
16584,Australia,2008.0,31,42,76,149
16585,Australia,1956.0,28,13,26,67
16586,Australia,1996.0,32,16,84,132
16587,Australia,2000.0,60,69,54,183
16588,Australia,1996.0,32,16,84,132
16589,Australia,1948.0,2,9,5,16
16590,Australia,1948.0,2,9,5,16
16591,Australia,1968.0,5,35,11,51
16592,Australia,1988.0,18,6,11,35
16593,Australia,1968.0,5,35,11,51
16594,Australia,1964.0,8,6,30,44
16595,Australia,1948.0,2,9,5,16
16596,Australia,2008.0,31,42,76,149
16597,Australia,1956.0,28,13,26,67
16598,Australia,1956.0,28,13,26,67
16599,Australia,2004.0,49,77,31,157
16600,Australia,2000.0,60,69,54,183
16601,Australia,1964.0,8,6,30,44
16602,Australia,2004.0,49,77,31,157
16603,Australia,1988.0,18,6,11,35
16604,Australia,1968.0,5,35,11,51
16605,Australia,1968.0,5,35,11,51
16606,Australia,2008.0,31,42,76,149
16607,Australia,2012.0,18,37,59,114
16608,Australia,2012.0,18,37,59,114
16609,Australia,1996.0,32,16,84,132
16610,Australia,2000.0,60,69,54,183
16611,Australia,1988.0,18,6,11,35
16612,Australia,2016.0,23,34,25,82
16613,Australia,2016.0,23,34,25,82
16614,Australia,1996.0,32,16,84,132
16615,Australia,1996.0,32,16,84,132
16616,Australia,2000.0,60,69,54,183
16617,Australia,2004.0,49,77,31,157
16618,Australia,2004.0,49,77,31,157
16619,Australia,1988.0,18,6,11,35
16620,Australia,1992.0,14,27,16,57
16621,Australia,1988.0,18,6,11,35
16622,Australia,2000.0,60,69,54,183
16623,Australia,1992.0,14,27,16,57
16624,Australia,1996.0,32,16,84,132
16625,Australia,2000.0,60,69,54,183
16626,Australia,2004.0,49,77,31,157
16627,Australia,2008.0,31,42,76,149
16628,Australia,2016.0,23,34,25,82
16629,Australia,2016.0,23,34,25,82
16630,Australia,2016.0,23,34,25,82
16631,Australia,2016.0,23,34,25,82
16632,Australia,2016.0,23,34,25,82
16633,Australia,1948.0,2,9,5,16
16634,Australia,1984.0,7,14,31,52
16635,Australia,2008.0,31,42,76,149
16636,Australia,2012.0,18,37,59,114
16637,Australia,1996.0,32,16,84,132
16638,Australia,1992.0,14,27,16,57
16639,Australia,1996.0,32,16,84,132
16640,Australia,2012.0,18,37,59,114
16641,Australia,2016.0,23,34,25,82
16642,Australia,1964.0,8,6,30,44
16643,Australia,1932.0,3,1,1,5
16644,Australia,2004.0,49,77,31,157
16645,Australia,2004.0,49,77,31,157
16646,Australia,2008.0,31,42,76,149
16647,Australia,2012.0,18,37,59,114
16648,Australia,2012.0,18,37,59,114
16649,Australia,2016.0,23,34,25,82
16650,Australia,2008.0,31,42,76,149
16651,Australia,1956.0,28,13,26,67
16652,Australia,1936.0,0,0,1,1
16653,Australia,1980.0,6,2,5,13
16654,Australia,2004.0,49,77,31,157
16655,Australia,2004.0,49,77,31,157
16656,Australia,2000.0,60,69,54,183
16657,Australia,1996.0,32,16,84,132
16658,Australia,1996.0,32,16,84,132
16659,Australia,2004.0,49,77,31,157
16660,Australia,2004.0,49,77,31,157
16661,Australia,2008.0,31,42,76,149
16662,Australia,2000.0,60,69,54,183
16663,Australia,2008.0,31,42,76,149
16664,Australia,1980.0,6,2,5,13
16665,Australia,2000.0,60,69,54,183
16666,Australia,2000.0,60,69,54,183
16667,Australia,1952.0,7,2,11,20
16668,Australia,1952.0,7,2,11,20
16669,Australia,2008.0,31,42,76,149
16670,Australia,2004.0,49,77,31,157
16671,Australia,1956.0,28,13,26,67
16672,Australia,1956.0,28,13,26,67
16673,Australia,2012.0,18,37,59,114
16674,Australia,1968.0,5,35,11,51
16675,Australia,2012.0,18,37,59,114
16676,Australia,2016.0,23,34,25,82
16677,Australia,1960.0,11,24,11,46
16678,Australia,1960.0,11,24,11,46
16679,Australia,1968.0,5,35,11,51
16680,Australia,1956.0,28,13,26,67
16681,Australia,1960.0,11,24,11,46
16682,Australia,2014.0,0,2,1,3
16683,Australia,1996.0,32,16,84,132
16684,Australia,2000.0,60,69,54,183
16685,Australia,2000.0,60,69,54,183
16686,Australia,2004.0,49,77,31,157
16687,Australia,2008.0,31,42,76,149
16688,Australia,2004.0,49,77,31,157
16689,Australia,2008.0,31,42,76,149
16690,Australia,2004.0,49,77,31,157
16691,Australia,1984.0,7,14,31,52
16692,Australia,1984.0,7,14,31,52
16693,Australia,1964.0,8,6,30,44
16694,Australia,2008.0,31,42,76,149
16695,Australia,2008.0,31,42,76,149
16696,Australia,1994.0,0,0,4,4
16697,Buraddoo,1956.0,28,13,26,67
16698,Australia,2016.0,23,34,25,82
16699,Australia,1972.0,11,7,2,20
16700,Australia,2012.0,18,37,59,114
16701,Australia,1988.0,18,6,11,35
16702,Australia,1992.0,14,27,16,57
16703,Australia,2000.0,60,69,54,183
16704,Australia,2000.0,60,69,54,183
16705,Australia,2000.0,60,69,54,183
16706,Australia,2004.0,49,77,31,157
16707,Australia,2004.0,49,77,31,157
16708,Australia,1984.0,7,14,31,52
16709,Australia,1972.0,11,7,2,20
16710,Australia,1964.0,8,6,30,44
16711,Australia,1968.0,5,35,11,51
16712,Australia,2004.0,49,77,31,157
16713,Australia,1994.0,0,0,4,4
16714,Australia,2012.0,18,37,59,114
16715,Australia,1968.0,5,35,11,51
16716,Australia,2000.0,60,69,54,183
16717,Barrenjoey,1964.0,8,6,30,44
16718,Australia,1984.0,7,14,31,52
16719,Australia,1964.0,8,6,30,44
16720,Australia,1964.0,8,6,30,44
16721,Australia,1992.0,14,27,16,57
16722,Australia,2008.0,31,42,76,149
16723,Australia,2012.0,18,37,59,114
16724,Barrenjoey,1964.0,8,6,30,44
16725,Australia,2004.0,49,77,31,157
16726,Australia,1992.0,14,27,16,57
16727,Australia,1996.0,32,16,84,132
16728,Australia,1996.0,32,16,84,132
16729,Australia,2004.0,49,77,31,157
16730,Australia,1956.0,28,13,26,67
16731,Australia,2012.0,18,37,59,114
16732,Australia,2008.0,31,42,76,149
16733,Australia,1992.0,14,27,16,57
16734,Australia,1996.0,32,16,84,132
16735,Australia,1996.0,32,16,84,132
16736,Australia,1996.0,32,16,84,132
16737,Australia,2000.0,60,69,54,183
16738,Australia,2000.0,60,69,54,183
16739,Australia,2000.0,60,69,54,183
16740,Australia,2000.0,60,69,54,183
16741,Australia,2012.0,18,37,59,114
16742,Australia,2004.0,49,77,31,157
16743,Australia,1996.0,32,16,84,132
16744,Australia,2012.0,18,37,59,114
16745,Australia,2004.0,49,77,31,157
16746,Australia,2012.0,18,37,59,114
16747,Australia,2012.0,18,37,59,114
16748,Australia,2016.0,23,34,25,82
16749,Australia,2004.0,49,77,31,157
16750,Australia,2016.0,23,34,25,82
16751,Australia,2008.0,31,42,76,149
16752,Australia,2012.0,18,37,59,114
16753,Australia,1952.0,7,2,11,20
16754,Australia,2008.0,31,42,76,149
16755,Australia,2008.0,31,42,76,149
16756,Australia,2012.0,18,37,59,114
16757,Australia,1920.0,0,6,1,7
16758,Australia,2008.0,31,42,76,149
16759,Australia,2016.0,23,34,25,82
16760,Australia,1988.0,18,6,11,35
16761,Australia,1980.0,6,2,5,13
16762,Australia,1984.0,7,14,31,52
16763,Australia,1928.0,1,2,1,4
16764,Australia,1932.0,3,1,1,5
16765,Australia,1964.0,8,6,30,44
16766,Australia,1968.0,5,35,11,51
16767,Australia,1968.0,5,35,11,51
16768,Australia,1968.0,5,35,11,51
16769,Australia,1964.0,8,6,30,44
16770,Australia,1968.0,5,35,11,51
16771,Australia,1984.0,7,14,31,52
16772,Australia,2000.0,60,69,54,183
16773,Australia,2000.0,60,69,54,183
16774,Australia,2004.0,49,77,31,157
16775,Australia,2000.0,60,69,54,183
16776,Australia,2000.0,60,69,54,183
16777,Australia,2016.0,23,34,25,82
16778,Australia,1988.0,18,6,11,35
16779,Australia,1996.0,32,16,84,132
16780,Australia,1996.0,32,16,84,132
16781,Australia,1992.0,14,27,16,57
16782,Australia,1992.0,14,27,16,57
16783,Australia,1996.0,32,16,84,132
16784,Australia,2000.0,60,69,54,183
16785,Australia,2012.0,18,37,59,114
16786,Australia,1996.0,32,16,84,132
16787,Australia,2008.0,31,42,76,149
16788,Australia,1984.0,7,14,31,52
16789,Australia,1976.0,0,15,8,23
16790,Australia,2000.0,60,69,54,183
16791,Australia,2000.0,60,69,54,183
16792,Australia,2008.0,31,42,76,149
16793,Australia,1964.0,8,6,30,44
16794,Australia,1968.0,5,35,11,51
16795,Australia,1988.0,18,6,11,35
16796,Australia,1968.0,5,35,11,51
16797,Australia,1956.0,28,13,26,67
16798,Australia,1976.0,0,15,8,23
16799,Australia,1984.0,7,14,31,52
16800,Australia,1956.0,28,13,26,67
16801,Australia,2004.0,49,77,31,157
16802,Australia,2004.0,49,77,31,157
16803,Australia,2008.0,31,42,76,149
16804,Australia,2000.0,60,69,54,183
16805,Australia,2008.0,31,42,76,149
16806,Australia,2004.0,49,77,31,157
16807,Australia-1,1996.0,32,16,84,132
16808,Australia-1,2000.0,60,69,54,183
16809,Australia,2016.0,23,34,25,82
16810,Australia,1996.0,32,16,84,132
16811,Australia,2000.0,60,69,54,183
16812,Australia,1996.0,32,16,84,132
16813,Australia,2000.0,60,69,54,183
16814,Australia,1960.0,11,24,11,46
16815,Australia,2012.0,18,37,59,114
16816,Australia,2012.0,18,37,59,114
16817,Australia,1976.0,0,15,8,23
16818,Australia,1992.0,14,27,16,57
16819,Australia,2000.0,60,69,54,183
16820,Australia,1968.0,5,35,11,51
16821,Australia,2016.0,23,34,25,82
16822,Australia,2012.0,18,37,59,114
16823,Australia,1968.0,5,35,11,51
16824,Australia,2008.0,31,42,76,149
16825,Australia,2008.0,31,42,76,149
16826,Australia,1984.0,7,14,31,52
16827,Australia,2008.0,31,42,76,149
16828,Australia,2008.0,31,42,76,149
16829,Australia,1976.0,0,15,8,23
16830,Australia,1992.0,14,27,16,57
16831,Australia,2004.0,49,77,31,157
16832,Australia,1964.0,8,6,30,44
16833,Australia,2008.0,31,42,76,149
16834,Australia,2008.0,31,42,76,149
16835,Australia,2008.0,31,42,76,149
16836,Australia,2000.0,60,69,54,183
16837,Australia,2012.0,18,37,59,114
16838,Australia,1996.0,32,16,84,132
16839,Australia,2008.0,31,42,76,149
16840,Australia,2008.0,31,42,76,149
16841,Australia,2012.0,18,37,59,114
16842,Australia,1960.0,11,24,11,46
16843,Australia,1956.0,28,13,26,67
16844,Australia,1968.0,5,35,11,51
16845,Australia,1976.0,0,15,8,23
16846,Australia,1992.0,14,27,16,57
16847,Australia,1996.0,32,16,84,132
16848,Australia,1996.0,32,16,84,132
16849,Australia,2008.0,31,42,76,149
16850,Australia,2008.0,31,42,76,149
16851,Australia,2012.0,18,37,59,114
16852,Australia,2016.0,23,34,25,82
16853,Australia,2004.0,49,77,31,157
16854,Australia,1992.0,14,27,16,57
16855,Australia,1996.0,32,16,84,132
16856,Australia,2004.0,49,77,31,157
16857,Australia,1996.0,32,16,84,132
16858,Australia,1996.0,32,16,84,132
16859,Australia,1996.0,32,16,84,132
16860,Australia,2000.0,60,69,54,183
16861,Australia,2004.0,49,77,31,157
16862,Australia,2008.0,31,42,76,149
16863,Australia,1968.0,5,35,11,51
16864,Australia,1968.0,5,35,11,51
16865,Australia,2004.0,49,77,31,157
16866,Australia,1992.0,14,27,16,57
16867,Australia,1996.0,32,16,84,132
16868,Australia,1992.0,14,27,16,57
16869,Australia,1996.0,32,16,84,132
16870,Australia,2004.0,49,77,31,157
16871,Australia,2000.0,60,69,54,183
16872,Australia,2000.0,60,69,54,183
16873,Australia,2004.0,49,77,31,157
16874,Australia,1956.0,28,13,26,67
16875,Australia,1956.0,28,13,26,67
16876,Australia,1956.0,28,13,26,67
16877,Australia,1960.0,11,24,11,46
16878,Australia,1960.0,11,24,11,46
16879,Australia,1960.0,11,24,11,46
16880,Australia,2008.0,31,42,76,149
16881,Australia,2016.0,23,34,25,82
16882,Australia,2004.0,49,77,31,157
16883,Australia,1900.0,3,0,3,6
16884,Australia,1900.0,3,0,3,6
16885,Australia,1900.0,3,0,3,6
16886,Amateur Athletic Association,1900.0,3,0,3,6
16887,Australia,1992.0,14,27,16,57
16888,Australia,1960.0,11,24,11,46
16889,Australia,1968.0,5,35,11,51
16890,Australia,1976.0,0,15,8,23
16891,Australia,1968.0,5,35,11,51
16892,Australia,1976.0,0,15,8,23
16893,Australia,1976.0,0,15,8,23
16894,Australia,2000.0,60,69,54,183
16895,Australia,1964.0,8,6,30,44
16896,Australia,2008.0,31,42,76,149
16897,Australia,1992.0,14,27,16,57
16898,Australia,1992.0,14,27,16,57
16899,Australia,2000.0,60,69,54,183
16900,Australia,1996.0,32,16,84,132
16901,Australia,2000.0,60,69,54,183
16902,Australia,2004.0,49,77,31,157
16903,Australia,2016.0,23,34,25,82
16904,Australia,2008.0,31,42,76,149
16905,Australia,2008.0,31,42,76,149
16906,Barrenjoey,1964.0,8,6,30,44
16907,Australia,2004.0,49,77,31,157
16908,Australia,2004.0,49,77,31,157
16909,Australia,1968.0,5,35,11,51
16910,Australia,1932.0,3,1,1,5
16911,Australia,1996.0,32,16,84,132
16912,Australia,2004.0,49,77,31,157
16913,Australia,2008.0,31,42,76,149
16914,Australia,2008.0,31,42,76,149
16915,Australia,2008.0,31,42,76,149
16916,Australia,2008.0,31,42,76,149
16917,Australia,2008.0,31,42,76,149
16918,Australia,2012.0,18,37,59,114
16919,Australia,2012.0,18,37,59,114
16920,Australia,2012.0,18,37,59,114
16921,Australia,2004.0,49,77,31,157
16922,Australia,2008.0,31,42,76,149
16923,Australia,2016.0,23,34,25,82
16924,Falcon IV,1956.0,28,13,26,67
16925,Australia,1996.0,32,16,84,132
16926,Australia,2008.0,31,42,76,149
16927,Australia,2012.0,18,37,59,114
16928,Australia,2008.0,31,42,76,149
16929,Australia,2012.0,18,37,59,114
16930,Australia,2012.0,18,37,59,114
16931,Australia,2012.0,18,37,59,114
16932,Australia,2016.0,23,34,25,82
16933,Australia,1972.0,11,7,2,20
16934,Australia,1972.0,11,7,2,20
16935,Australia,1960.0,11,24,11,46
16936,Australia,1968.0,5,35,11,51
16937,Australia,1984.0,7,14,31,52
16938,Australia,1984.0,7,14,31,52
16939,Australia,2016.0,23,34,25,82
16940,Australia,2000.0,60,69,54,183
16941,Australia,1996.0,32,16,84,132
16942,Australia,2000.0,60,69,54,183
16943,Australia,2012.0,18,37,59,114
16944,Australia,1988.0,18,6,11,35
16945,Australia,1964.0,8,6,30,44
16946,Australia,1968.0,5,35,11,51
16947,Australia,2008.0,31,42,76,149
16948,Australia,2016.0,23,34,25,82
16949,Australia,2008.0,31,42,76,149
16950,Australia,2012.0,18,37,59,114
16951,Australia,1996.0,32,16,84,132
16952,Australia,1996.0,32,16,84,132
16953,Australia,2012.0,18,37,59,114
16954,Australia,2012.0,18,37,59,114
16955,Australia,1976.0,0,15,8,23
16956,Australia,1988.0,18,6,11,35
16957,Australia,2004.0,49,77,31,157
16958,Australia,2008.0,31,42,76,149
16959,Australia,2012.0,18,37,59,114
16960,Australia,1996.0,32,16,84,132
16961,Australia,2008.0,31,42,76,149
16962,Australia,2012.0,18,37,59,114
16963,Australia,1996.0,32,16,84,132
16964,Australia,2000.0,60,69,54,183
16965,Australia,2004.0,49,77,31,157
16966,Australia,2008.0,31,42,76,149
16967,Australia,2012.0,18,37,59,114
16968,Australia,2012.0,18,37,59,114
16969,Australia,2004.0,49,77,31,157
16970,Australia,1996.0,32,16,84,132
16971,Australia,2000.0,60,69,54,183
16972,Australia,1992.0,14,27,16,57
16973,Australia,1996.0,32,16,84,132
16974,Australia,2000.0,60,69,54,183
16975,Australia,1996.0,32,16,84,132
16976,Australia,2000.0,60,69,54,183
16977,Australia,1920.0,0,6,1,7
16978,Australia,1924.0,4,5,2,11
16979,Australia,2004.0,49,77,31,157
16980,Australia,1998.0,0,0,1,1
16981,Australia,1968.0,5,35,11,51
16982,Australia,2004.0,49,77,31,157
16983,Australia,2004.0,49,77,31,157
16984,Australia,2008.0,31,42,76,149
16985,Australia,2000.0,60,69,54,183
16986,Australia,2004.0,49,77,31,157
16987,Australia,2000.0,60,69,54,183
16988,Australia,2004.0,49,77,31,157
16989,Australia,2012.0,18,37,59,114
16990,Australia,2004.0,49,77,31,157
16991,Australia,1996.0,32,16,84,132
16992,Australia,2004.0,49,77,31,157
16993,Australia,1984.0,7,14,31,52
16994,Australia,1984.0,7,14,31,52
16995,Australia,1984.0,7,14,31,52
16996,Australia,2008.0,31,42,76,149
16997,Australia,2008.0,31,42,76,149
16998,Australia,2012.0,18,37,59,114
16999,Australia,2000.0,60,69,54,183
17000,Australia,1948.0,2,9,5,16
17001,Australia,1948.0,2,9,5,16
17002,Australia,1948.0,2,9,5,16
17003,Australia,1952.0,7,2,11,20
17004,Australia,1952.0,7,2,11,20
17005,Australia,1956.0,28,13,26,67
17006,Australia,1956.0,28,13,26,67
17007,Buraddoo,1956.0,28,13,26,67
17008,Australia,2008.0,31,42,76,149
17009,Australia,2008.0,31,42,76,149
17010,Australia,2008.0,31,42,76,149
17011,Australia,1980.0,6,2,5,13
17012,Australia,2004.0,49,77,31,157
17013,Australia,2008.0,31,42,76,149
17014,Australia,2012.0,18,37,59,114
17015,Australia,2012.0,18,37,59,114
17016,Australia,2004.0,49,77,31,157
17017,Australia,2008.0,31,42,76,149
17018,Australia,2008.0,31,42,76,149
17019,Australia,2012.0,18,37,59,114
17020,Australia,2016.0,23,34,25,82
17021,Australia,2004.0,49,77,31,157
17022,Australia,2016.0,23,34,25,82
17023,Australia,2008.0,31,42,76,149
17024,Australia,2008.0,31,42,76,149
17025,Australia,2012.0,18,37,59,114
17026,Falcon IV,1956.0,28,13,26,67
17027,Australia,2000.0,60,69,54,183
17028,Australia,1960.0,11,24,11,46
17029,Australia,2004.0,49,77,31,157
17030,Australia,2008.0,31,42,76,149
17031,Australia,2000.0,60,69,54,183
17032,Australia,1956.0,28,13,26,67
17033,Australia,1960.0,11,24,11,46
17034,Australia,1960.0,11,24,11,46
17035,Australia,1996.0,32,16,84,132
17036,Australia,2000.0,60,69,54,183
17037,Australia,2000.0,60,69,54,183
17038,Australia,2000.0,60,69,54,183
17039,Australia,2004.0,49,77,31,157
17040,Australia,2004.0,49,77,31,157
17041,Australia,2004.0,49,77,31,157
17042,Australia,2004.0,49,77,31,157
17043,Australia,2004.0,49,77,31,157
17044,Australia,2000.0,60,69,54,183
17045,Australia,1964.0,8,6,30,44
17046,Australia,2000.0,60,69,54,183
17047,Australia,2000.0,60,69,54,183
17048,Australia,2000.0,60,69,54,183
17049,Australia,2000.0,60,69,54,183
17050,Australia,2000.0,60,69,54,183
17051,Australia,2004.0,49,77,31,157
17052,Australia,2004.0,49,77,31,157
17053,Australia,2004.0,49,77,31,157
17054,Australia,2004.0,49,77,31,157
17055,Australia,1984.0,7,14,31,52
17056,Australia,1956.0,28,13,26,67
17057,Australia,1996.0,32,16,84,132
17058,Australia,2000.0,60,69,54,183
17059,Australia,2000.0,60,69,54,183
17060,Australia,2016.0,23,34,25,82
17061,Australia,1952.0,7,2,11,20
17062,Australia,2000.0,60,69,54,183
17063,Australia,2004.0,49,77,31,157
17064,Australia,2008.0,31,42,76,149
17065,Australia,1992.0,14,27,16,57
17066,Australia,1996.0,32,16,84,132
17067,Australia,2000.0,60,69,54,183
17068,Australia,2004.0,49,77,31,157
17069,Australia,2016.0,23,34,25,82
17070,Australia,1980.0,6,2,5,13
17071,Australia,1964.0,8,6,30,44
17072,Australia,2004.0,49,77,31,157
17073,Australia,1988.0,18,6,11,35
17074,Australia,1996.0,32,16,84,132
17075,Australia,2000.0,60,69,54,183
17076,Australia,2004.0,49,77,31,157
17077,Australia,2000.0,60,69,54,183
17078,Australia,2000.0,60,69,54,183
17079,Australia,1996.0,32,16,84,132
17080,Australia,2000.0,60,69,54,183
17081,Australia,2000.0,60,69,54,183
17082,Australia,1988.0,18,6,11,35
17083,Australia,2016.0,23,34,25,82
17084,Australia,2012.0,18,37,59,114
17085,Australia,1964.0,8,6,30,44
17086,Australia,1984.0,7,14,31,52
17087,Australia,2016.0,23,34,25,82
17088,Australia,1996.0,32,16,84,132
17089,Australia,2004.0,49,77,31,157
17090,Australia,2004.0,49,77,31,157
17091,Australia,2000.0,60,69,54,183
17092,Australia,2004.0,49,77,31,157
17093,Australia,2000.0,60,69,54,183
17094,Australia,1988.0,18,6,11,35
17095,Australia,2000.0,60,69,54,183
17096,Australia,2008.0,31,42,76,149
17097,Australia,2008.0,31,42,76,149
17098,Australia,2016.0,23,34,25,82
17099,Australia,1976.0,0,15,8,23
17100,Australia,1992.0,14,27,16,57
17101,Australia,1996.0,32,16,84,132
17102,Australia,2000.0,60,69,54,183
17103,Australia,2004.0,49,77,31,157
17104,Australia,2008.0,31,42,76,149
17105,Australia,1992.0,14,27,16,57
17106,Australia,1996.0,32,16,84,132
17107,Australia,2016.0,23,34,25,82
17108,Australia,1964.0,8,6,30,44
17109,Australia,2000.0,60,69,54,183
17110,Australia,2000.0,60,69,54,183
17111,Australia,1968.0,5,35,11,51
17112,Australia,1992.0,14,27,16,57
17113,Australia,1992.0,14,27,16,57
17114,Australia,2012.0,18,37,59,114
17115,Australia,2012.0,18,37,59,114
17116,Australia,2000.0,60,69,54,183
17117,Australia,1996.0,32,16,84,132
17118,Australia,2000.0,60,69,54,183
17119,Australia,2004.0,49,77,31,157
17120,Australia,2000.0,60,69,54,183
17121,Australia,2004.0,49,77,31,157
17122,Australia,2008.0,31,42,76,149
17123,Australia,2016.0,23,34,25,82
17124,Australia,2000.0,60,69,54,183
17125,Australia,2000.0,60,69,54,183
17126,Australia,2000.0,60,69,54,183
17127,Australia,1968.0,5,35,11,51
17128,Australia,1968.0,5,35,11,51
17129,Australia,1968.0,5,35,11,51
17130,Australia,1968.0,5,35,11,51
17131,Australia,1968.0,5,35,11,51
17132,Australia,2000.0,60,69,54,183
17133,Australia,2008.0,31,42,76,149
17134,Australia,1972.0,11,7,2,20
17135,Australia,1972.0,11,7,2,20
17136,Australia,1996.0,32,16,84,132
17137,Australia,2000.0,60,69,54,183
17138,Australia,2012.0,18,37,59,114
17139,Australia,2004.0,49,77,31,157
17140,Australia,1996.0,32,16,84,132
17141,Australia,2000.0,60,69,54,183
17142,Australia,2004.0,49,77,31,157
17143,Australia,2004.0,49,77,31,157
17144,Australia,2004.0,49,77,31,157
17145,Australia,2016.0,23,34,25,82
17146,Australia,1952.0,7,2,11,20
17147,Australia,2012.0,18,37,59,114
17148,Australia,1984.0,7,14,31,52
17149,Australia,2008.0,31,42,76,149
17150,Australia,2016.0,23,34,25,82
17151,Australia,2016.0,23,34,25,82
17152,Australia,1960.0,11,24,11,46
17153,Australia,1972.0,11,7,2,20
17154,Australia,1964.0,8,6,30,44
17155,Australia,1964.0,8,6,30,44
17156,Australia,1968.0,5,35,11,51
17157,Australia,1968.0,5,35,11,51
17158,Australia,1948.0,2,9,5,16
17159,Australia,1924.0,4,5,2,11
17160,Australia,1960.0,11,24,11,46
17161,Australia,1964.0,8,6,30,44
17162,Australia,1964.0,8,6,30,44
17163,Australia,1964.0,8,6,30,44
17164,Australia,1948.0,2,9,5,16
17165,Australia,1952.0,7,2,11,20
17166,Australia,1956.0,28,13,26,67
17167,Australia,1992.0,14,27,16,57
17168,Australia,1996.0,32,16,84,132
17169,Australia,2000.0,60,69,54,183
17170,Australia,1996.0,32,16,84,132
17171,Australia,2000.0,60,69,54,183
17172,Australia,2000.0,60,69,54,183
17173,Australia,1984.0,7,14,31,52
17174,Australia,1984.0,7,14,31,52
17175,Australia,1988.0,18,6,11,35
17176,Australia,1988.0,18,6,11,35
17177,Australia,1996.0,32,16,84,132
17178,Australia,2000.0,60,69,54,183
17179,Australia,1992.0,14,27,16,57
17180,Australia,2004.0,49,77,31,157
17181,Australia,2016.0,23,34,25,82
17182,Australia,2008.0,31,42,76,149
17183,Australia,2008.0,31,42,76,149
17184,Australia,2004.0,49,77,31,157
17185,Australia,2008.0,31,42,76,149
17186,Australia,1992.0,14,27,16,57
17187,Australia,1996.0,32,16,84,132
17188,Australia,2000.0,60,69,54,183
17189,Australia,2012.0,18,37,59,114
17190,Iran,2016.0,3,1,4,8
17191,Iran,1972.0,0,2,1,3
17192,Iran,2016.0,3,1,4,8
17193,Iran,2012.0,4,5,3,12
17194,Iran,2012.0,4,5,3,12
17195,Iran,1976.0,0,1,1,2
17196,Iran,2000.0,3,0,1,4
17197,Iran,1960.0,0,1,3,4
17198,Iran,2012.0,4,5,3,12
17199,Iran,2016.0,3,1,4,8
17200,Iran,1952.0,0,3,4,7
17201,Iran,2012.0,4,5,3,12
17202,Iran,1956.0,2,2,1,5
17203,Iran,2012.0,4,5,3,12
17204,Iran,1964.0,0,0,2,2
17205,Iran,2004.0,2,2,2,6
17206,Iran,1996.0,1,1,1,3
17207,Iran,1952.0,0,3,4,7
17208,Iran,1968.0,2,1,2,5
17209,Iran,1972.0,0,2,1,3
17210,Iran,2004.0,2,2,2,6
17211,Iran,1992.0,0,1,2,3
17212,Iran,1996.0,1,1,1,3
17213,Iran,1992.0,0,1,2,3
17214,Iran,1996.0,1,1,1,3
17215,Iran,1956.0,2,2,1,5
17216,Iran,2012.0,4,5,3,12
17217,Iran,1952.0,0,3,4,7
17218,Iran,2008.0,1,0,1,2
17219,Iran,1988.0,0,1,0,1
17220,Iran,1992.0,0,1,2,3
17221,Iran,1952.0,0,3,4,7
17222,Iran,1952.0,0,3,4,7
17223,Iran,2016.0,3,1,4,8
17224,Iran,2004.0,2,2,2,6
17225,Iran,1968.0,2,1,2,5
17226,Iran,1952.0,0,3,4,7
17227,Iran,1956.0,2,2,1,5
17228,Iran,1968.0,2,1,2,5
17229,Iran,1972.0,0,2,1,3
17230,Iran,1976.0,0,1,1,2
17231,Iran,2012.0,4,5,3,12
17232,Iran,2012.0,4,5,3,12
17233,Iran,1960.0,0,1,3,4
17234,Iran,2016.0,3,1,4,8
17235,Iran,2000.0,3,0,1,4
17236,Iran,2004.0,2,2,2,6
17237,Iran,2004.0,2,2,2,6
17238,Iran,2012.0,4,5,3,12
17239,Iran,2016.0,3,1,4,8
17240,Iran,2012.0,4,5,3,12
17241,Iran,2016.0,3,1,4,8
17242,Iran,2000.0,3,0,1,4
17243,Iran,2004.0,2,2,2,6
17244,Iran,2008.0,1,0,1,2
17245,Iran,2012.0,4,5,3,12
17246,Iran,1948.0,0,0,1,1
17247,Iran,1964.0,0,0,2,2
17248,Iran,1960.0,0,1,3,4
17249,Iran,1968.0,2,1,2,5
17250,Iran,2012.0,4,5,3,12
17251,Iran,1952.0,0,3,4,7
17252,Iran,1956.0,2,2,1,5
17253,Iran,1960.0,0,1,3,4
17254,Iran,1968.0,2,1,2,5
17255,Iran,2000.0,3,0,1,4
17256,Iran,1956.0,2,2,1,5
17257,Iran,2016.0,3,1,4,8
17258,Canada,1984.0,21,37,33,91
17259,Canada,1952.0,17,3,1,21
17260,Canada,2012.0,1,21,33,55
17261,Canada,2006.0,30,28,11,69
17262,Canada,2006.0,30,28,11,69
17263,Canada,2010.0,67,15,8,90
17264,Canada,2014.0,59,22,5,86
17265,Canada,1936.0,1,25,9,35
17266,Canada,2016.0,4,4,61,69
17267,Canada,1996.0,8,30,12,50
17268,Canada,2000.0,4,4,23,31
17269,Canada,1936.0,1,25,9,35
17270,Mohawk Indians-2,1904.0,27,9,12,48
17271,Canada,1976.0,1,10,15,26
17272,Canada,1936.0,1,25,9,35
17273,Canada-1,1964.0,6,4,2,12
17274,Canada,1960.0,3,26,1,30
17275,Canada,2010.0,67,15,8,90
17276,Canada,1908.0,14,8,30,52
17277,Canada,1908.0,14,8,30,52
17278,Canada,2002.0,52,7,15,74
17279,Canada,2006.0,30,28,11,69
17280,Canada,2010.0,67,15,8,90
17281,Canada,2014.0,59,22,5,86
17282,Canada,1992.0,32,33,15,80
17283,Canada,1908.0,14,8,30,52
17284,Canada,1984.0,21,37,33,91
17285,Canada,2008.0,11,13,11,35
17286,Canada,1956.0,5,11,23,39
17287,Canada,1960.0,3,26,1,30
17288,Canada,1994.0,3,29,5,37
17289,Canada,1960.0,3,26,1,30
17290,Canada,1994.0,3,29,5,37
17291,Canada,1998.0,14,28,7,49
17292,Canada,1994.0,3,29,5,37
17293,Canada,1952.0,17,3,1,21
17294,Canada,1928.0,19,5,21,45
17295,Canada,2004.0,3,10,4,17
17296,Canada,1984.0,21,37,33,91
17297,Toronto Argonauts,1904.0,27,9,12,48
17298,Canada,1996.0,8,30,12,50
17299,Canada,1996.0,8,30,12,50
17300,Canada,2006.0,30,28,11,69
17301,Argonaut Rowing Club,1908.0,14,8,30,52
17302,Toronto Argonauts,1908.0,14,8,30,52
17303,Canada,1928.0,19,5,21,45
17304,Canada,1928.0,19,5,21,45
17305,Canada,1932.0,16,14,29,59
17306,Canada,1992.0,32,33,15,80
17307,Canada,1992.0,32,33,15,80
17308,Canada,1992.0,32,33,15,80
17309,Canada,1924.0,9,19,1,29
17310,Canada,1984.0,21,37,33,91
17311,Canada,1984.0,21,37,33,91
17312,Canada,2010.0,67,15,8,90
17313,Canada,2002.0,52,7,15,74
17314,Canada,1984.0,21,37,33,91
17315,Canada,2010.0,67,15,8,90
17316,Canada,1984.0,21,37,33,91
17317,Canada,1984.0,21,37,33,91
17318,Canada,1984.0,21,37,33,91
17319,Canada,2008.0,11,13,11,35
17320,Canada,1908.0,14,8,30,52
17321,Canada,1908.0,14,8,30,52
17322,Canada,1924.0,9,19,1,29
17323,Canada,2000.0,4,4,23,31
17324,Canada,2002.0,52,7,15,74
17325,Canada,2016.0,4,4,61,69
17326,Canada,1998.0,14,28,7,49
17327,Canada,1998.0,14,28,7,49
17328,Canada,2002.0,52,7,15,74
17329,Canada,2006.0,30,28,11,69
17330,Canada,1992.0,32,33,15,80
17331,Canada,1994.0,3,29,5,37
17332,Canada,1994.0,3,29,5,37
17333,Canada,2016.0,4,4,61,69
17334,Canada,1924.0,9,19,1,29
17335,Canada,1928.0,19,5,21,45
17336,Canada,2012.0,1,21,33,55
17337,Canada,2016.0,4,4,61,69
17338,Canada,2016.0,4,4,61,69
17339,Canada,2016.0,4,4,61,69
17340,Canada,2014.0,59,22,5,86
17341,Canada,1948.0,13,2,7,22
17342,Canada,1960.0,3,26,1,30
17343,Canada,1920.0,10,3,3,16
17344,Canada,2012.0,1,21,33,55
17345,Canada,1984.0,21,37,33,91
17346,Canada,2010.0,67,15,8,90
17347,Canada,2014.0,59,22,5,86
17348,Canada,2010.0,67,15,8,90
17349,Canada,1984.0,21,37,33,91
17350,Canada,1998.0,14,28,7,49
17351,Canada,2016.0,4,4,61,69
17352,Canada,1996.0,8,30,12,50
17353,Canada,2000.0,4,4,23,31
17354,Canada,1960.0,3,26,1,30
17355,Canada,2010.0,67,15,8,90
17356,Canada,2014.0,59,22,5,86
17357,Canada-1,2010.0,67,15,8,90
17358,Canada,1924.0,9,19,1,29
17359,Canada,1924.0,9,19,1,29
17360,Mohawk Indians-2,1904.0,27,9,12,48
17361,Mohawk Indians-2,1904.0,27,9,12,48
17362,Canada,1992.0,32,33,15,80
17363,Canada,1992.0,32,33,15,80
17364,Canada,2002.0,52,7,15,74
17365,Winnipeg Shamrocks-1,1904.0,27,9,12,48
17366,Canada,1956.0,5,11,23,39
17367,Canada,1932.0,16,14,29,59
17368,Canada,2010.0,67,15,8,90
17369,Canada,2000.0,4,4,23,31
17370,Canada,1998.0,14,28,7,49
17371,Canada,2002.0,52,7,15,74
17372,Canada,2006.0,30,28,11,69
17373,Canada,2010.0,67,15,8,90
17374,Canada,1980.0,0,1,1,2
17375,Canada,1984.0,21,37,33,91
17376,Canada,1984.0,21,37,33,91
17377,Canada,1984.0,21,37,33,91
17378,Canada,1994.0,3,29,5,37
17379,Canada,1998.0,14,28,7,49
17380,Caprice,1932.0,16,14,29,59
17381,Canada,1968.0,4,4,22,30
17382,Canada,1928.0,19,5,21,45
17383,Canada,2014.0,59,22,5,86
17384,Canada-1,1956.0,5,11,23,39
17385,Toronto Argonauts,1904.0,27,9,12,48
17386,Canada,1996.0,8,30,12,50
17387,Canada,2010.0,67,15,8,90
17388,Canada,1984.0,21,37,33,91
17389,Canada,2008.0,11,13,11,35
17390,Canada,1994.0,3,29,5,37
17391,Canada-1,1992.0,32,33,15,80
17392,Canada-1,1994.0,3,29,5,37
17393,Canada,1996.0,8,30,12,50
17394,Winnipeg Shamrocks-1,1904.0,27,9,12,48
17395,Canada,1908.0,14,8,30,52
17396,Canada,2002.0,52,7,15,74
17397,Winnipeg Shamrocks-1,1904.0,27,9,12,48
17398,Canada,2002.0,52,7,15,74
17399,Canada,1908.0,14,8,30,52
17400,Canada,1912.0,3,2,3,8
17401,Canada,1998.0,14,28,7,49
17402,Canada,2002.0,52,7,15,74
17403,Canada,1908.0,14,8,30,52
17404,Canada,1968.0,4,4,22,30
17405,Canada,1956.0,5,11,23,39
17406,Canada,2002.0,52,7,15,74
17407,Canada,2010.0,67,15,8,90
17408,Canada,1956.0,5,11,23,39
17409,Canada,1936.0,1,25,9,35
17410,Canada,1992.0,32,33,15,80
17411,Canada,2016.0,4,4,61,69
17412,Canada,2012.0,1,21,33,55
17413,Canada-1,2006.0,30,28,11,69
17414,Canada-1,2010.0,67,15,8,90
17415,Canada,2016.0,4,4,61,69
17416,Canada-2,2010.0,67,15,8,90
17417,Canada,1996.0,8,30,12,50
17418,Canada,2000.0,4,4,23,31
17419,Canada,2004.0,3,10,4,17
17420,Canada,2012.0,1,21,33,55
17421,Canada,2016.0,4,4,61,69
17422,Canada,1964.0,6,4,2,12
17423,Canada,1992.0,32,33,15,80
17424,Canada,2008.0,11,13,11,35
17425,Winnipeg Shamrocks-1,1904.0,27,9,12,48
17426,Canada,1912.0,3,2,3,8
17427,Canada,2006.0,30,28,11,69
17428,Canada,2008.0,11,13,11,35
17429,Canada,2012.0,1,21,33,55
17430,Canada,1920.0,10,3,3,16
17431,Canada,1968.0,4,4,22,30
17432,Canada,1984.0,21,37,33,91
17433,Canada,1984.0,21,37,33,91
17434,Canada,2008.0,11,13,11,35
17435,Canada,1984.0,21,37,33,91
17436,Canada,2016.0,4,4,61,69
17437,Canada,1936.0,1,25,9,35
17438,Canada,1924.0,9,19,1,29
17439,Canada,1988.0,4,7,18,29
17440,Canada,2008.0,11,13,11,35
17441,Canada,1998.0,14,28,7,49
17442,Canada,2002.0,52,7,15,74
17443,Canada,2006.0,30,28,11,69
17444,Canada,1998.0,14,28,7,49
17445,Canada,1908.0,14,8,30,52
17446,Canada,1924.0,9,19,1,29
17447,Canada,2012.0,1,21,33,55
17448,Canada,2014.0,59,22,5,86
17449,Canada,2000.0,4,4,23,31
17450,Canada,1928.0,19,5,21,45
17451,Winnipeg Shamrocks-1,1904.0,27,9,12,48
17452,Canada,1992.0,32,33,15,80
17453,Canada,1996.0,8,30,12,50
17454,Canada,2000.0,4,4,23,31
17455,Canada,2014.0,59,22,5,86
17456,Canada,2014.0,59,22,5,86
17457,Canada,2016.0,4,4,61,69
17458,Canada,1936.0,1,25,9,35
17459,Canada,2012.0,1,21,33,55
17460,Canada,1936.0,1,25,9,35
17461,Canada,1994.0,3,29,5,37
17462,Canada,1998.0,14,28,7,49
17463,Canada,2002.0,52,7,15,74
17464,Canada,1936.0,1,25,9,35
17465,Canada,1936.0,1,25,9,35
17466,Canada,2002.0,52,7,15,74
17467,Canada-1,1996.0,8,30,12,50
17468,Galt Football Club,1904.0,27,9,12,48
17469,Canada,1976.0,1,10,15,26
17470,Canada,1996.0,8,30,12,50
17471,Canada,1976.0,1,10,15,26
17472,Canada,1976.0,1,10,15,26
17473,Canada,1992.0,32,33,15,80
17474,Canada,1992.0,32,33,15,80
17475,Canada,1972.0,0,3,9,12
17476,Winnipeg Shamrocks-1,1904.0,27,9,12,48
17477,Canada,2008.0,11,13,11,35
17478,Canada,2012.0,1,21,33,55
17479,Canada,1932.0,16,14,29,59
17480,Canada,2000.0,4,4,23,31
17481,Canada,2004.0,3,10,4,17
17482,Canada,2008.0,11,13,11,35
17483,Canada,1924.0,9,19,1,29
17484,Canada,1956.0,5,11,23,39
17485,Canada,2008.0,11,13,11,35
17486,Canada,1968.0,4,4,22,30
17487,Canada,1960.0,3,26,1,30
17488,Canada,1928.0,19,5,21,45
17489,Canada,1976.0,1,10,15,26
17490,Canada,1976.0,1,10,15,26
17491,Canada,1968.0,4,4,22,30
17492,Canada,1908.0,14,8,30,52
17493,Canada,1972.0,0,3,9,12
17494,Canada,1968.0,4,4,22,30
17495,Canada,2014.0,59,22,5,86
17496,Winnipeg Shamrocks-1,1904.0,27,9,12,48
17497,Canada,1984.0,21,37,33,91
17498,Canada,1976.0,1,10,15,26
17499,Canada,2006.0,30,28,11,69
17500,Canada,1984.0,21,37,33,91
17501,Canada,1992.0,32,33,15,80
17502,Santa Maria,1932.0,16,14,29,59
17503,Canada,1984.0,21,37,33,91
17504,Canada,1992.0,32,33,15,80
17505,Canada,2010.0,67,15,8,90
17506,Canada,2014.0,59,22,5,86
17507,Canada,1964.0,6,4,2,12
17508,Canada,2012.0,1,21,33,55
17509,Canada,1908.0,14,8,30,52
17510,Canada,1932.0,16,14,29,59
17511,Canada,2012.0,1,21,33,55
17512,Canada,1992.0,32,33,15,80
17513,Canada,2016.0,4,4,61,69
17514,Canada-1,1956.0,5,11,23,39
17515,Canada,1992.0,32,33,15,80
17516,Canada,1992.0,32,33,15,80
17517,Canada,1994.0,3,29,5,37
17518,Canada,1992.0,32,33,15,80
17519,Canada,1992.0,32,33,15,80
17520,Canada,2006.0,30,28,11,69
17521,Canada,2014.0,59,22,5,86
17522,Canada,2010.0,67,15,8,90
17523,Canada,2016.0,4,4,61,69
17524,Canada,1952.0,17,3,1,21
17525,Canada,2000.0,4,4,23,31
17526,Canada,1984.0,21,37,33,91
17527,Canada,1984.0,21,37,33,91
17528,Canada,1984.0,21,37,33,91
17529,Canada,1988.0,4,7,18,29
17530,Canada,1952.0,17,3,1,21
17531,Canada,1932.0,16,14,29,59
17532,Canada,1936.0,1,25,9,35
17533,Canada,1968.0,4,4,22,30
17534,Canada,2016.0,4,4,61,69
17535,Canada,2016.0,4,4,61,69
17536,Canada,2016.0,4,4,61,69
17537,Canada,2012.0,1,21,33,55
17538,Canada,2012.0,1,21,33,55
17539,Canada,1932.0,16,14,29,59
17540,Canada,1936.0,1,25,9,35
17541,Canada,1996.0,8,30,12,50
17542,Canada,1928.0,19,5,21,45
17543,Canada,1992.0,32,33,15,80
17544,Canada,1984.0,21,37,33,91
17545,Canada,1904.0,27,9,12,48
17546,Canada,2004.0,3,10,4,17
17547,Canada,2008.0,11,13,11,35
17548,Canada,1984.0,21,37,33,91
17549,Canada,1956.0,5,11,23,39
17550,Canada,1960.0,3,26,1,30
17551,Canada,1952.0,17,3,1,21
17552,Canada,1998.0,14,28,7,49
17553,Canada,1948.0,13,2,7,22
17554,Canada,1908.0,14,8,30,52
17555,Canada,1968.0,4,4,22,30
17556,Canada,2002.0,52,7,15,74
17557,Canada,1908.0,14,8,30,52
17558,Canada,1936.0,1,25,9,35
17559,Canada,1928.0,19,5,21,45
17560,Canada,2010.0,67,15,8,90
17561,Canada,2014.0,59,22,5,86
17562,Canada,1960.0,3,26,1,30
17563,Canada,1948.0,13,2,7,22
17564,Canada,1988.0,4,7,18,29
17565,Canada,1998.0,14,28,7,49
17566,Canada,2002.0,52,7,15,74
17567,Canada,2014.0,59,22,5,86
17568,Canada,1998.0,14,28,7,49
17569,Canada,2012.0,1,21,33,55
17570,Canada,2016.0,4,4,61,69
17571,Canada,2014.0,59,22,5,86
17572,Galt Football Club,1904.0,27,9,12,48
17573,Canada,1908.0,14,8,30,52
17574,Canada,2014.0,59,22,5,86
17575,Canada,2014.0,59,22,5,86
17576,Canada,1988.0,4,7,18,29
17577,Canada,2014.0,59,22,5,86
17578,Canada,1932.0,16,14,29,59
17579,Canada,1948.0,13,2,7,22
17580,Canada,1998.0,14,28,7,49
17581,Canada,2002.0,52,7,15,74
17582,Canada,1908.0,14,8,30,52
17583,Canada,1932.0,16,14,29,59
17584,Canada,1928.0,19,5,21,45
17585,Canada,1932.0,16,14,29,59
17586,Canada,1932.0,16,14,29,59
17587,Canada,1932.0,16,14,29,59
17588,Canada,1936.0,1,25,9,35
17589,Canada-1,1992.0,32,33,15,80
17590,Canada-1,1994.0,3,29,5,37
17591,Canada,1972.0,0,3,9,12
17592,Canada,1956.0,5,11,23,39
17593,Canada,1968.0,4,4,22,30
17594,Canada,2006.0,30,28,11,69
17595,Canada-1,1964.0,6,4,2,12
17596,Canada-1,1964.0,6,4,2,12
17597,Canada,2010.0,67,15,8,90
17598,Canada,1996.0,8,30,12,50
17599,Canada,1960.0,3,26,1,30
17600,Canada,1976.0,1,10,15,26
17601,Canada,1984.0,21,37,33,91
17602,Canada,1984.0,21,37,33,91
17603,Canada,1908.0,14,8,30,52
17604,Canada,1908.0,14,8,30,52
17605,Canada,2016.0,4,4,61,69
17606,Canada,1936.0,1,25,9,35
17607,Canada,1936.0,1,25,9,35
17608,Canada,2006.0,30,28,11,69
17609,Canada,1928.0,19,5,21,45
17610,Canada,2012.0,1,21,33,55
17611,Canada,2012.0,1,21,33,55
17612,Canada,2016.0,4,4,61,69
17613,Canada,1924.0,9,19,1,29
17614,Canada,1972.0,0,3,9,12
17615,Canada,1928.0,19,5,21,45
17616,Canada,1984.0,21,37,33,91
17617,Canada,1984.0,21,37,33,91
17618,Canada,1932.0,16,14,29,59
17619,Mohawk Indians-2,1904.0,27,9,12,48
17620,Canada,2016.0,4,4,61,69
17621,Canada,1908.0,14,8,30,52
17622,Winnipeg Shamrocks-1,1904.0,27,9,12,48
17623,Canada,2002.0,52,7,15,74
17624,Canada,1984.0,21,37,33,91
17625,Canada,1996.0,8,30,12,50
17626,Canada,2002.0,52,7,15,74
17627,Canada,1998.0,14,28,7,49
17628,Canada,1984.0,21,37,33,91
17629,Canada,1992.0,32,33,15,80
17630,Canada,1960.0,3,26,1,30
17631,Canada,2014.0,59,22,5,86
17632,Canada,1948.0,13,2,7,22
17633,Canada,2008.0,11,13,11,35
17634,Galt Football Club,1904.0,27,9,12,48
17635,Canada,1992.0,32,33,15,80
17636,Canada,1996.0,8,30,12,50
17637,Canada,1920.0,10,3,3,16
17638,Canada,1920.0,10,3,3,16
17639,Canada,1932.0,16,14,29,59
17640,Canada,1932.0,16,14,29,59
17641,Canada,2014.0,59,22,5,86
17642,Canada,1984.0,21,37,33,91
17643,Canada,2002.0,52,7,15,74
17644,Canada,1994.0,3,29,5,37
17645,Canada,1998.0,14,28,7,49
17646,Canada,2002.0,52,7,15,74
17647,Canada,2002.0,52,7,15,74
17648,Canada,2002.0,52,7,15,74
17649,Canada,1992.0,32,33,15,80
17650,Argonaut Rowing Club,1908.0,14,8,30,52
17651,Toronto Argonauts,1908.0,14,8,30,52
17652,Canada,1976.0,1,10,15,26
17653,Canada,1976.0,1,10,15,26
17654,Canada,1932.0,16,14,29,59
17655,Canada,2000.0,4,4,23,31
17656,Canada,1984.0,21,37,33,91
17657,Canada,1952.0,17,3,1,21
17658,Canada,1968.0,4,4,22,30
17659,Canada,2012.0,1,21,33,55
17660,Canada,1952.0,17,3,1,21
17661,Canada,1992.0,32,33,15,80
17662,Canada,2010.0,67,15,8,90
17663,Canada,2014.0,59,22,5,86
17664,Canada,1952.0,17,3,1,21
17665,Canada,1976.0,1,10,15,26
17666,Canada,2006.0,30,28,11,69
17667,Canada,2012.0,1,21,33,55
17668,Canada,1996.0,8,30,12,50
17669,Canada,1992.0,32,33,15,80
17670,Canada,2000.0,4,4,23,31
17671,Canada,1992.0,32,33,15,80
17672,Canada,2000.0,4,4,23,31
17673,Canada,1912.0,3,2,3,8
17674,Canada,2012.0,1,21,33,55
17675,Canada,2010.0,67,15,8,90
17676,Canada,2012.0,1,21,33,55
17677,Canada,2016.0,4,4,61,69
17678,Caprice,1932.0,16,14,29,59
17679,Canada,1968.0,4,4,22,30
17680,Canada,1928.0,19,5,21,45
17681,Canada,1920.0,10,3,3,16
17682,Santa Maria,1932.0,16,14,29,59
17683,Canada,1908.0,14,8,30,52
17684,Canada,2016.0,4,4,61,69
17685,Canada,1984.0,21,37,33,91
17686,Canada,1988.0,4,7,18,29
17687,Canada,1912.0,3,2,3,8
17688,Canada,2002.0,52,7,15,74
17689,Galt Football Club,1904.0,27,9,12,48
17690,Canada,1998.0,14,28,7,49
17691,Canada,2002.0,52,7,15,74
17692,Canada,2006.0,30,28,11,69
17693,Canada,1920.0,10,3,3,16
17694,Canada,1952.0,17,3,1,21
17695,Canada,1948.0,13,2,7,22
17696,Canada,1968.0,4,4,22,30
17697,Canada,1968.0,4,4,22,30
17698,Canada,2010.0,67,15,8,90
17699,Canada,2006.0,30,28,11,69
17700,Canada,2006.0,30,28,11,69
17701,Canada,2010.0,67,15,8,90
17702,Canada,2010.0,67,15,8,90
17703,Canada,1984.0,21,37,33,91
17704,Canada,1998.0,14,28,7,49
17705,Canada,1928.0,19,5,21,45
17706,Canada,2002.0,52,7,15,74
17707,Canada,2002.0,52,7,15,74
17708,Canada,2006.0,30,28,11,69
17709,Canada,2012.0,1,21,33,55
17710,Canada,1972.0,0,3,9,12
17711,Canada,2006.0,30,28,11,69
17712,Canada,1948.0,13,2,7,22
17713,Canada,1932.0,16,14,29,59
17714,Santa Maria,1932.0,16,14,29,59
17715,Canada,1936.0,1,25,9,35
17716,Canada,1948.0,13,2,7,22
17717,Canada,1920.0,10,3,3,16
17718,Mohawk Indians-2,1904.0,27,9,12,48
17719,Galt Football Club,1904.0,27,9,12,48
17720,Canada,2008.0,11,13,11,35
17721,Canada,1912.0,3,2,3,8
17722,Canada,1984.0,21,37,33,91
17723,Canada,2006.0,30,28,11,69
17724,Canada,2010.0,67,15,8,90
17725,Canada,2010.0,67,15,8,90
17726,Canada,2014.0,59,22,5,86
17727,Canada,2010.0,67,15,8,90
17728,Canada,2014.0,59,22,5,86
17729,Canada,1984.0,21,37,33,91
17730,Canada,1908.0,14,8,30,52
17731,Canada,2008.0,11,13,11,35
17732,Canada,1928.0,19,5,21,45
17733,Canada,1992.0,32,33,15,80
17734,Canada,1952.0,17,3,1,21
17735,Canada,2012.0,1,21,33,55
17736,Canada,1968.0,4,4,22,30
17737,Canada,1994.0,3,29,5,37
17738,Canada,2014.0,59,22,5,86
17739,Canada,2014.0,59,22,5,86
17740,Canada,1984.0,21,37,33,91
17741,Canada,1992.0,32,33,15,80
17742,Canada,1996.0,8,30,12,50
17743,Canada,1932.0,16,14,29,59
17744,Canada,1998.0,14,28,7,49
17745,Canada,1998.0,14,28,7,49
17746,Canada,2004.0,3,10,4,17
17747,Canada,1996.0,8,30,12,50
17748,Canada,1952.0,17,3,1,21
17749,Canada,2012.0,1,21,33,55
17750,Canada,2016.0,4,4,61,69
17751,Canada,1960.0,3,26,1,30
17752,Canada,1998.0,14,28,7,49
17753,Canada,2002.0,52,7,15,74
17754,Canada,2010.0,67,15,8,90
17755,Canada,2010.0,67,15,8,90
17756,Canada,1992.0,32,33,15,80
17757,Canada,1992.0,32,33,15,80
17758,Canada,1996.0,8,30,12,50
17759,Canada,1996.0,8,30,12,50
17760,Canada,1928.0,19,5,21,45
17761,Canada-1,1996.0,8,30,12,50
17762,Canada,1998.0,14,28,7,49
17763,Canada,2002.0,52,7,15,74
17764,Canada,2006.0,30,28,11,69
17765,Canada,2010.0,67,15,8,90
17766,Canada,2014.0,59,22,5,86
17767,Canada,1960.0,3,26,1,30
17768,Canada,2006.0,30,28,11,69
17769,Canada,2010.0,67,15,8,90
17770,Canada,1956.0,5,11,23,39
17771,Galt Football Club,1904.0,27,9,12,48
17772,Canada,1932.0,16,14,29,59
17773,Canada,1984.0,21,37,33,91
17774,Canada,2008.0,11,13,11,35
17775,Canada,1956.0,5,11,23,39
17776,Canada,2004.0,3,10,4,17
17777,Canada,1920.0,10,3,3,16
17778,Canada,2014.0,59,22,5,86
17779,Canada,2000.0,4,4,23,31
17780,Canada,2004.0,3,10,4,17
17781,Canada,2008.0,11,13,11,35
17782,Canada,2012.0,1,21,33,55
17783,Canada,1948.0,13,2,7,22
17784,Canada,1988.0,4,7,18,29
17785,Canada,1984.0,21,37,33,91
17786,Canada,1994.0,3,29,5,37
17787,Canada,1994.0,3,29,5,37
17788,Canada,1912.0,3,2,3,8
17789,Canada,1912.0,3,2,3,8
17790,Canada,2006.0,30,28,11,69
17791,Canada,1984.0,21,37,33,91
17792,Canada,1984.0,21,37,33,91
17793,Canada,1908.0,14,8,30,52
17794,Canada,1984.0,21,37,33,91
17795,Canada,1956.0,5,11,23,39
17796,Canada,1996.0,8,30,12,50
17797,Canada,2008.0,11,13,11,35
17798,Canada,2012.0,1,21,33,55
17799,Canada,2006.0,30,28,11,69
17800,Canada,2014.0,59,22,5,86
17801,Canada,1968.0,4,4,22,30
17802,Canada,2014.0,59,22,5,86
17803,Canada,1928.0,19,5,21,45
17804,Canada,1996.0,8,30,12,50
17805,Canada,1996.0,8,30,12,50
17806,Canada,2002.0,52,7,15,74
17807,Canada,2006.0,30,28,11,69
17808,Canada,2006.0,30,28,11,69
17809,Canada,2010.0,67,15,8,90
17810,Canada,1984.0,21,37,33,91
17811,Canada-1,2010.0,67,15,8,90
17812,Canada-1,2014.0,59,22,5,86
17813,Canada,1964.0,6,4,2,12
17814,Canada,1924.0,9,19,1,29
17815,Canada,1932.0,16,14,29,59
17816,Canada,1932.0,16,14,29,59
17817,Canada,1960.0,3,26,1,30
17818,Canada,1956.0,5,11,23,39
17819,Canada,1968.0,4,4,22,30
17820,Canada,2008.0,11,13,11,35
17821,Canada,2012.0,1,21,33,55
17822,Canada,1992.0,32,33,15,80
17823,Canada,2000.0,4,4,23,31
17824,Canada,2002.0,52,7,15,74
17825,Canada,2010.0,67,15,8,90
17826,Canada,2010.0,67,15,8,90
17827,Canada,2014.0,59,22,5,86
17828,Argonaut Rowing Club,1908.0,14,8,30,52
17829,Canada,1960.0,3,26,1,30
17830,Canada,1964.0,6,4,2,12
17831,Canada,2014.0,59,22,5,86
17832,Winnipeg Shamrocks-1,1904.0,27,9,12,48
17833,Canada,1976.0,1,10,15,26
17834,Canada,1976.0,1,10,15,26
17835,Canada,2010.0,67,15,8,90
17836,Canada,2006.0,30,28,11,69
17837,Canada,2014.0,59,22,5,86
17838,Canada,2016.0,4,4,61,69
17839,Canada,1964.0,6,4,2,12
17840,Canada,1992.0,32,33,15,80
17841,Canada,1920.0,10,3,3,16
17842,Canada,1984.0,21,37,33,91
17843,Canada,1984.0,21,37,33,91
17844,Canada,1992.0,32,33,15,80
17845,Canada,1994.0,3,29,5,37
17846,Galt Football Club,1904.0,27,9,12,48
17847,Canada,1968.0,4,4,22,30
17848,Canada,2010.0,67,15,8,90
17849,Canada,2014.0,59,22,5,86
17850,Santa Maria,1932.0,16,14,29,59
17851,Canada,2014.0,59,22,5,86
17852,Canada,1948.0,13,2,7,22
17853,Canada,2002.0,52,7,15,74
17854,Canada,1992.0,32,33,15,80
17855,Canada,1994.0,3,29,5,37
17856,Canada,2002.0,52,7,15,74
17857,Canada,1976.0,1,10,15,26
17858,Canada,1992.0,32,33,15,80
17859,Canada,1994.0,3,29,5,37
17860,Canada,2002.0,52,7,15,74
17861,Canada,1998.0,14,28,7,49
17862,Canada,1972.0,0,3,9,12
17863,Canada,2010.0,67,15,8,90
17864,Canada,2014.0,59,22,5,86
17865,Canada,1998.0,14,28,7,49
17866,Canada,2002.0,52,7,15,74
17867,Canada,2006.0,30,28,11,69
17868,Canada,2010.0,67,15,8,90
17869,Canada,1972.0,0,3,9,12
17870,Canada,2010.0,67,15,8,90
17871,Canada,1908.0,14,8,30,52
17872,Canada,1908.0,14,8,30,52
17873,Canada,1908.0,14,8,30,52
17874,Canada,1988.0,4,7,18,29
17875,Canada,1984.0,21,37,33,91
17876,Toronto Argonauts,1908.0,14,8,30,52
17877,Canada,2006.0,30,28,11,69
17878,Canada,1992.0,32,33,15,80
17879,Canada,1984.0,21,37,33,91
17880,Canada,2006.0,30,28,11,69
17881,Canada,2010.0,67,15,8,90
17882,Canada,2014.0,59,22,5,86
17883,Canada-1,1964.0,6,4,2,12
17884,Canada,2016.0,4,4,61,69
17885,Canada,1936.0,1,25,9,35
17886,Canada,2002.0,52,7,15,74
17887,Canada,2006.0,30,28,11,69
17888,Canada,2006.0,30,28,11,69
17889,Canada,2006.0,30,28,11,69
17890,Canada,2006.0,30,28,11,69
17891,Canada,2006.0,30,28,11,69
17892,Canada,2006.0,30,28,11,69
17893,Canada,1956.0,5,11,23,39
17894,Canada,1956.0,5,11,23,39
17895,Canada,2008.0,11,13,11,35
17896,Canada,1994.0,3,29,5,37
17897,Canada,2006.0,30,28,11,69
17898,Canada,1996.0,8,30,12,50
17899,Canada,2000.0,4,4,23,31
17900,Canada,2002.0,52,7,15,74
17901,Canada,2006.0,30,28,11,69
17902,Canada,2008.0,11,13,11,35
17903,Canada,1976.0,1,10,15,26
17904,Canada,1984.0,21,37,33,91
17905,Canada,1956.0,5,11,23,39
17906,Canada,1960.0,3,26,1,30
17907,Canada,2014.0,59,22,5,86
17908,Canada,2012.0,1,21,33,55
17909,Canada,2016.0,4,4,61,69
17910,Canada,2006.0,30,28,11,69
17911,Canada,2010.0,67,15,8,90
17912,Canada,2014.0,59,22,5,86
17913,Canada,1992.0,32,33,15,80
17914,Winnipeg Shamrocks-1,1904.0,27,9,12,48
17915,Canada,2014.0,59,22,5,86
17916,Canada,2008.0,11,13,11,35
17917,Canada,2008.0,11,13,11,35
17918,Canada,2016.0,4,4,61,69
17919,Canada,1992.0,32,33,15,80
17920,Canada,1994.0,3,29,5,37
17921,Canada,1994.0,3,29,5,37
17922,Canada,2016.0,4,4,61,69
17923,Galt Football Club,1904.0,27,9,12,48
17924,Canada,1952.0,17,3,1,21
17925,Canada,1948.0,13,2,7,22
17926,Canada,1924.0,9,19,1,29
17927,Canada,1994.0,3,29,5,37
17928,Canada,1948.0,13,2,7,22
17929,Canada,2000.0,4,4,23,31
17930,Canada,1994.0,3,29,5,37
17931,Canada,2014.0,59,22,5,86
17932,Canada,1996.0,8,30,12,50
17933,Canada,1956.0,5,11,23,39
17934,Canada,1960.0,3,26,1,30
17935,Canada,1984.0,21,37,33,91
17936,Canada,1984.0,21,37,33,91
17937,Canada,1992.0,32,33,15,80
17938,Canada,1996.0,8,30,12,50
17939,Canada,2002.0,52,7,15,74
17940,Canada,2014.0,59,22,5,86
17941,Canada,2016.0,4,4,61,69
17942,Canada,1996.0,8,30,12,50
17943,Canada,2016.0,4,4,61,69
17944,Canada,1968.0,4,4,22,30
17945,Canada-1,2010.0,67,15,8,90
17946,Canada,1998.0,14,28,7,49
17947,Canada,1998.0,14,28,7,49
17948,Canada,2002.0,52,7,15,74
17949,Canada,1992.0,32,33,15,80
17950,Canada,1992.0,32,33,15,80
17951,Canada,2012.0,1,21,33,55
17952,Canada,2006.0,30,28,11,69
17953,Canada,2006.0,30,28,11,69
17954,Canada,1960.0,3,26,1,30
17955,Canada,1948.0,13,2,7,22
17956,Canada,1992.0,32,33,15,80
17957,Canada,1956.0,5,11,23,39
17958,Canada,1992.0,32,33,15,80
17959,Canada,2002.0,52,7,15,74
17960,Canada,1928.0,19,5,21,45
17961,Canada,2000.0,4,4,23,31
17962,Canada,1924.0,9,19,1,29
17963,Canada,1988.0,4,7,18,29
17964,Canada,2008.0,11,13,11,35
17965,Canada,1932.0,16,14,29,59
17966,Toronto Argonauts,1908.0,14,8,30,52
17967,Canada,1932.0,16,14,29,59
17968,Canada,2008.0,11,13,11,35
17969,Mohawk Indians-2,1904.0,27,9,12,48
17970,Canada,1996.0,8,30,12,50
17971,Canada,1992.0,32,33,15,80
17972,Canada,1906.0,1,1,0,2
17973,Canada,1932.0,16,14,29,59
17974,Canada,1992.0,32,33,15,80
17975,Canada,2002.0,52,7,15,74
17976,Galt Football Club,1904.0,27,9,12,48
17977,Canada,1924.0,9,19,1,29
17978,Canada,1936.0,1,25,9,35
17979,Canada,1956.0,5,11,23,39
17980,Canada,1932.0,16,14,29,59
17981,Canada,1932.0,16,14,29,59
17982,Canada,1956.0,5,11,23,39
17983,Canada,2008.0,11,13,11,35
17984,Toronto Argonauts,1904.0,27,9,12,48
17985,Canada,1994.0,3,29,5,37
17986,Canada-1,1998.0,14,28,7,49
17987,Canada-1,2006.0,30,28,11,69
17988,Canada,2016.0,4,4,61,69
17989,Canada,1996.0,8,30,12,50
17990,Canada,2000.0,4,4,23,31
17991,Canada,1912.0,3,2,3,8
17992,Canada,2010.0,67,15,8,90
17993,Canada,2014.0,59,22,5,86
17994,Winnipeg Shamrocks-1,1904.0,27,9,12,48
17995,Canada,1904.0,27,9,12,48
17996,Canada,1908.0,14,8,30,52
17997,Canada,1976.0,1,10,15,26
17998,Canada,1956.0,5,11,23,39
17999,Canada,1932.0,16,14,29,59
18000,Canada,1992.0,32,33,15,80
18001,Canada,2004.0,3,10,4,17
18002,Canada-1,1998.0,14,28,7,49
18003,Canada,2002.0,52,7,15,74
18004,Canada,1924.0,9,19,1,29
18005,Canada,1948.0,13,2,7,22
18006,Canada,1968.0,4,4,22,30
18007,Toronto Argonauts,1904.0,27,9,12,48
18008,Canada,1908.0,14,8,30,52
18009,Canada,1956.0,5,11,23,39
18010,Canada,1960.0,3,26,1,30
18011,Canada,2016.0,4,4,61,69
18012,Canada,2012.0,1,21,33,55
18013,Canada,2016.0,4,4,61,69
18014,Canada,2006.0,30,28,11,69
18015,Canada,2010.0,67,15,8,90
18016,Canada,1968.0,4,4,22,30
18017,Canada,1984.0,21,37,33,91
18018,Canada,1972.0,0,3,9,12
18019,Canada,1972.0,0,3,9,12
18020,Canada,1984.0,21,37,33,91
18021,Canada,2016.0,4,4,61,69
18022,Santa Maria,1932.0,16,14,29,59
18023,Canada,2010.0,67,15,8,90
18024,Canada,1932.0,16,14,29,59
18025,Canada,2006.0,30,28,11,69
18026,Canada,2014.0,59,22,5,86
18027,Canada,2014.0,59,22,5,86
18028,Mohawk Indians-2,1904.0,27,9,12,48
18029,Canada,1992.0,32,33,15,80
18030,Canada,1988.0,4,7,18,29
18031,Canada,1948.0,13,2,7,22
18032,Canada,1988.0,4,7,18,29
18033,Canada,1992.0,32,33,15,80
18034,Canada,2010.0,67,15,8,90
18035,Canada,2014.0,59,22,5,86
18036,Canada,2012.0,1,21,33,55
18037,Canada,1956.0,5,11,23,39
18038,Canada,1960.0,3,26,1,30
18039,Canada,2002.0,52,7,15,74
18040,Canada,2010.0,67,15,8,90
18041,Canada,2016.0,4,4,61,69
18042,Canada,2012.0,1,21,33,55
18043,Canada,2012.0,1,21,33,55
18044,Canada,2016.0,4,4,61,69
18045,Canada,1996.0,8,30,12,50
18046,Canada,1994.0,3,29,5,37
18047,Canada,1992.0,32,33,15,80
18048,Canada,1992.0,32,33,15,80
18049,Canada,1996.0,8,30,12,50
18050,Canada,1996.0,8,30,12,50
18051,Canada,2012.0,1,21,33,55
18052,Canada,1924.0,9,19,1,29
18053,Canada-1,1988.0,4,7,18,29
18054,Canada,1908.0,14,8,30,52
18055,Canada,1956.0,5,11,23,39
18056,Canada,1998.0,14,28,7,49
18057,Canada,1998.0,14,28,7,49
18058,Canada,1996.0,8,30,12,50
18059,Canada,2000.0,4,4,23,31
18060,Canada,1932.0,16,14,29,59
18061,Canada,1956.0,5,11,23,39
18062,Galt Football Club,1904.0,27,9,12,48
18063,Canada,2014.0,59,22,5,86
18064,Canada,1908.0,14,8,30,52
18065,Canada,2010.0,67,15,8,90
18066,Canada,1956.0,5,11,23,39
18067,Canada,1932.0,16,14,29,59
18068,Canada,1956.0,5,11,23,39
18069,Canada,1960.0,3,26,1,30
18070,Canada,1960.0,3,26,1,30
18071,Canada,1992.0,32,33,15,80
18072,Canada,1988.0,4,7,18,29
18073,Canada,1984.0,21,37,33,91
18074,Canada,2012.0,1,21,33,55
18075,Canada,1908.0,14,8,30,52
18076,Canada,1984.0,21,37,33,91
18077,Canada,2014.0,59,22,5,86
18078,Canada,1924.0,9,19,1,29
18079,Canada,1932.0,16,14,29,59
18080,Canada,1936.0,1,25,9,35
18081,Canada,1928.0,19,5,21,45
18082,Canada,1988.0,4,7,18,29
18083,Canada,1936.0,1,25,9,35
18084,Canada,1960.0,3,26,1,30
18085,Canada,1952.0,17,3,1,21
18086,Canada,2010.0,67,15,8,90
18087,Canada,2014.0,59,22,5,86
18088,Canada,2008.0,11,13,11,35
18089,Canada,1988.0,4,7,18,29
18090,Canada,1972.0,0,3,9,12
18091,Canada,1952.0,17,3,1,21
18092,Canada,1984.0,21,37,33,91
18093,Canada,1936.0,1,25,9,35
18094,Canada,1998.0,14,28,7,49
18095,Canada-1,2010.0,67,15,8,90
18096,Canada-1,2014.0,59,22,5,86
18097,Canada,2014.0,59,22,5,86
18098,Canada,2016.0,4,4,61,69
18099,Canada,1984.0,21,37,33,91
18100,Canada,1984.0,21,37,33,91
18101,Canada,1992.0,32,33,15,80
18102,Canada,1992.0,32,33,15,80
18103,Canada,1996.0,8,30,12,50
18104,Canada,1932.0,16,14,29,59
18105,Canada,1968.0,4,4,22,30
18106,Canada,1924.0,9,19,1,29
18107,Canada,2010.0,67,15,8,90
18108,Canada,2000.0,4,4,23,31
18109,Canada,2000.0,4,4,23,31
18110,Canada,1936.0,1,25,9,35
18111,Canada,1932.0,16,14,29,59
18112,Canada,2010.0,67,15,8,90
18113,Canada,2014.0,59,22,5,86
18114,Canada,2012.0,1,21,33,55
18115,Canada,1984.0,21,37,33,91
18116,Canada,1984.0,21,37,33,91
18117,Canada,2010.0,67,15,8,90
18118,Canada,2006.0,30,28,11,69
18119,Canada,2010.0,67,15,8,90
18120,Canada,2014.0,59,22,5,86
18121,Canada,2014.0,59,22,5,86
18122,Canada,2010.0,67,15,8,90
18123,Canada,1948.0,13,2,7,22
18124,Canada,1908.0,14,8,30,52
18125,Canada,2012.0,1,21,33,55
18126,Canada,2014.0,59,22,5,86
18127,Canada,1968.0,4,4,22,30
18128,Canada-1,2010.0,67,15,8,90
18129,Canada-1,2014.0,59,22,5,86
18130,Canada,1928.0,19,5,21,45
18131,Canada,2004.0,3,10,4,17
18132,Canada,1924.0,9,19,1,29
18133,Canada,1928.0,19,5,21,45
18134,Canada,1936.0,1,25,9,35
18135,Canada,1996.0,8,30,12,50
18136,Canada,1996.0,8,30,12,50
18137,Canada,2000.0,4,4,23,31
18138,Canada,1948.0,13,2,7,22
18139,Canada,1936.0,1,25,9,35
18140,Canada,2010.0,67,15,8,90
18141,Canada,2014.0,59,22,5,86
18142,Canada,2012.0,1,21,33,55
18143,Canada,1988.0,4,7,18,29
18144,Canada,1994.0,3,29,5,37
18145,Canada,1984.0,21,37,33,91
18146,Canada,2002.0,52,7,15,74
18147,Canada,2006.0,30,28,11,69
18148,Canada,2010.0,67,15,8,90
18149,Canada,2000.0,4,4,23,31
18150,Canada,1984.0,21,37,33,91
18151,Canada,1936.0,1,25,9,35
18152,Canada,1920.0,10,3,3,16
18153,Canada,1924.0,9,19,1,29
18154,Canada,2006.0,30,28,11,69
18155,Canada,1988.0,4,7,18,29
18156,Canada,2002.0,52,7,15,74
18157,Canada,2010.0,67,15,8,90
18158,Canada,2002.0,52,7,15,74
18159,Mohawk Indians-2,1904.0,27,9,12,48
18160,Canada,2006.0,30,28,11,69
18161,Canada,1988.0,4,7,18,29
18162,Canada,2002.0,52,7,15,74
18163,Canada,2002.0,52,7,15,74
18164,Canada,2000.0,4,4,23,31
18165,Canada,1994.0,3,29,5,37
18166,Canada,1928.0,19,5,21,45
18167,Canada,1988.0,4,7,18,29
18168,Canada,1998.0,14,28,7,49
18169,Canada,2016.0,4,4,61,69
18170,Canada,2010.0,67,15,8,90
18171,Canada,2014.0,59,22,5,86
18172,Canada,1996.0,8,30,12,50
18173,Canada,1956.0,5,11,23,39
18174,Canada,2012.0,1,21,33,55
18175,Canada,2016.0,4,4,61,69
18176,Canada,2016.0,4,4,61,69
18177,Canada,2016.0,4,4,61,69
18178,Canada,2016.0,4,4,61,69
18179,Canada,1984.0,21,37,33,91
18180,Canada,1968.0,4,4,22,30
18181,Canada,1984.0,21,37,33,91
18182,Canada,1988.0,4,7,18,29
18183,Canada,1900.0,1,0,1,2
18184,Canada,1900.0,1,0,1,2
18185,Canada,1968.0,4,4,22,30
18186,Canada,1984.0,21,37,33,91
18187,Canada,2014.0,59,22,5,86
18188,Canada,1984.0,21,37,33,91
18189,Canada,1984.0,21,37,33,91
18190,Canada,1984.0,21,37,33,91
18191,Canada,2002.0,52,7,15,74
18192,Canada,2006.0,30,28,11,69
18193,Canada,2010.0,67,15,8,90
18194,Canada,2014.0,59,22,5,86
18195,Canada,1956.0,5,11,23,39
18196,Canada,2016.0,4,4,61,69
18197,Canada,2006.0,30,28,11,69
18198,Canada,1998.0,14,28,7,49
18199,Canada,2006.0,30,28,11,69
18200,Canada,1932.0,16,14,29,59
18201,Canada,2016.0,4,4,61,69
18202,Canada,2006.0,30,28,11,69
18203,Canada,2012.0,1,21,33,55
18204,Canada,1994.0,3,29,5,37
18205,Canada,2008.0,11,13,11,35
18206,Canada,1952.0,17,3,1,21
18207,Canada-1,1960.0,3,26,1,30
18208,Canada,1992.0,32,33,15,80
18209,Canada,1984.0,21,37,33,91
18210,Canada,1984.0,21,37,33,91
18211,Canada,1996.0,8,30,12,50
18212,Canada,2002.0,52,7,15,74
18213,Canada,1936.0,1,25,9,35
18214,Canada,1996.0,8,30,12,50
18215,Canada-1,2002.0,52,7,15,74
18216,Canada,2016.0,4,4,61,69
18217,Canada,1960.0,3,26,1,30
18218,Winnipeg Shamrocks-1,1904.0,27,9,12,48
18219,Canada,1988.0,4,7,18,29
18220,Canada,1988.0,4,7,18,29
18221,Canada,1992.0,32,33,15,80
18222,Canada,1998.0,14,28,7,49
18223,Canada,1998.0,14,28,7,49
18224,Canada,2010.0,67,15,8,90
18225,Canada,2014.0,59,22,5,86
18226,Canada,1976.0,1,10,15,26
18227,Canada,2014.0,59,22,5,86
18228,Canada,1968.0,4,4,22,30
18229,Canada,1968.0,4,4,22,30
18230,Canada,2002.0,52,7,15,74
18231,Canada,2006.0,30,28,11,69
18232,Canada,2010.0,67,15,8,90
18233,Canada,1992.0,32,33,15,80
18234,Canada,1928.0,19,5,21,45
18235,Canada,1928.0,19,5,21,45
18236,Canada,1928.0,19,5,21,45
18237,Canada,1980.0,0,1,1,2
18238,Canada,1994.0,3,29,5,37
18239,Canada,1952.0,17,3,1,21
18240,Canada,1984.0,21,37,33,91
18241,Canada,1988.0,4,7,18,29
18242,Canada,1992.0,32,33,15,80
18243,Canada,1992.0,32,33,15,80
18244,Canada,1996.0,8,30,12,50
18245,Canada,1928.0,19,5,21,45
18246,Canada,2010.0,67,15,8,90
18247,Canada,2014.0,59,22,5,86
18248,Canada,2002.0,52,7,15,74
18249,Canada,2006.0,30,28,11,69
18250,Canada,1988.0,4,7,18,29
18251,Canada,1932.0,16,14,29,59
18252,Canada,2004.0,3,10,4,17
18253,Canada,1956.0,5,11,23,39
18254,Canada,2008.0,11,13,11,35
18255,Canada,2012.0,1,21,33,55
18256,Canada,2014.0,59,22,5,86
18257,Canada,1976.0,1,10,15,26
18258,Canada,2016.0,4,4,61,69
18259,Canada,2002.0,52,7,15,74
18260,Canada,2010.0,67,15,8,90
18261,Canada,1920.0,10,3,3,16
18262,Canada,1952.0,17,3,1,21
18263,Canada,2016.0,4,4,61,69
18264,Canada,2014.0,59,22,5,86
18265,Canada,1984.0,21,37,33,91
18266,Mohawk Indians-2,1904.0,27,9,12,48
18267,Canada,1924.0,9,19,1,29
18268,Canada,1992.0,32,33,15,80
18269,Canada,1992.0,32,33,15,80
18270,Canada,1996.0,8,30,12,50
18271,Canada,1998.0,14,28,7,49
18272,Mohawk Indians-2,1904.0,27,9,12,48
18273,Canada,1998.0,14,28,7,49
18274,Toronto Argonauts,1904.0,27,9,12,48
18275,Canada,2006.0,30,28,11,69
18276,Canada,1948.0,13,2,7,22
18277,Canada,2006.0,30,28,11,69
18278,Canada,1908.0,14,8,30,52
18279,Canada-1,1964.0,6,4,2,12
18280,Canada,2014.0,59,22,5,86
18281,Canada,1998.0,14,28,7,49
18282,Toronto Argonauts,1904.0,27,9,12,48
18283,Canada,2010.0,67,15,8,90
18284,Canada,1928.0,19,5,21,45
18285,Canada,1984.0,21,37,33,91
18286,Canada,2010.0,67,15,8,90
18287,Canada,2014.0,59,22,5,86
18288,Argonaut Rowing Club,1908.0,14,8,30,52
18289,Toronto Argonauts,1908.0,14,8,30,52
18290,Canada,1984.0,21,37,33,91
18291,Canada,1932.0,16,14,29,59
18292,Canada,2006.0,30,28,11,69
18293,Canada,2010.0,67,15,8,90
18294,Canada,1992.0,32,33,15,80
18295,Canada,1972.0,0,3,9,12
18296,Canada,1972.0,0,3,9,12
18297,Canada,1976.0,1,10,15,26
18298,Canada,1952.0,17,3,1,21
18299,Toronto Argonauts,1908.0,14,8,30,52
18300,Canada,2010.0,67,15,8,90
18301,Canada,1996.0,8,30,12,50
18302,Canada,2000.0,4,4,23,31
18303,Canada,2010.0,67,15,8,90
18304,Canada,2016.0,4,4,61,69
18305,Canada,1964.0,6,4,2,12
18306,Caprice,1932.0,16,14,29,59
18307,Canada,1956.0,5,11,23,39
18308,Canada,1960.0,3,26,1,30
18309,Canada,2016.0,4,4,61,69
18310,Canada,1928.0,19,5,21,45
18311,Canada,1928.0,19,5,21,45
18312,Canada,1928.0,19,5,21,45
18313,Canada,2014.0,59,22,5,86
18314,Canada,1960.0,3,26,1,30
18315,Canada,1994.0,3,29,5,37
18316,Canada,2016.0,4,4,61,69
18317,Canada,2016.0,4,4,61,69
18318,Canada,1956.0,5,11,23,39
18319,Canada-1,2010.0,67,15,8,90
18320,Canada,2016.0,4,4,61,69
18321,Canada,2008.0,11,13,11,35
18322,Canada,2002.0,52,7,15,74
18323,Canada,1936.0,1,25,9,35
18324,Canada,1936.0,1,25,9,35
18325,Canada,1936.0,1,25,9,35
18326,Canada,2002.0,52,7,15,74
18327,Canada-1,2002.0,52,7,15,74
18328,Canada,1960.0,3,26,1,30
18329,Canada,1994.0,3,29,5,37
18330,Canada,1998.0,14,28,7,49
18331,Canada,2016.0,4,4,61,69
18332,Canada,1992.0,32,33,15,80
18333,Canada,1994.0,3,29,5,37
18334,Canada,1936.0,1,25,9,35
18335,Canada,2012.0,1,21,33,55
18336,Canada,2016.0,4,4,61,69
18337,Canada,1998.0,14,28,7,49
18338,Canada,1984.0,21,37,33,91
18339,Canada,1920.0,10,3,3,16
18340,Canada,1956.0,5,11,23,39
18341,Canada,1992.0,32,33,15,80
18342,Canada,1994.0,3,29,5,37
18343,Canada,1948.0,13,2,7,22
18344,Canada,1998.0,14,28,7,49
18345,Canada,1948.0,13,2,7,22
18346,Canada,2002.0,52,7,15,74
18347,Canada,2006.0,30,28,11,69
18348,Canada,2012.0,1,21,33,55
18349,Canada,2016.0,4,4,61,69
18350,Canada,2010.0,67,15,8,90
18351,Canada,1952.0,17,3,1,21
18352,Canada,2008.0,11,13,11,35
18353,Canada,2008.0,11,13,11,35
18354,Canada,2014.0,59,22,5,86
18355,Canada,2012.0,1,21,33,55
18356,Canada,2002.0,52,7,15,74
18357,Canada,2014.0,59,22,5,86
18358,Canada,1984.0,21,37,33,91
18359,Canada,1906.0,1,1,0,2
18360,Canada,2002.0,52,7,15,74
18361,Canada,2004.0,3,10,4,17
18362,Canada,2016.0,4,4,61,69
18363,Canada,1932.0,16,14,29,59
18364,Canada,1936.0,1,25,9,35
18365,Canada,2012.0,1,21,33,55
18366,Canada,2016.0,4,4,61,69
18367,Canada,1960.0,3,26,1,30
18368,Canada,1996.0,8,30,12,50
18369,Canada,1924.0,9,19,1,29
18370,Canada,1976.0,1,10,15,26
18371,Canada,1960.0,3,26,1,30
18372,Canada,2002.0,52,7,15,74
18373,Canada,1928.0,19,5,21,45
18374,Canada,1976.0,1,10,15,26
18375,Canada,1976.0,1,10,15,26
18376,Canada,1928.0,19,5,21,45
18377,Canada,1928.0,19,5,21,45
18378,Canada,1998.0,14,28,7,49
18379,Canada,1988.0,4,7,18,29
18380,Canada,1976.0,1,10,15,26
18381,Canada,1924.0,9,19,1,29
18382,Canada,1924.0,9,19,1,29
18383,Canada,1992.0,32,33,15,80
18384,Canada,1976.0,1,10,15,26
18385,Canada,1984.0,21,37,33,91
18386,Canada,1908.0,14,8,30,52
18387,Canada,2002.0,52,7,15,74
18388,Mohawk Indians-2,1904.0,27,9,12,48
18389,Canada,1924.0,9,19,1,29
18390,Canada,2002.0,52,7,15,74
18391,Canada,2006.0,30,28,11,69
18392,Canada,2010.0,67,15,8,90
18393,Canada,1928.0,19,5,21,45
18394,Canada,2014.0,59,22,5,86
18395,Mohawk Indians-2,1904.0,27,9,12,48
18396,Canada,2010.0,67,15,8,90
18397,Canada,2010.0,67,15,8,90
18398,Canada,2014.0,59,22,5,86
18399,Canada,2002.0,52,7,15,74
18400,Canada,2006.0,30,28,11,69
18401,Canada,2010.0,67,15,8,90
18402,Canada,1998.0,14,28,7,49
18403,Canada,2014.0,59,22,5,86
18404,Canada,2010.0,67,15,8,90
18405,Canada,1932.0,16,14,29,59
18406,Canada,1932.0,16,14,29,59
18407,Canada,2016.0,4,4,61,69
18408,Canada,1984.0,21,37,33,91
18409,Canada,1988.0,4,7,18,29
18410,Galt Football Club,1904.0,27,9,12,48
18411,Canada,1968.0,4,4,22,30
18412,Canada,2012.0,1,21,33,55
18413,Canada,1936.0,1,25,9,35
18414,Canada,1928.0,19,5,21,45
18415,Canada,1994.0,3,29,5,37
18416,Canada,1998.0,14,28,7,49
18417,Toronto Argonauts,1904.0,27,9,12,48
18418,Canada,1932.0,16,14,29,59
18419,Canada,1932.0,16,14,29,59
18420,Canada,2014.0,59,22,5,86
18421,Canada,1952.0,17,3,1,21
18422,Canada,1928.0,19,5,21,45
18423,Canada,1928.0,19,5,21,45
18424,Canada,1998.0,14,28,7,49
18425,Canada,2002.0,52,7,15,74
18426,Canada,2006.0,30,28,11,69
18427,Canada,1996.0,8,30,12,50
18428,Canada,1932.0,16,14,29,59
18429,Canada,2002.0,52,7,15,74
18430,Canada,1996.0,8,30,12,50
18431,Canada,2010.0,67,15,8,90
18432,Canada,2014.0,59,22,5,86
18433,Canada,2000.0,4,4,23,31
18434,Canada,2012.0,1,21,33,55
18435,Canada,2016.0,4,4,61,69
18436,Canada,1968.0,4,4,22,30
18437,Canada,1968.0,4,4,22,30
18438,Canada,1968.0,4,4,22,30
18439,Canada,2000.0,4,4,23,31
18440,Canada,2014.0,59,22,5,86
18441,Canada,1932.0,16,14,29,59
18442,Canada,1936.0,1,25,9,35
18443,Canada,1992.0,32,33,15,80
18444,Canada,1992.0,32,33,15,80
18445,Argonaut Rowing Club,1908.0,14,8,30,52
18446,Toronto Argonauts,1908.0,14,8,30,52
18447,Canada,1948.0,13,2,7,22
18448,Canada,1924.0,9,19,1,29
18449,Canada,1928.0,19,5,21,45
18450,Galt Football Club,1904.0,27,9,12,48
18451,Canada,1984.0,21,37,33,91
18452,Canada,1988.0,4,7,18,29
18453,Canada,1992.0,32,33,15,80
18454,Canada,1992.0,32,33,15,80
18455,Canada,1956.0,5,11,23,39
18456,Canada,2016.0,4,4,61,69
18457,Canada,1994.0,3,29,5,37
18458,Canada,1932.0,16,14,29,59
18459,Canada,1984.0,21,37,33,91
18460,Canada,1928.0,19,5,21,45
18461,Canada,2014.0,59,22,5,86
18462,Canada,1984.0,21,37,33,91
18463,Canada,1992.0,32,33,15,80
18464,Canada,1996.0,8,30,12,50
18465,Canada,2000.0,4,4,23,31
18466,Canada,2012.0,1,21,33,55
18467,Canada,1936.0,1,25,9,35
18468,Toronto Argonauts,1908.0,14,8,30,52
18469,Canada,1920.0,10,3,3,16
18470,Canada,2010.0,67,15,8,90
18471,Canada,1992.0,32,33,15,80
18472,Canada,2012.0,1,21,33,55
18473,Canada,1992.0,32,33,15,80
18474,Canada,2010.0,67,15,8,90
18475,Canada,2014.0,59,22,5,86
18476,Argonaut Rowing Club,1908.0,14,8,30,52
18477,Canada,2002.0,52,7,15,74
18478,Canada,1984.0,21,37,33,91
18479,Canada,2002.0,52,7,15,74
18480,Canada,2006.0,30,28,11,69
18481,Canada,2006.0,30,28,11,69
18482,Canada,2010.0,67,15,8,90
18483,Canada,2010.0,67,15,8,90
18484,Canada,1928.0,19,5,21,45
18485,Canada,1928.0,19,5,21,45
18486,Canada,1996.0,8,30,12,50
18487,Canada,2002.0,52,7,15,74
18488,Canada,2002.0,52,7,15,74
18489,Canada,2006.0,30,28,11,69
18490,Canada,2000.0,4,4,23,31
18491,Canada,1908.0,14,8,30,52
18492,Canada,1984.0,21,37,33,91
18493,Canada,1992.0,32,33,15,80
18494,Galt Football Club,1904.0,27,9,12,48
18495,Canada-2,2010.0,67,15,8,90
18496,Canada,2000.0,4,4,23,31
18497,Canada,1976.0,1,10,15,26
18498,Canada,2006.0,30,28,11,69
18499,Canada,2010.0,67,15,8,90
18500,Canada,2012.0,1,21,33,55
18501,Canada,1996.0,8,30,12,50
18502,Canada,2004.0,3,10,4,17
18503,Canada,2004.0,3,10,4,17
18504,Canada,2008.0,11,13,11,35
18505,Canada,2012.0,1,21,33,55
18506,Canada,2016.0,4,4,61,69
18507,Canada,1924.0,9,19,1,29
18508,Canada,2004.0,3,10,4,17
18509,Canada,2008.0,11,13,11,35
18510,Canada,2012.0,1,21,33,55
18511,Canada,1920.0,10,3,3,16
18512,Canada,1920.0,10,3,3,16
18513,Canada,1998.0,14,28,7,49
18514,Canada,2002.0,52,7,15,74
18515,Canada,2006.0,30,28,11,69
18516,Canada,2010.0,67,15,8,90
18517,Canada,1992.0,32,33,15,80
18518,Canada,1992.0,32,33,15,80
18519,Canada-1,2010.0,67,15,8,90
18520,Canada-1,2014.0,59,22,5,86
18521,Canada,2014.0,59,22,5,86
18522,Canada,1908.0,14,8,30,52
18523,Canada,2014.0,59,22,5,86
18524,Toronto Argonauts,1904.0,27,9,12,48
18525,Canada-1,1960.0,3,26,1,30
18526,Canada,1932.0,16,14,29,59
18527,Canada,2014.0,59,22,5,86
18528,Canada,2002.0,52,7,15,74
18529,Canada,1984.0,21,37,33,91
18530,Canada,1988.0,4,7,18,29
18531,Canada,1988.0,4,7,18,29
18532,Santa Maria,1932.0,16,14,29,59
18533,Canada,1992.0,32,33,15,80
18534,Canada,1924.0,9,19,1,29
18535,Canada,1908.0,14,8,30,52
18536,Canada,1984.0,21,37,33,91
18537,Canada,1996.0,8,30,12,50
18538,Canada,2010.0,67,15,8,90
18539,Canada,2014.0,59,22,5,86
18540,Canada,2016.0,4,4,61,69
18541,Canada,1994.0,3,29,5,37
18542,Canada,2006.0,30,28,11,69
18543,Canada,2016.0,4,4,61,69
18544,Canada,2014.0,59,22,5,86
18545,Canada,1924.0,9,19,1,29
18546,Canada,1952.0,17,3,1,21
18547,Canada,2006.0,30,28,11,69
18548,Canada,2010.0,67,15,8,90
18549,Canada,2014.0,59,22,5,86
18550,Canada,2012.0,1,21,33,55
18551,Canada,1948.0,13,2,7,22
18552,Canada,1994.0,3,29,5,37
18553,Canada,1956.0,5,11,23,39
18554,Canada,1984.0,21,37,33,91
18555,Canada,1984.0,21,37,33,91
18556,Canada,1908.0,14,8,30,52
18557,Canada,2004.0,3,10,4,17
18558,Canada,2008.0,11,13,11,35
18559,Canada,2002.0,52,7,15,74
18560,Canada,1956.0,5,11,23,39
18561,Canada,1956.0,5,11,23,39
18562,Canada,2000.0,4,4,23,31
18563,Canada,2008.0,11,13,11,35
18564,Canada,2012.0,1,21,33,55
18565,Canada,1998.0,14,28,7,49
18566,Canada,2002.0,52,7,15,74
18567,Canada,2006.0,30,28,11,69
18568,Canada,2010.0,67,15,8,90
18569,Canada,2014.0,59,22,5,86
18570,Canada,2016.0,4,4,61,69
18571,Canada-1,1964.0,6,4,2,12
18572,Canada,2012.0,1,21,33,55
18573,Canada,2012.0,1,21,33,55
18574,Canada,2016.0,4,4,61,69
18575,Canada,2004.0,3,10,4,17
18576,Canada,1908.0,14,8,30,52
18577,Canada,2016.0,4,4,61,69
18578,Canada,1984.0,21,37,33,91
18579,Canada,1984.0,21,37,33,91
18580,Canada,2016.0,4,4,61,69
18581,Canada,1928.0,19,5,21,45
18582,Canada,1928.0,19,5,21,45
18583,Canada,1928.0,19,5,21,45
18584,Canada,1932.0,16,14,29,59
18585,Canada,1932.0,16,14,29,59
18586,Canada,1932.0,16,14,29,59
18587,Canada,1932.0,16,14,29,59
18588,Caprice,1932.0,16,14,29,59
18589,Canada,1956.0,5,11,23,39
18590,Canada,1998.0,14,28,7,49
18591,Canada-1,1988.0,4,7,18,29
18592,Canada,1932.0,16,14,29,59
18593,Canada,1936.0,1,25,9,35
18594,Canada,2004.0,3,10,4,17
18595,Canada,1924.0,9,19,1,29
18596,Canada,1976.0,1,10,15,26
18597,Canada,1956.0,5,11,23,39
18598,Canada,1996.0,8,30,12,50
18599,Canada,1920.0,10,3,3,16
18600,Canada,1992.0,32,33,15,80
18601,Canada,1992.0,32,33,15,80
18602,Canada,1992.0,32,33,15,80
18603,Canada,1998.0,14,28,7,49
18604,Canada,1984.0,21,37,33,91
18605,Canada,1928.0,19,5,21,45
18606,Toronto Argonauts,1904.0,27,9,12,48
18607,Toronto Argonauts,1908.0,14,8,30,52
18608,Canada,2002.0,52,7,15,74
18609,Canada,2016.0,4,4,61,69
18610,Pakistan,1960.0,13,0,1,14
18611,Pakistan,1964.0,0,16,0,16
18612,Pakistan,1964.0,0,16,0,16
18613,Pakistan,1992.0,0,0,16,16
18614,Pakistan,1968.0,13,0,0,13
18615,Pakistan,1960.0,13,0,1,14
18616,Pakistan,1984.0,16,0,0,16
18617,Pakistan,1992.0,0,0,16,16
18618,Pakistan,1984.0,16,0,0,16
18619,Pakistan,1960.0,13,0,1,14
18620,Pakistan,1968.0,13,0,0,13
18621,Pakistan,1972.0,0,15,0,15
18622,Pakistan,1992.0,0,0,16,16
18623,Pakistan,1968.0,13,0,0,13
18624,Pakistan,1984.0,16,0,0,16
18625,Pakistan,1984.0,16,0,0,16
18626,Pakistan,1956.0,0,14,0,14
18627,Pakistan,1960.0,13,0,1,14
18628,Pakistan,1984.0,16,0,0,16
18629,Pakistan,1964.0,0,16,0,16
18630,Pakistan,1968.0,13,0,0,13
18631,Pakistan,1972.0,0,15,0,15
18632,Pakistan,1972.0,0,15,0,15
18633,Pakistan,1976.0,0,0,16,16
18634,Pakistan,1960.0,13,0,1,14
18635,Pakistan,1956.0,0,14,0,14
18636,Pakistan,1960.0,13,0,1,14
18637,Pakistan,1964.0,0,16,0,16
18638,Pakistan,1964.0,0,16,0,16
18639,Pakistan,1964.0,0,16,0,16
18640,Pakistan,1968.0,13,0,0,13
18641,Pakistan,1992.0,0,0,16,16
18642,Pakistan,1964.0,0,16,0,16
18643,Pakistan,1992.0,0,0,16,16
18644,Pakistan,1960.0,13,0,1,14
18645,Pakistan,1956.0,0,14,0,14
18646,Pakistan,1960.0,13,0,1,14
18647,Pakistan,1968.0,13,0,0,13
18648,Pakistan,1972.0,0,15,0,15
18649,Pakistan,1976.0,0,0,16,16
18650,Pakistan,1956.0,0,14,0,14
18651,Pakistan,1964.0,0,16,0,16
18652,Pakistan,1968.0,13,0,0,13
18653,Pakistan,1984.0,16,0,0,16
18654,Pakistan,1992.0,0,0,16,16
18655,Pakistan,1956.0,0,14,0,14
18656,Pakistan,1960.0,13,0,1,14
18657,Pakistan,1964.0,0,16,0,16
18658,Pakistan,1984.0,16,0,0,16
18659,Pakistan,1976.0,0,0,16,16
18660,Pakistan,1964.0,0,16,0,16
18661,Pakistan,1956.0,0,14,0,14
18662,Pakistan,1976.0,0,0,16,16
18663,Pakistan,1984.0,16,0,0,16
18664,Pakistan,1992.0,0,0,16,16
18665,Pakistan,1956.0,0,14,0,14
18666,Pakistan,1956.0,0,14,0,14
18667,Pakistan,1968.0,13,0,0,13
18668,Pakistan,1988.0,0,0,1,1
18669,Pakistan,1992.0,0,0,16,16
18670,Pakistan,1972.0,0,15,0,15
18671,Pakistan,1976.0,0,0,16,16
18672,Pakistan,1972.0,0,15,0,15
18673,Pakistan,1992.0,0,0,16,16
18674,Pakistan,1984.0,16,0,0,16
18675,Pakistan,1992.0,0,0,16,16
18676,Pakistan,1960.0,13,0,1,14
18677,Pakistan,1956.0,0,14,0,14
18678,Pakistan,1960.0,13,0,1,14
18679,Pakistan,1964.0,0,16,0,16
18680,Pakistan,1992.0,0,0,16,16
18681,Pakistan,1976.0,0,0,16,16
18682,Pakistan,1984.0,16,0,0,16
18683,Pakistan,1984.0,16,0,0,16
18684,Pakistan,1992.0,0,0,16,16
18685,Pakistan,1956.0,0,14,0,14
18686,Pakistan,1960.0,13,0,1,14
18687,Pakistan,1976.0,0,0,16,16
18688,Pakistan,1984.0,16,0,0,16
18689,Pakistan,1964.0,0,16,0,16
18690,Pakistan,1968.0,13,0,0,13
18691,Pakistan,1964.0,0,16,0,16
18692,Pakistan,1968.0,13,0,0,13
18693,Pakistan,1972.0,0,15,0,15
18694,Pakistan,1984.0,16,0,0,16
18695,Pakistan,1956.0,0,14,0,14
18696,Pakistan,1960.0,13,0,1,14
18697,Pakistan,1964.0,0,16,0,16
18698,Pakistan,1976.0,0,0,16,16
18699,Pakistan,1964.0,0,16,0,16
18700,Pakistan,1968.0,13,0,0,13
18701,Pakistan,1992.0,0,0,16,16
18702,Pakistan,1968.0,13,0,0,13
18703,Pakistan,1972.0,0,15,0,15
18704,Pakistan,1976.0,0,0,16,16
18705,Pakistan,1972.0,0,15,0,15
18706,Pakistan,1976.0,0,0,16,16
18707,Pakistan,1956.0,0,14,0,14
18708,Pakistan,1960.0,13,0,1,14
18709,Pakistan,1972.0,0,15,0,15
18710,Pakistan,1956.0,0,14,0,14
18711,Pakistan,1956.0,0,14,0,14
18712,Pakistan,1992.0,0,0,16,16
18713,Pakistan,1976.0,0,0,16,16
18714,Pakistan,1984.0,16,0,0,16
18715,Pakistan,1992.0,0,0,16,16
18716,Pakistan,1972.0,0,15,0,15
18717,Pakistan,1972.0,0,15,0,15
18718,Pakistan,1976.0,0,0,16,16
18719,Pakistan,1984.0,16,0,0,16
18720,Pakistan,1972.0,0,15,0,15
18721,Pakistan,1976.0,0,0,16,16
18722,Pakistan,1972.0,0,15,0,15
18723,Pakistan,1976.0,0,0,16,16
18724,Pakistan,1968.0,13,0,0,13
18725,Pakistan,1964.0,0,16,0,16
18726,Pakistan,1972.0,0,15,0,15
18727,Pakistan,1976.0,0,0,16,16
18728,Pakistan,1992.0,0,0,16,16
18729,Pakistan,1976.0,0,0,16,16
18730,Pakistan,1984.0,16,0,0,16
18731,Soviet Union,1972.0,143,53,63,259
18732,Soviet Union,1972.0,143,53,63,259
18733,Soviet Union,1972.0,143,53,63,259
18734,Soviet Union,1964.0,90,71,60,221
18735,Soviet Union,1980.0,205,158,133,496
18736,Soviet Union,1980.0,205,158,133,496
18737,Soviet Union,1980.0,205,158,133,496
18738,Soviet Union,1968.0,91,69,69,229
18739,Soviet Union,1956.0,94,51,61,206
18740,Soviet Union,1960.0,68,70,73,211
18741,Soviet Union,1964.0,90,71,60,221
18742,Soviet Union,1980.0,205,158,133,496
18743,Soviet Union,1980.0,205,158,133,496
18744,Soviet Union,1960.0,68,70,73,211
18745,Soviet Union,1972.0,143,53,63,259
18746,Soviet Union,1980.0,205,158,133,496
18747,Soviet Union,1976.0,152,102,88,342
18748,Soviet Union,1976.0,152,102,88,342
18749,Soviet Union,1980.0,205,158,133,496
18750,Soviet Union,1980.0,205,158,133,496
18751,Soviet Union,1976.0,152,102,88,342
18752,Soviet Union,1964.0,90,71,60,221
18753,Soviet Union,1972.0,143,53,63,259
18754,Soviet Union,1960.0,68,70,73,211
18755,Soviet Union,1976.0,152,102,88,342
18756,Soviet Union,1960.0,68,70,73,211
18757,Soviet Union,1964.0,90,71,60,221
18758,Soviet Union,1968.0,91,69,69,229
18759,Soviet Union-2,1984.0,29,15,12,56
18760,Soviet Union,1976.0,152,102,88,342
18761,Soviet Union,1980.0,205,158,133,496
18762,Soviet Union,1972.0,143,53,63,259
18763,Soviet Union,1976.0,152,102,88,342
18764,Soviet Union,1964.0,90,71,60,221
18765,Soviet Union,1976.0,152,102,88,342
18766,Soviet Union,1980.0,205,158,133,496
18767,Soviet Union,1976.0,152,102,88,342
18768,Soviet Union,1980.0,205,158,133,496
18769,Soviet Union,1980.0,205,158,133,496
18770,Soviet Union,1960.0,68,70,73,211
18771,Soviet Union,1964.0,90,71,60,221
18772,Soviet Union,1988.0,174,81,111,366
18773,Soviet Union,1980.0,205,158,133,496
18774,Soviet Union,1980.0,205,158,133,496
18775,Soviet Union,1980.0,205,158,133,496
18776,Soviet Union,1980.0,205,158,133,496
18777,Soviet Union,1980.0,205,158,133,496
18778,Soviet Union,1952.0,36,62,19,117
18779,Soviet Union,1976.0,152,102,88,342
18780,Soviet Union,1976.0,152,102,88,342
18781,Soviet Union,1980.0,205,158,133,496
18782,Soviet Union,1952.0,36,62,19,117
18783,Soviet Union,1952.0,36,62,19,117
18784,Soviet Union,1980.0,205,158,133,496
18785,Soviet Union,1968.0,91,69,69,229
18786,Soviet Union,1980.0,205,158,133,496
18787,Soviet Union,1972.0,143,53,63,259
18788,Soviet Union,1972.0,143,53,63,259
18789,Soviet Union,1972.0,143,53,63,259
18790,Soviet Union,1976.0,152,102,88,342
18791,Soviet Union,1976.0,152,102,88,342
18792,Soviet Union,1976.0,152,102,88,342
18793,Soviet Union,1976.0,152,102,88,342
18794,Soviet Union,1976.0,152,102,88,342
18795,Soviet Union,1976.0,152,102,88,342
18796,Soviet Union,1976.0,152,102,88,342
18797,Soviet Union,1980.0,205,158,133,496
18798,Soviet Union,1980.0,205,158,133,496
18799,Soviet Union,1980.0,205,158,133,496
18800,Soviet Union,1980.0,205,158,133,496
18801,Soviet Union,1980.0,205,158,133,496
18802,Soviet Union,1972.0,143,53,63,259
18803,Soviet Union,1956.0,94,51,61,206
18804,Soviet Union,1960.0,68,70,73,211
18805,Soviet Union,1960.0,68,70,73,211
18806,Soviet Union,1988.0,174,81,111,366
18807,Soviet Union,1976.0,152,102,88,342
18808,Soviet Union,1976.0,152,102,88,342
18809,Soviet Union,1980.0,205,158,133,496
18810,Soviet Union,1976.0,152,102,88,342
18811,Soviet Union,1980.0,205,158,133,496
18812,Soviet Union,1988.0,174,81,111,366
18813,Soviet Union,1976.0,152,102,88,342
18814,Soviet Union,1968.0,91,69,69,229
18815,Soviet Union,1964.0,90,71,60,221
18816,Soviet Union,1952.0,36,62,19,117
18817,Soviet Union,1988.0,174,81,111,366
18818,Soviet Union,1988.0,174,81,111,366
18819,Soviet Union,1980.0,205,158,133,496
18820,Soviet Union,1980.0,205,158,133,496
18821,Soviet Union,1976.0,152,102,88,342
18822,Soviet Union,1988.0,174,81,111,366
18823,Soviet Union,1988.0,174,81,111,366
18824,Soviet Union,1988.0,174,81,111,366
18825,Soviet Union,1988.0,174,81,111,366
18826,Soviet Union,1988.0,174,81,111,366
18827,Soviet Union,1988.0,174,81,111,366
18828,Soviet Union,1976.0,152,102,88,342
18829,Soviet Union,1972.0,143,53,63,259
18830,Soviet Union,1964.0,90,71,60,221
18831,Soviet Union,1972.0,143,53,63,259
18832,Soviet Union,1980.0,205,158,133,496
18833,Soviet Union,1956.0,94,51,61,206
18834,Soviet Union,1956.0,94,51,61,206
18835,Soviet Union,1960.0,68,70,73,211
18836,Soviet Union,1960.0,68,70,73,211
18837,Soviet Union,1960.0,68,70,73,211
18838,Soviet Union,1960.0,68,70,73,211
18839,Soviet Union,1964.0,90,71,60,221
18840,Soviet Union,1964.0,90,71,60,221
18841,Soviet Union,1964.0,90,71,60,221
18842,Soviet Union,1964.0,90,71,60,221
18843,Soviet Union,1976.0,152,102,88,342
18844,Soviet Union,1988.0,174,81,111,366
18845,Soviet Union,1964.0,90,71,60,221
18846,Soviet Union,1988.0,174,81,111,366
18847,Soviet Union,1976.0,152,102,88,342
18848,Soviet Union,1976.0,152,102,88,342
18849,Soviet Union,1976.0,152,102,88,342
18850,Soviet Union,1976.0,152,102,88,342
18851,Soviet Union,1972.0,143,53,63,259
18852,Soviet Union,1976.0,152,102,88,342
18853,Soviet Union,1988.0,174,81,111,366
18854,Soviet Union,1956.0,94,51,61,206
18855,Soviet Union,1956.0,94,51,61,206
18856,Soviet Union,1960.0,68,70,73,211
18857,Soviet Union,1960.0,68,70,73,211
18858,Soviet Union,1980.0,205,158,133,496
18859,Soviet Union,1980.0,205,158,133,496
18860,Soviet Union,1964.0,90,71,60,221
18861,Soviet Union,1964.0,90,71,60,221
18862,Soviet Union,1956.0,94,51,61,206
18863,Soviet Union,1976.0,152,102,88,342
18864,Soviet Union,1960.0,68,70,73,211
18865,Soviet Union,1980.0,205,158,133,496
18866,Soviet Union,1960.0,68,70,73,211
18867,Soviet Union,1968.0,91,69,69,229
18868,Soviet Union,1952.0,36,62,19,117
18869,Soviet Union,1964.0,90,71,60,221
18870,Soviet Union,1988.0,174,81,111,366
18871,Soviet Union,1988.0,174,81,111,366
18872,Soviet Union,1968.0,91,69,69,229
18873,Soviet Union,1976.0,152,102,88,342
18874,Soviet Union,1980.0,205,158,133,496
18875,Soviet Union,1956.0,94,51,61,206
18876,Soviet Union,1976.0,152,102,88,342
18877,Soviet Union,1980.0,205,158,133,496
18878,Soviet Union,1980.0,205,158,133,496
18879,Soviet Union,1964.0,90,71,60,221
18880,Soviet Union,1980.0,205,158,133,496
18881,Soviet Union,1988.0,174,81,111,366
18882,Soviet Union,1980.0,205,158,133,496
18883,Soviet Union,1968.0,91,69,69,229
18884,Soviet Union,1972.0,143,53,63,259
18885,Soviet Union,1980.0,205,158,133,496
18886,Soviet Union,1980.0,205,158,133,496
18887,Soviet Union,1956.0,94,51,61,206
18888,Soviet Union,1960.0,68,70,73,211
18889,Soviet Union,1976.0,152,102,88,342
18890,Soviet Union,1980.0,205,158,133,496
18891,Soviet Union,1976.0,152,102,88,342
18892,Soviet Union,1980.0,205,158,133,496
18893,Soviet Union,1988.0,174,81,111,366
18894,Soviet Union,1956.0,94,51,61,206
18895,Soviet Union,1988.0,174,81,111,366
18896,Soviet Union,1984.0,29,15,12,56
18897,Soviet Union,1960.0,68,70,73,211
18898,Soviet Union,1988.0,174,81,111,366
18899,Soviet Union,1972.0,143,53,63,259
18900,Soviet Union,1976.0,152,102,88,342
18901,Soviet Union,1976.0,152,102,88,342
18902,Soviet Union,1980.0,205,158,133,496
18903,Soviet Union,1956.0,94,51,61,206
18904,Soviet Union,1976.0,152,102,88,342
18905,Soviet Union,1960.0,68,70,73,211
18906,Soviet Union,1968.0,91,69,69,229
18907,Soviet Union,1968.0,91,69,69,229
18908,Soviet Union,1980.0,205,158,133,496
18909,Soviet Union,1980.0,205,158,133,496
18910,Soviet Union,1988.0,174,81,111,366
18911,Soviet Union,1968.0,91,69,69,229
18912,Soviet Union-1,1984.0,29,15,12,56
18913,Soviet Union-1,1964.0,90,71,60,221
18914,Soviet Union-1,1968.0,91,69,69,229
18915,Soviet Union,1972.0,143,53,63,259
18916,Soviet Union,1976.0,152,102,88,342
18917,Soviet Union,1952.0,36,62,19,117
18918,Soviet Union,1968.0,91,69,69,229
18919,Soviet Union,1972.0,143,53,63,259
18920,Soviet Union,1976.0,152,102,88,342
18921,Soviet Union,1980.0,205,158,133,496
18922,Soviet Union,1980.0,205,158,133,496
18923,Soviet Union-1,1984.0,29,15,12,56
18924,Soviet Union,1980.0,205,158,133,496
18925,Soviet Union,1952.0,36,62,19,117
18926,Soviet Union,1976.0,152,102,88,342
18927,Soviet Union,1976.0,152,102,88,342
18928,Soviet Union,1980.0,205,158,133,496
18929,Soviet Union,1952.0,36,62,19,117
18930,Soviet Union,1988.0,174,81,111,366
18931,Soviet Union,1976.0,152,102,88,342
18932,Soviet Union,1980.0,205,158,133,496
18933,Soviet Union,1976.0,152,102,88,342
18934,Soviet Union,1956.0,94,51,61,206
18935,Soviet Union,1960.0,68,70,73,211
18936,Soviet Union,1980.0,205,158,133,496
18937,Soviet Union,1980.0,205,158,133,496
18938,Soviet Union,1976.0,152,102,88,342
18939,Soviet Union,1956.0,94,51,61,206
18940,Soviet Union-1,1984.0,29,15,12,56
18941,Soviet Union-1,1988.0,174,81,111,366
18942,Soviet Union,1956.0,94,51,61,206
18943,Soviet Union,1980.0,205,158,133,496
18944,Soviet Union,1972.0,143,53,63,259
18945,Soviet Union,1976.0,152,102,88,342
18946,Soviet Union,1964.0,90,71,60,221
18947,Soviet Union,1968.0,91,69,69,229
18948,Soviet Union,1968.0,91,69,69,229
18949,Soviet Union,1980.0,205,158,133,496
18950,Soviet Union,1988.0,174,81,111,366
18951,Soviet Union,1988.0,174,81,111,366
18952,Soviet Union,1988.0,174,81,111,366
18953,Soviet Union,1988.0,174,81,111,366
18954,Soviet Union,1988.0,174,81,111,366
18955,Soviet Union,1964.0,90,71,60,221
18956,Soviet Union,1980.0,205,158,133,496
18957,Soviet Union,1984.0,29,15,12,56
18958,Soviet Union,1980.0,205,158,133,496
18959,Soviet Union,1980.0,205,158,133,496
18960,Soviet Union,1980.0,205,158,133,496
18961,Soviet Union,1968.0,91,69,69,229
18962,Soviet Union,1972.0,143,53,63,259
18963,Soviet Union,1972.0,143,53,63,259
18964,Soviet Union,1976.0,152,102,88,342
18965,Soviet Union,1956.0,94,51,61,206
18966,Soviet Union,1976.0,152,102,88,342
18967,Soviet Union,1980.0,205,158,133,496
18968,Soviet Union,1952.0,36,62,19,117
18969,Soviet Union,1952.0,36,62,19,117
18970,Soviet Union,1952.0,36,62,19,117
18971,Soviet Union,1952.0,36,62,19,117
18972,Soviet Union,1980.0,205,158,133,496
18973,Soviet Union,1980.0,205,158,133,496
18974,Soviet Union,1956.0,94,51,61,206
18975,Soviet Union,1964.0,90,71,60,221
18976,Soviet Union,1952.0,36,62,19,117
18977,Soviet Union,1956.0,94,51,61,206
18978,Soviet Union,1976.0,152,102,88,342
18979,Soviet Union,1956.0,94,51,61,206
18980,Soviet Union,1980.0,205,158,133,496
18981,Soviet Union,1956.0,94,51,61,206
18982,Soviet Union,1988.0,174,81,111,366
18983,Soviet Union,1988.0,174,81,111,366
18984,Soviet Union,1988.0,174,81,111,366
18985,Soviet Union,1988.0,174,81,111,366
18986,Soviet Union,1964.0,90,71,60,221
18987,Soviet Union,1960.0,68,70,73,211
18988,Soviet Union,1972.0,143,53,63,259
18989,Soviet Union,1960.0,68,70,73,211
18990,Soviet Union,1972.0,143,53,63,259
18991,Soviet Union,1976.0,152,102,88,342
18992,Soviet Union,1988.0,174,81,111,366
18993,Soviet Union,1960.0,68,70,73,211
18994,Soviet Union,1952.0,36,62,19,117
18995,Soviet Union,1956.0,94,51,61,206
18996,Soviet Union,1956.0,94,51,61,206
18997,Soviet Union,1960.0,68,70,73,211
18998,Soviet Union,1988.0,174,81,111,366
18999,Soviet Union,1972.0,143,53,63,259
19000,Soviet Union,1972.0,143,53,63,259
19001,Soviet Union,1964.0,90,71,60,221
19002,Soviet Union,1988.0,174,81,111,366
19003,Soviet Union,1972.0,143,53,63,259
19004,Soviet Union,1972.0,143,53,63,259
19005,Soviet Union,1972.0,143,53,63,259
19006,Soviet Union,1976.0,152,102,88,342
19007,Soviet Union,1976.0,152,102,88,342
19008,Soviet Union,1956.0,94,51,61,206
19009,Soviet Union,1956.0,94,51,61,206
19010,Soviet Union,1968.0,91,69,69,229
19011,Soviet Union,1964.0,90,71,60,221
19012,Soviet Union,1964.0,90,71,60,221
19013,Soviet Union,1964.0,90,71,60,221
19014,Soviet Union,1984.0,29,15,12,56
19015,Soviet Union,1972.0,143,53,63,259
19016,Soviet Union,1952.0,36,62,19,117
19017,Soviet Union,1956.0,94,51,61,206
19018,Soviet Union,1968.0,91,69,69,229
19019,Soviet Union,1960.0,68,70,73,211
19020,Soviet Union,1964.0,90,71,60,221
19021,Soviet Union,1976.0,152,102,88,342
19022,Soviet Union,1988.0,174,81,111,366
19023,Soviet Union,1988.0,174,81,111,366
19024,Soviet Union,1988.0,174,81,111,366
19025,Soviet Union,1988.0,174,81,111,366
19026,Soviet Union,1980.0,205,158,133,496
19027,Soviet Union,1980.0,205,158,133,496
19028,Soviet Union,1964.0,90,71,60,221
19029,Soviet Union,1968.0,91,69,69,229
19030,Soviet Union,1956.0,94,51,61,206
19031,Soviet Union,1956.0,94,51,61,206
19032,Soviet Union,1968.0,91,69,69,229
19033,Soviet Union-1,1984.0,29,15,12,56
19034,Soviet Union-1,1988.0,174,81,111,366
19035,Soviet Union,1952.0,36,62,19,117
19036,Soviet Union,1956.0,94,51,61,206
19037,Soviet Union,1964.0,90,71,60,221
19038,Soviet Union,1968.0,91,69,69,229
19039,Soviet Union,1972.0,143,53,63,259
19040,Soviet Union,1984.0,29,15,12,56
19041,Soviet Union,1980.0,205,158,133,496
19042,Soviet Union,1968.0,91,69,69,229
19043,Soviet Union,1972.0,143,53,63,259
19044,Soviet Union,1968.0,91,69,69,229
19045,Soviet Union,1972.0,143,53,63,259
19046,Soviet Union,1972.0,143,53,63,259
19047,Soviet Union,1972.0,143,53,63,259
19048,Soviet Union,1976.0,152,102,88,342
19049,Soviet Union,1964.0,90,71,60,221
19050,Soviet Union,1976.0,152,102,88,342
19051,Soviet Union,1980.0,205,158,133,496
19052,Soviet Union,1980.0,205,158,133,496
19053,Soviet Union,1988.0,174,81,111,366
19054,Soviet Union,1988.0,174,81,111,366
19055,Soviet Union,1960.0,68,70,73,211
19056,Soviet Union,1988.0,174,81,111,366
19057,Soviet Union,1952.0,36,62,19,117
19058,Soviet Union,1976.0,152,102,88,342
19059,Soviet Union,1980.0,205,158,133,496
19060,Soviet Union,1980.0,205,158,133,496
19061,Soviet Union,1988.0,174,81,111,366
19062,Soviet Union,1960.0,68,70,73,211
19063,Soviet Union,1976.0,152,102,88,342
19064,Soviet Union,1980.0,205,158,133,496
19065,Soviet Union,1988.0,174,81,111,366
19066,Soviet Union,1980.0,205,158,133,496
19067,Soviet Union,1988.0,174,81,111,366
19068,Soviet Union,1964.0,90,71,60,221
19069,Soviet Union,1964.0,90,71,60,221
19070,Soviet Union,1968.0,91,69,69,229
19071,Soviet Union,1976.0,152,102,88,342
19072,Soviet Union,1980.0,205,158,133,496
19073,Soviet Union,1972.0,143,53,63,259
19074,Soviet Union,1976.0,152,102,88,342
19075,Soviet Union,1980.0,205,158,133,496
19076,Soviet Union,1976.0,152,102,88,342
19077,Soviet Union,1980.0,205,158,133,496
19078,Soviet Union,1964.0,90,71,60,221
19079,Soviet Union,1988.0,174,81,111,366
19080,Soviet Union,1988.0,174,81,111,366
19081,Soviet Union,1988.0,174,81,111,366
19082,Soviet Union,1988.0,174,81,111,366
19083,Soviet Union,1980.0,205,158,133,496
19084,Soviet Union,1980.0,205,158,133,496
19085,Soviet Union,1980.0,205,158,133,496
19086,Soviet Union,1956.0,94,51,61,206
19087,Soviet Union,1956.0,94,51,61,206
19088,Soviet Union-2,1980.0,205,158,133,496
19089,Soviet Union,1988.0,174,81,111,366
19090,Soviet Union,1980.0,205,158,133,496
19091,Soviet Union,1960.0,68,70,73,211
19092,Soviet Union,1980.0,205,158,133,496
19093,Soviet Union,1960.0,68,70,73,211
19094,Soviet Union,1988.0,174,81,111,366
19095,Soviet Union,1976.0,152,102,88,342
19096,Soviet Union,1980.0,205,158,133,496
19097,Soviet Union,1976.0,152,102,88,342
19098,Soviet Union,1980.0,205,158,133,496
19099,Soviet Union,1976.0,152,102,88,342
19100,Soviet Union,1980.0,205,158,133,496
19101,Soviet Union,1976.0,152,102,88,342
19102,Soviet Union,1964.0,90,71,60,221
19103,Soviet Union,1972.0,143,53,63,259
19104,Soviet Union,1972.0,143,53,63,259
19105,Soviet Union,1964.0,90,71,60,221
19106,Soviet Union,1952.0,36,62,19,117
19107,Soviet Union,1960.0,68,70,73,211
19108,Soviet Union,1968.0,91,69,69,229
19109,Soviet Union,1952.0,36,62,19,117
19110,Soviet Union,1980.0,205,158,133,496
19111,Soviet Union,1968.0,91,69,69,229
19112,Soviet Union,1972.0,143,53,63,259
19113,Soviet Union,1976.0,152,102,88,342
19114,Soviet Union,1972.0,143,53,63,259
19115,Soviet Union,1976.0,152,102,88,342
19116,Soviet Union,1988.0,174,81,111,366
19117,Soviet Union,1952.0,36,62,19,117
19118,Soviet Union,1952.0,36,62,19,117
19119,Soviet Union,1952.0,36,62,19,117
19120,Soviet Union,1976.0,152,102,88,342
19121,Soviet Union,1980.0,205,158,133,496
19122,Soviet Union,1952.0,36,62,19,117
19123,Soviet Union,1952.0,36,62,19,117
19124,Soviet Union,1952.0,36,62,19,117
19125,Soviet Union,1952.0,36,62,19,117
19126,Soviet Union,1952.0,36,62,19,117
19127,Soviet Union,1952.0,36,62,19,117
19128,Soviet Union,1956.0,94,51,61,206
19129,Soviet Union,1956.0,94,51,61,206
19130,Soviet Union,1956.0,94,51,61,206
19131,Soviet Union,1956.0,94,51,61,206
19132,Soviet Union,1956.0,94,51,61,206
19133,Soviet Union,1976.0,152,102,88,342
19134,Soviet Union,1980.0,205,158,133,496
19135,Soviet Union,1980.0,205,158,133,496
19136,Soviet Union,1972.0,143,53,63,259
19137,Soviet Union,1976.0,152,102,88,342
19138,Soviet Union,1988.0,174,81,111,366
19139,Soviet Union,1988.0,174,81,111,366
19140,Soviet Union,1964.0,90,71,60,221
19141,Soviet Union,1988.0,174,81,111,366
19142,Soviet Union,1984.0,29,15,12,56
19143,Soviet Union,1952.0,36,62,19,117
19144,Soviet Union,1952.0,36,62,19,117
19145,Soviet Union,1980.0,205,158,133,496
19146,Soviet Union,1976.0,152,102,88,342
19147,Soviet Union,1976.0,152,102,88,342
19148,Soviet Union,1964.0,90,71,60,221
19149,Soviet Union,1968.0,91,69,69,229
19150,Soviet Union,1972.0,143,53,63,259
19151,Soviet Union,1980.0,205,158,133,496
19152,Soviet Union,1980.0,205,158,133,496
19153,Soviet Union,1980.0,205,158,133,496
19154,Soviet Union,1976.0,152,102,88,342
19155,Soviet Union,1956.0,94,51,61,206
19156,Soviet Union,1956.0,94,51,61,206
19157,Soviet Union,1980.0,205,158,133,496
19158,Soviet Union,1988.0,174,81,111,366
19159,Soviet Union,1988.0,174,81,111,366
19160,Soviet Union,1988.0,174,81,111,366
19161,Soviet Union,1972.0,143,53,63,259
19162,Soviet Union,1980.0,205,158,133,496
19163,Soviet Union,1980.0,205,158,133,496
19164,Soviet Union,1956.0,94,51,61,206
19165,Soviet Union,1964.0,90,71,60,221
19166,Soviet Union,1988.0,174,81,111,366
19167,Soviet Union,1988.0,174,81,111,366
19168,Soviet Union,1972.0,143,53,63,259
19169,Soviet Union,1988.0,174,81,111,366
19170,Soviet Union,1964.0,90,71,60,221
19171,Soviet Union,1968.0,91,69,69,229
19172,Soviet Union,1968.0,91,69,69,229
19173,Soviet Union,1976.0,152,102,88,342
19174,Soviet Union,1976.0,152,102,88,342
19175,Soviet Union,1980.0,205,158,133,496
19176,Soviet Union,1980.0,205,158,133,496
19177,Soviet Union,1980.0,205,158,133,496
19178,Soviet Union,1980.0,205,158,133,496
19179,Soviet Union,1980.0,205,158,133,496
19180,Soviet Union,1980.0,205,158,133,496
19181,Soviet Union,1980.0,205,158,133,496
19182,Soviet Union,1980.0,205,158,133,496
19183,Soviet Union,1972.0,143,53,63,259
19184,Soviet Union,1976.0,152,102,88,342
19185,Soviet Union,1980.0,205,158,133,496
19186,Soviet Union,1988.0,174,81,111,366
19187,Soviet Union,1988.0,174,81,111,366
19188,Soviet Union,1968.0,91,69,69,229
19189,Soviet Union,1972.0,143,53,63,259
19190,Soviet Union,1980.0,205,158,133,496
19191,Soviet Union,1976.0,152,102,88,342
19192,Soviet Union,1980.0,205,158,133,496
19193,Soviet Union,1980.0,205,158,133,496
19194,Soviet Union,1972.0,143,53,63,259
19195,Soviet Union,1960.0,68,70,73,211
19196,Soviet Union,1976.0,152,102,88,342
19197,Soviet Union,1980.0,205,158,133,496
19198,Soviet Union,1980.0,205,158,133,496
19199,Soviet Union,1972.0,143,53,63,259
19200,Soviet Union,1984.0,29,15,12,56
19201,Soviet Union,1988.0,174,81,111,366
19202,Soviet Union,1964.0,90,71,60,221
19203,Soviet Union,1984.0,29,15,12,56
19204,Soviet Union,1976.0,152,102,88,342
19205,Soviet Union,1952.0,36,62,19,117
19206,Soviet Union,1988.0,174,81,111,366
19207,Soviet Union,1976.0,152,102,88,342
19208,Soviet Union,1972.0,143,53,63,259
19209,Soviet Union,1972.0,143,53,63,259
19210,Soviet Union,1960.0,68,70,73,211
19211,Soviet Union,1956.0,94,51,61,206
19212,Soviet Union,1980.0,205,158,133,496
19213,Soviet Union,1988.0,174,81,111,366
19214,Soviet Union,1972.0,143,53,63,259
19215,Soviet Union-2,1984.0,29,15,12,56
19216,Soviet Union,1980.0,205,158,133,496
19217,Soviet Union,1956.0,94,51,61,206
19218,Soviet Union,1956.0,94,51,61,206
19219,Soviet Union,1980.0,205,158,133,496
19220,Soviet Union,1988.0,174,81,111,366
19221,Soviet Union,1980.0,205,158,133,496
19222,Soviet Union,1964.0,90,71,60,221
19223,Soviet Union,1968.0,91,69,69,229
19224,Soviet Union,1976.0,152,102,88,342
19225,Soviet Union,1980.0,205,158,133,496
19226,Soviet Union,1960.0,68,70,73,211
19227,Soviet Union,1976.0,152,102,88,342
19228,Soviet Union,1980.0,205,158,133,496
19229,Soviet Union,1980.0,205,158,133,496
19230,Soviet Union,1980.0,205,158,133,496
19231,Soviet Union,1980.0,205,158,133,496
19232,Soviet Union,1984.0,29,15,12,56
19233,Soviet Union,1988.0,174,81,111,366
19234,Soviet Union,1960.0,68,70,73,211
19235,Soviet Union,1964.0,90,71,60,221
19236,Soviet Union,1964.0,90,71,60,221
19237,Soviet Union,1972.0,143,53,63,259
19238,Soviet Union,1976.0,152,102,88,342
19239,Soviet Union,1976.0,152,102,88,342
19240,Soviet Union,1980.0,205,158,133,496
19241,Soviet Union,1980.0,205,158,133,496
19242,Soviet Union,1980.0,205,158,133,496
19243,Soviet Union,1964.0,90,71,60,221
19244,Soviet Union,1968.0,91,69,69,229
19245,Soviet Union,1972.0,143,53,63,259
19246,Soviet Union,1984.0,29,15,12,56
19247,Soviet Union,1988.0,174,81,111,366
19248,Soviet Union,1976.0,152,102,88,342
19249,Soviet Union,1964.0,90,71,60,221
19250,Soviet Union,1988.0,174,81,111,366
19251,Soviet Union,1980.0,205,158,133,496
19252,Soviet Union,1980.0,205,158,133,496
19253,Soviet Union,1976.0,152,102,88,342
19254,Soviet Union,1976.0,152,102,88,342
19255,Soviet Union,1976.0,152,102,88,342
19256,Soviet Union,1980.0,205,158,133,496
19257,Soviet Union,1968.0,91,69,69,229
19258,Soviet Union,1968.0,91,69,69,229
19259,Soviet Union,1972.0,143,53,63,259
19260,Soviet Union,1988.0,174,81,111,366
19261,Soviet Union,1972.0,143,53,63,259
19262,Soviet Union,1976.0,152,102,88,342
19263,Soviet Union,1976.0,152,102,88,342
19264,Soviet Union,1952.0,36,62,19,117
19265,Soviet Union,1980.0,205,158,133,496
19266,Soviet Union,1976.0,152,102,88,342
19267,Soviet Union,1976.0,152,102,88,342
19268,Soviet Union,1988.0,174,81,111,366
19269,Soviet Union,1976.0,152,102,88,342
19270,Soviet Union,1968.0,91,69,69,229
19271,Soviet Union,1980.0,205,158,133,496
19272,Soviet Union,1988.0,174,81,111,366
19273,Soviet Union,1976.0,152,102,88,342
19274,Soviet Union,1980.0,205,158,133,496
19275,Soviet Union,1980.0,205,158,133,496
19276,Soviet Union,1984.0,29,15,12,56
19277,Soviet Union,1988.0,174,81,111,366
19278,Soviet Union,1960.0,68,70,73,211
19279,Soviet Union,1976.0,152,102,88,342
19280,Soviet Union,1980.0,205,158,133,496
19281,Soviet Union,1988.0,174,81,111,366
19282,Soviet Union,1952.0,36,62,19,117
19283,Soviet Union,1980.0,205,158,133,496
19284,Soviet Union,1988.0,174,81,111,366
19285,Soviet Union,1988.0,174,81,111,366
19286,Soviet Union,1960.0,68,70,73,211
19287,Soviet Union,1980.0,205,158,133,496
19288,Soviet Union,1980.0,205,158,133,496
19289,Soviet Union,1960.0,68,70,73,211
19290,Soviet Union,1964.0,90,71,60,221
19291,Soviet Union,1952.0,36,62,19,117
19292,Soviet Union,1956.0,94,51,61,206
19293,Soviet Union,1956.0,94,51,61,206
19294,Soviet Union,1980.0,205,158,133,496
19295,Soviet Union,1972.0,143,53,63,259
19296,Soviet Union,1988.0,174,81,111,366
19297,Soviet Union,1976.0,152,102,88,342
19298,Soviet Union,1980.0,205,158,133,496
19299,Soviet Union,1972.0,143,53,63,259
19300,Soviet Union,1980.0,205,158,133,496
19301,Soviet Union,1952.0,36,62,19,117
19302,Soviet Union,1964.0,90,71,60,221
19303,Soviet Union-1,1988.0,174,81,111,366
19304,Soviet Union-2,1968.0,91,69,69,229
19305,Soviet Union,1988.0,174,81,111,366
19306,Soviet Union,1960.0,68,70,73,211
19307,Soviet Union,1964.0,90,71,60,221
19308,Soviet Union,1968.0,91,69,69,229
19309,Soviet Union,1972.0,143,53,63,259
19310,Soviet Union,1972.0,143,53,63,259
19311,Soviet Union-1,1976.0,152,102,88,342
19312,Soviet Union,1960.0,68,70,73,211
19313,Soviet Union,1956.0,94,51,61,206
19314,Soviet Union,1960.0,68,70,73,211
19315,Soviet Union,1980.0,205,158,133,496
19316,Soviet Union,1964.0,90,71,60,221
19317,Soviet Union,1956.0,94,51,61,206
19318,Soviet Union,1960.0,68,70,73,211
19319,Soviet Union,1960.0,68,70,73,211
19320,Soviet Union,1960.0,68,70,73,211
19321,Soviet Union,1968.0,91,69,69,229
19322,Soviet Union,1960.0,68,70,73,211
19323,Soviet Union-1,1988.0,174,81,111,366
19324,Soviet Union,1980.0,205,158,133,496
19325,Soviet Union,1964.0,90,71,60,221
19326,Soviet Union,1964.0,90,71,60,221
19327,Soviet Union,1968.0,91,69,69,229
19328,Soviet Union,1980.0,205,158,133,496
19329,Soviet Union,1988.0,174,81,111,366
19330,Soviet Union,1956.0,94,51,61,206
19331,Soviet Union,1956.0,94,51,61,206
19332,Soviet Union,1960.0,68,70,73,211
19333,Soviet Union,1960.0,68,70,73,211
19334,Soviet Union,1964.0,90,71,60,221
19335,Soviet Union,1972.0,143,53,63,259
19336,Soviet Union,1972.0,143,53,63,259
19337,Soviet Union,1964.0,90,71,60,221
19338,Soviet Union,1960.0,68,70,73,211
19339,Soviet Union,1976.0,152,102,88,342
19340,Soviet Union,1988.0,174,81,111,366
19341,Soviet Union,1968.0,91,69,69,229
19342,Soviet Union,1972.0,143,53,63,259
19343,Soviet Union,1980.0,205,158,133,496
19344,Soviet Union,1968.0,91,69,69,229
19345,Soviet Union,1968.0,91,69,69,229
19346,Soviet Union,1952.0,36,62,19,117
19347,Soviet Union,1980.0,205,158,133,496
19348,Soviet Union,1956.0,94,51,61,206
19349,Soviet Union,1960.0,68,70,73,211
19350,Soviet Union,1960.0,68,70,73,211
19351,Soviet Union,1960.0,68,70,73,211
19352,Soviet Union,1964.0,90,71,60,221
19353,Soviet Union,1988.0,174,81,111,366
19354,Soviet Union,1980.0,205,158,133,496
19355,Soviet Union,1976.0,152,102,88,342
19356,Soviet Union,1968.0,91,69,69,229
19357,Soviet Union,1968.0,91,69,69,229
19358,Soviet Union,1988.0,174,81,111,366
19359,Soviet Union,1960.0,68,70,73,211
19360,Soviet Union,1960.0,68,70,73,211
19361,Soviet Union,1968.0,91,69,69,229
19362,Soviet Union,1956.0,94,51,61,206
19363,Soviet Union,1964.0,90,71,60,221
19364,Soviet Union,1960.0,68,70,73,211
19365,Soviet Union,1960.0,68,70,73,211
19366,Soviet Union,1980.0,205,158,133,496
19367,Soviet Union,1980.0,205,158,133,496
19368,Soviet Union,1976.0,152,102,88,342
19369,Soviet Union,1988.0,174,81,111,366
19370,Soviet Union,1960.0,68,70,73,211
19371,Soviet Union,1964.0,90,71,60,221
19372,Soviet Union,1968.0,91,69,69,229
19373,Soviet Union,1972.0,143,53,63,259
19374,Soviet Union,1988.0,174,81,111,366
19375,Soviet Union,1952.0,36,62,19,117
19376,Soviet Union,1952.0,36,62,19,117
19377,Soviet Union,1952.0,36,62,19,117
19378,Soviet Union,1952.0,36,62,19,117
19379,Soviet Union,1952.0,36,62,19,117
19380,Soviet Union,1952.0,36,62,19,117
19381,Soviet Union,1952.0,36,62,19,117
19382,Soviet Union,1980.0,205,158,133,496
19383,Soviet Union,1968.0,91,69,69,229
19384,Soviet Union,1964.0,90,71,60,221
19385,Soviet Union,1968.0,91,69,69,229
19386,Soviet Union,1988.0,174,81,111,366
19387,Soviet Union,1976.0,152,102,88,342
19388,Soviet Union,1988.0,174,81,111,366
19389,Soviet Union,1988.0,174,81,111,366
19390,Soviet Union,1964.0,90,71,60,221
19391,Soviet Union,1956.0,94,51,61,206
19392,Soviet Union,1968.0,91,69,69,229
19393,Soviet Union,1968.0,91,69,69,229
19394,Soviet Union,1968.0,91,69,69,229
19395,Soviet Union,1968.0,91,69,69,229
19396,Soviet Union,1956.0,94,51,61,206
19397,Soviet Union,1976.0,152,102,88,342
19398,Soviet Union,1968.0,91,69,69,229
19399,Soviet Union,1980.0,205,158,133,496
19400,Soviet Union,1968.0,91,69,69,229
19401,Soviet Union,1964.0,90,71,60,221
19402,Soviet Union,1980.0,205,158,133,496
19403,Soviet Union,1956.0,94,51,61,206
19404,Soviet Union,1976.0,152,102,88,342
19405,Soviet Union,1980.0,205,158,133,496
19406,Soviet Union,1972.0,143,53,63,259
19407,Soviet Union,1988.0,174,81,111,366
19408,Soviet Union,1964.0,90,71,60,221
19409,Soviet Union,1976.0,152,102,88,342
19410,Soviet Union,1964.0,90,71,60,221
19411,Soviet Union,1988.0,174,81,111,366
19412,Soviet Union,1980.0,205,158,133,496
19413,Soviet Union,1988.0,174,81,111,366
19414,Soviet Union,1976.0,152,102,88,342
19415,Soviet Union,1956.0,94,51,61,206
19416,Soviet Union,1956.0,94,51,61,206
19417,Soviet Union,1968.0,91,69,69,229
19418,Soviet Union,1956.0,94,51,61,206
19419,Soviet Union,1960.0,68,70,73,211
19420,Soviet Union,1964.0,90,71,60,221
19421,Soviet Union,1984.0,29,15,12,56
19422,Soviet Union,1980.0,205,158,133,496
19423,Soviet Union,1980.0,205,158,133,496
19424,Soviet Union,1980.0,205,158,133,496
19425,Soviet Union,1968.0,91,69,69,229
19426,Soviet Union,1988.0,174,81,111,366
19427,Soviet Union,1956.0,94,51,61,206
19428,Soviet Union,1952.0,36,62,19,117
19429,Soviet Union,1980.0,205,158,133,496
19430,Soviet Union,1952.0,36,62,19,117
19431,Soviet Union,1952.0,36,62,19,117
19432,Soviet Union,1960.0,68,70,73,211
19433,Soviet Union,1968.0,91,69,69,229
19434,Soviet Union,1988.0,174,81,111,366
19435,Soviet Union,1952.0,36,62,19,117
19436,Soviet Union,1956.0,94,51,61,206
19437,Soviet Union,1976.0,152,102,88,342
19438,Soviet Union,1988.0,174,81,111,366
19439,Soviet Union,1988.0,174,81,111,366
19440,Soviet Union,1964.0,90,71,60,221
19441,Soviet Union,1956.0,94,51,61,206
19442,Soviet Union,1960.0,68,70,73,211
19443,Soviet Union,1956.0,94,51,61,206
19444,Soviet Union,1972.0,143,53,63,259
19445,Soviet Union,1980.0,205,158,133,496
19446,Soviet Union,1956.0,94,51,61,206
19447,Soviet Union,1980.0,205,158,133,496
19448,Soviet Union,1980.0,205,158,133,496
19449,Soviet Union,1964.0,90,71,60,221
19450,Soviet Union,1964.0,90,71,60,221
19451,Soviet Union,1960.0,68,70,73,211
19452,Soviet Union,1960.0,68,70,73,211
19453,Soviet Union,1952.0,36,62,19,117
19454,Soviet Union,1952.0,36,62,19,117
19455,Soviet Union,1952.0,36,62,19,117
19456,Soviet Union,1960.0,68,70,73,211
19457,Soviet Union,1980.0,205,158,133,496
19458,Soviet Union,1956.0,94,51,61,206
19459,Soviet Union,1956.0,94,51,61,206
19460,Soviet Union,1960.0,68,70,73,211
19461,Soviet Union,1964.0,90,71,60,221
19462,Soviet Union,1968.0,91,69,69,229
19463,Soviet Union,1972.0,143,53,63,259
19464,Soviet Union,1964.0,90,71,60,221
19465,Soviet Union,1952.0,36,62,19,117
19466,Soviet Union,1988.0,174,81,111,366
19467,Soviet Union,1988.0,174,81,111,366
19468,Soviet Union,1964.0,90,71,60,221
19469,Soviet Union,1968.0,91,69,69,229
19470,Soviet Union,1976.0,152,102,88,342
19471,Soviet Union,1976.0,152,102,88,342
19472,Soviet Union,1980.0,205,158,133,496
19473,Soviet Union,1980.0,205,158,133,496
19474,Soviet Union,1960.0,68,70,73,211
19475,Soviet Union,1960.0,68,70,73,211
19476,Soviet Union,1972.0,143,53,63,259
19477,Soviet Union,1964.0,90,71,60,221
19478,Soviet Union,1968.0,91,69,69,229
19479,Soviet Union,1976.0,152,102,88,342
19480,Soviet Union,1980.0,205,158,133,496
19481,Soviet Union,1980.0,205,158,133,496
19482,Soviet Union,1988.0,174,81,111,366
19483,Soviet Union,1968.0,91,69,69,229
19484,Soviet Union,1968.0,91,69,69,229
19485,Soviet Union,1960.0,68,70,73,211
19486,Soviet Union,1988.0,174,81,111,366
19487,Soviet Union,1976.0,152,102,88,342
19488,Soviet Union,1980.0,205,158,133,496
19489,Soviet Union,1988.0,174,81,111,366
19490,Soviet Union-1,1980.0,205,158,133,496
19491,Soviet Union,1960.0,68,70,73,211
19492,Soviet Union,1980.0,205,158,133,496
19493,Soviet Union,1988.0,174,81,111,366
19494,Soviet Union,1960.0,68,70,73,211
19495,Soviet Union,1980.0,205,158,133,496
19496,Soviet Union,1984.0,29,15,12,56
19497,Soviet Union,1988.0,174,81,111,366
19498,Soviet Union,1980.0,205,158,133,496
19499,Soviet Union,1956.0,94,51,61,206
19500,Soviet Union,1984.0,29,15,12,56
19501,Soviet Union,1988.0,174,81,111,366
19502,Soviet Union,1964.0,90,71,60,221
19503,Soviet Union,1980.0,205,158,133,496
19504,Soviet Union,1980.0,205,158,133,496
19505,Soviet Union,1972.0,143,53,63,259
19506,Soviet Union,1976.0,152,102,88,342
19507,Soviet Union,1976.0,152,102,88,342
19508,Soviet Union,1980.0,205,158,133,496
19509,Soviet Union,1952.0,36,62,19,117
19510,Soviet Union,1988.0,174,81,111,366
19511,Soviet Union,1976.0,152,102,88,342
19512,Soviet Union,1960.0,68,70,73,211
19513,Soviet Union,1980.0,205,158,133,496
19514,Soviet Union,1988.0,174,81,111,366
19515,Soviet Union,1956.0,94,51,61,206
19516,Soviet Union,1988.0,174,81,111,366
19517,Soviet Union,1980.0,205,158,133,496
19518,Soviet Union,1988.0,174,81,111,366
19519,Soviet Union,1988.0,174,81,111,366
19520,Soviet Union,1956.0,94,51,61,206
19521,Soviet Union,1956.0,94,51,61,206
19522,Soviet Union,1988.0,174,81,111,366
19523,Soviet Union,1988.0,174,81,111,366
19524,Soviet Union,1972.0,143,53,63,259
19525,Soviet Union,1976.0,152,102,88,342
19526,Soviet Union,1980.0,205,158,133,496
19527,Soviet Union,1976.0,152,102,88,342
19528,Soviet Union,1980.0,205,158,133,496
19529,Soviet Union,1964.0,90,71,60,221
19530,Soviet Union,1972.0,143,53,63,259
19531,Soviet Union,1984.0,29,15,12,56
19532,Soviet Union,1984.0,29,15,12,56
19533,Soviet Union,1980.0,205,158,133,496
19534,Soviet Union,1956.0,94,51,61,206
19535,Soviet Union,1972.0,143,53,63,259
19536,Soviet Union,1952.0,36,62,19,117
19537,Soviet Union,1956.0,94,51,61,206
19538,Soviet Union,1964.0,90,71,60,221
19539,Soviet Union,1984.0,29,15,12,56
19540,Soviet Union,1988.0,174,81,111,366
19541,Soviet Union,1988.0,174,81,111,366
19542,Soviet Union,1964.0,90,71,60,221
19543,Soviet Union,1980.0,205,158,133,496
19544,Soviet Union,1988.0,174,81,111,366
19545,Soviet Union,1972.0,143,53,63,259
19546,Soviet Union,1964.0,90,71,60,221
19547,Soviet Union,1968.0,91,69,69,229
19548,Soviet Union,1968.0,91,69,69,229
19549,Soviet Union,1972.0,143,53,63,259
19550,Soviet Union,1964.0,90,71,60,221
19551,Soviet Union,1976.0,152,102,88,342
19552,Soviet Union,1980.0,205,158,133,496
19553,Soviet Union,1976.0,152,102,88,342
19554,Soviet Union,1976.0,152,102,88,342
19555,Soviet Union,1976.0,152,102,88,342
19556,Soviet Union,1976.0,152,102,88,342
19557,Soviet Union,1980.0,205,158,133,496
19558,Soviet Union,1980.0,205,158,133,496
19559,Soviet Union-1,1988.0,174,81,111,366
19560,Soviet Union-2,1988.0,174,81,111,366
19561,Soviet Union,1988.0,174,81,111,366
19562,Soviet Union,1980.0,205,158,133,496
19563,Soviet Union,1988.0,174,81,111,366
19564,Soviet Union,1972.0,143,53,63,259
19565,Soviet Union,1964.0,90,71,60,221
19566,Soviet Union,1968.0,91,69,69,229
19567,Soviet Union,1964.0,90,71,60,221
19568,Soviet Union,1964.0,90,71,60,221
19569,Soviet Union,1968.0,91,69,69,229
19570,Soviet Union,1968.0,91,69,69,229
19571,Soviet Union,1972.0,143,53,63,259
19572,Soviet Union,1988.0,174,81,111,366
19573,Soviet Union,1976.0,152,102,88,342
19574,Soviet Union,1980.0,205,158,133,496
19575,Soviet Union,1980.0,205,158,133,496
19576,Soviet Union,1980.0,205,158,133,496
19577,Soviet Union,1960.0,68,70,73,211
19578,Soviet Union,1964.0,90,71,60,221
19579,Soviet Union,1968.0,91,69,69,229
19580,Soviet Union,1968.0,91,69,69,229
19581,Soviet Union,1968.0,91,69,69,229
19582,Soviet Union,1972.0,143,53,63,259
19583,Soviet Union,1972.0,143,53,63,259
19584,Soviet Union,1972.0,143,53,63,259
19585,Soviet Union,1976.0,152,102,88,342
19586,Soviet Union-2,1984.0,29,15,12,56
19587,Soviet Union-2,1988.0,174,81,111,366
19588,Soviet Union,1976.0,152,102,88,342
19589,Soviet Union,1976.0,152,102,88,342
19590,Soviet Union,1976.0,152,102,88,342
19591,Soviet Union,1968.0,91,69,69,229
19592,Soviet Union,1956.0,94,51,61,206
19593,Soviet Union,1956.0,94,51,61,206
19594,Soviet Union,1956.0,94,51,61,206
19595,Soviet Union,1964.0,90,71,60,221
19596,Soviet Union,1956.0,94,51,61,206
19597,Soviet Union,1964.0,90,71,60,221
19598,Soviet Union,1964.0,90,71,60,221
19599,Soviet Union,1968.0,91,69,69,229
19600,Soviet Union,1968.0,91,69,69,229
19601,Soviet Union,1976.0,152,102,88,342
19602,Soviet Union,1980.0,205,158,133,496
19603,Soviet Union,1976.0,152,102,88,342
19604,Soviet Union,1976.0,152,102,88,342
19605,Soviet Union,1976.0,152,102,88,342
19606,Soviet Union,1964.0,90,71,60,221
19607,Soviet Union,1976.0,152,102,88,342
19608,Soviet Union,1988.0,174,81,111,366
19609,Soviet Union,1964.0,90,71,60,221
19610,Soviet Union,1988.0,174,81,111,366
19611,Soviet Union,1972.0,143,53,63,259
19612,Soviet Union,1976.0,152,102,88,342
19613,Soviet Union,1980.0,205,158,133,496
19614,Soviet Union,1960.0,68,70,73,211
19615,Soviet Union,1952.0,36,62,19,117
19616,Soviet Union,1988.0,174,81,111,366
19617,Soviet Union,1980.0,205,158,133,496
19618,Soviet Union,1980.0,205,158,133,496
19619,Soviet Union,1972.0,143,53,63,259
19620,Soviet Union,1980.0,205,158,133,496
19621,Soviet Union,1976.0,152,102,88,342
19622,Soviet Union,1972.0,143,53,63,259
19623,Soviet Union,1976.0,152,102,88,342
19624,Soviet Union,1980.0,205,158,133,496
19625,Soviet Union,1976.0,152,102,88,342
19626,Soviet Union,1980.0,205,158,133,496
19627,Soviet Union,1988.0,174,81,111,366
19628,Soviet Union,1952.0,36,62,19,117
19629,Soviet Union,1976.0,152,102,88,342
19630,Soviet Union,1964.0,90,71,60,221
19631,Soviet Union,1968.0,91,69,69,229
19632,Soviet Union,1956.0,94,51,61,206
19633,Soviet Union,1960.0,68,70,73,211
19634,Soviet Union,1976.0,152,102,88,342
19635,Soviet Union,1956.0,94,51,61,206
19636,Soviet Union,1976.0,152,102,88,342
19637,Soviet Union,1980.0,205,158,133,496
19638,Soviet Union,1980.0,205,158,133,496
19639,Soviet Union,1980.0,205,158,133,496
19640,Soviet Union,1980.0,205,158,133,496
19641,Soviet Union,1980.0,205,158,133,496
19642,Soviet Union,1972.0,143,53,63,259
19643,Soviet Union,1972.0,143,53,63,259
19644,Soviet Union,1972.0,143,53,63,259
19645,Soviet Union,1972.0,143,53,63,259
19646,Soviet Union,1976.0,152,102,88,342
19647,Soviet Union,1976.0,152,102,88,342
19648,Soviet Union,1988.0,174,81,111,366
19649,Soviet Union,1960.0,68,70,73,211
19650,Soviet Union,1972.0,143,53,63,259
19651,Soviet Union,1976.0,152,102,88,342
19652,Soviet Union,1952.0,36,62,19,117
19653,Soviet Union,1972.0,143,53,63,259
19654,Soviet Union,1968.0,91,69,69,229
19655,Soviet Union,1960.0,68,70,73,211
19656,Soviet Union,1964.0,90,71,60,221
19657,Soviet Union,1980.0,205,158,133,496
19658,Soviet Union,1976.0,152,102,88,342
19659,Soviet Union,1980.0,205,158,133,496
19660,Soviet Union,1980.0,205,158,133,496
19661,Soviet Union,1952.0,36,62,19,117
19662,Soviet Union,1952.0,36,62,19,117
19663,Soviet Union,1972.0,143,53,63,259
19664,Soviet Union,1976.0,152,102,88,342
19665,Soviet Union,1988.0,174,81,111,366
19666,Soviet Union,1988.0,174,81,111,366
19667,Soviet Union,1960.0,68,70,73,211
19668,Soviet Union,1976.0,152,102,88,342
19669,Soviet Union,1972.0,143,53,63,259
19670,Soviet Union,1976.0,152,102,88,342
19671,Soviet Union,1976.0,152,102,88,342
19672,Soviet Union,1980.0,205,158,133,496
19673,Soviet Union,1960.0,68,70,73,211
19674,Soviet Union,1960.0,68,70,73,211
19675,Soviet Union,1968.0,91,69,69,229
19676,Soviet Union,1968.0,91,69,69,229
19677,Soviet Union,1968.0,91,69,69,229
19678,Soviet Union,1960.0,68,70,73,211
19679,Soviet Union,1964.0,90,71,60,221
19680,Soviet Union,1968.0,91,69,69,229
19681,Soviet Union,1980.0,205,158,133,496
19682,Soviet Union,1988.0,174,81,111,366
19683,Soviet Union,1972.0,143,53,63,259
19684,Soviet Union,1952.0,36,62,19,117
19685,Soviet Union,1988.0,174,81,111,366
19686,Soviet Union,1968.0,91,69,69,229
19687,Soviet Union,1972.0,143,53,63,259
19688,Soviet Union,1964.0,90,71,60,221
19689,Soviet Union,1976.0,152,102,88,342
19690,Soviet Union,1984.0,29,15,12,56
19691,Soviet Union,1976.0,152,102,88,342
19692,Soviet Union,1988.0,174,81,111,366
19693,Soviet Union,1980.0,205,158,133,496
19694,Soviet Union,1980.0,205,158,133,496
19695,Soviet Union,1976.0,152,102,88,342
19696,Soviet Union,1976.0,152,102,88,342
19697,Soviet Union,1984.0,29,15,12,56
19698,Soviet Union,1988.0,174,81,111,366
19699,Soviet Union-1,1988.0,174,81,111,366
19700,Soviet Union-2,1988.0,174,81,111,366
19701,Soviet Union,1968.0,91,69,69,229
19702,Soviet Union,1980.0,205,158,133,496
19703,Soviet Union,1956.0,94,51,61,206
19704,Soviet Union,1956.0,94,51,61,206
19705,Soviet Union,1960.0,68,70,73,211
19706,Soviet Union,1960.0,68,70,73,211
19707,Soviet Union,1972.0,143,53,63,259
19708,Soviet Union,1980.0,205,158,133,496
19709,Soviet Union,1988.0,174,81,111,366
19710,Soviet Union,1980.0,205,158,133,496
19711,Soviet Union,1980.0,205,158,133,496
19712,Soviet Union,1980.0,205,158,133,496
19713,Soviet Union,1980.0,205,158,133,496
19714,Soviet Union,1972.0,143,53,63,259
19715,Soviet Union,1968.0,91,69,69,229
19716,Soviet Union,1972.0,143,53,63,259
19717,Soviet Union,1964.0,90,71,60,221
19718,Soviet Union,1988.0,174,81,111,366
19719,Soviet Union,1968.0,91,69,69,229
19720,Soviet Union,1976.0,152,102,88,342
19721,Soviet Union,1980.0,205,158,133,496
19722,Soviet Union,1988.0,174,81,111,366
19723,Soviet Union,1976.0,152,102,88,342
19724,Soviet Union,1980.0,205,158,133,496
19725,Soviet Union,1956.0,94,51,61,206
19726,Soviet Union,1960.0,68,70,73,211
19727,Soviet Union,1968.0,91,69,69,229
19728,Soviet Union,1980.0,205,158,133,496
19729,Soviet Union,1980.0,205,158,133,496
19730,Soviet Union,1964.0,90,71,60,221
19731,Soviet Union,1968.0,91,69,69,229
19732,Soviet Union,1968.0,91,69,69,229
19733,Soviet Union,1972.0,143,53,63,259
19734,Soviet Union,1956.0,94,51,61,206
19735,Soviet Union,1988.0,174,81,111,366
19736,Soviet Union,1976.0,152,102,88,342
19737,Soviet Union,1976.0,152,102,88,342
19738,Soviet Union,1976.0,152,102,88,342
19739,Soviet Union,1980.0,205,158,133,496
19740,Soviet Union,1980.0,205,158,133,496
19741,Soviet Union,1976.0,152,102,88,342
19742,Soviet Union,1976.0,152,102,88,342
19743,Soviet Union,1980.0,205,158,133,496
19744,Soviet Union,1956.0,94,51,61,206
19745,Soviet Union,1960.0,68,70,73,211
19746,Soviet Union,1964.0,90,71,60,221
19747,Soviet Union,1980.0,205,158,133,496
19748,Soviet Union,1984.0,29,15,12,56
19749,Soviet Union,1988.0,174,81,111,366
19750,Soviet Union,1960.0,68,70,73,211
19751,Soviet Union,1952.0,36,62,19,117
19752,Soviet Union,1976.0,152,102,88,342
19753,Soviet Union,1980.0,205,158,133,496
19754,Soviet Union,1980.0,205,158,133,496
19755,Soviet Union,1980.0,205,158,133,496
19756,Soviet Union,1988.0,174,81,111,366
19757,Soviet Union,1956.0,94,51,61,206
19758,Soviet Union,1976.0,152,102,88,342
19759,Soviet Union,1976.0,152,102,88,342
19760,Soviet Union,1980.0,205,158,133,496
19761,Soviet Union,1952.0,36,62,19,117
19762,Soviet Union,1980.0,205,158,133,496
19763,Soviet Union,1956.0,94,51,61,206
19764,Soviet Union,1960.0,68,70,73,211
19765,Soviet Union,1968.0,91,69,69,229
19766,Soviet Union,1968.0,91,69,69,229
19767,Soviet Union,1968.0,91,69,69,229
19768,Soviet Union,1968.0,91,69,69,229
19769,Soviet Union,1972.0,143,53,63,259
19770,Soviet Union,1972.0,143,53,63,259
19771,Soviet Union,1980.0,205,158,133,496
19772,Soviet Union,1980.0,205,158,133,496
19773,Soviet Union,1968.0,91,69,69,229
19774,Soviet Union,1968.0,91,69,69,229
19775,Soviet Union,1972.0,143,53,63,259
19776,Soviet Union,1972.0,143,53,63,259
19777,Soviet Union,1972.0,143,53,63,259
19778,Soviet Union,1976.0,152,102,88,342
19779,Soviet Union,1976.0,152,102,88,342
19780,Soviet Union,1980.0,205,158,133,496
19781,Soviet Union,1956.0,94,51,61,206
19782,Soviet Union,1976.0,152,102,88,342
19783,Soviet Union,1980.0,205,158,133,496
19784,Soviet Union,1968.0,91,69,69,229
19785,Soviet Union,1968.0,91,69,69,229
19786,Soviet Union,1972.0,143,53,63,259
19787,Soviet Union,1972.0,143,53,63,259
19788,Soviet Union,1952.0,36,62,19,117
19789,Soviet Union,1988.0,174,81,111,366
19790,Soviet Union,1980.0,205,158,133,496
19791,Soviet Union,1956.0,94,51,61,206
19792,Soviet Union,1960.0,68,70,73,211
19793,Soviet Union,1964.0,90,71,60,221
19794,Soviet Union,1968.0,91,69,69,229
19795,Soviet Union,1988.0,174,81,111,366
19796,Soviet Union,1988.0,174,81,111,366
19797,Soviet Union,1976.0,152,102,88,342
19798,Soviet Union,1960.0,68,70,73,211
19799,Soviet Union,1972.0,143,53,63,259
19800,Soviet Union,1976.0,152,102,88,342
19801,Soviet Union,1976.0,152,102,88,342
19802,Soviet Union,1980.0,205,158,133,496
19803,Soviet Union,1956.0,94,51,61,206
19804,Soviet Union,1956.0,94,51,61,206
19805,Soviet Union,1980.0,205,158,133,496
19806,Soviet Union,1956.0,94,51,61,206
19807,Soviet Union,1956.0,94,51,61,206
19808,Soviet Union,1964.0,90,71,60,221
19809,Soviet Union,1968.0,91,69,69,229
19810,Soviet Union,1972.0,143,53,63,259
19811,Soviet Union,1988.0,174,81,111,366
19812,Soviet Union,1960.0,68,70,73,211
19813,Soviet Union,1988.0,174,81,111,366
19814,Soviet Union,1972.0,143,53,63,259
19815,Soviet Union,1956.0,94,51,61,206
19816,Soviet Union,1956.0,94,51,61,206
19817,Soviet Union,1956.0,94,51,61,206
19818,Soviet Union,1976.0,152,102,88,342
19819,Soviet Union,1964.0,90,71,60,221
19820,Soviet Union,1976.0,152,102,88,342
19821,Soviet Union,1988.0,174,81,111,366
19822,Soviet Union,1956.0,94,51,61,206
19823,Soviet Union,1960.0,68,70,73,211
19824,Soviet Union,1980.0,205,158,133,496
19825,Soviet Union,1980.0,205,158,133,496
19826,Soviet Union,1972.0,143,53,63,259
19827,Soviet Union,1964.0,90,71,60,221
19828,Soviet Union,1988.0,174,81,111,366
19829,Soviet Union,1968.0,91,69,69,229
19830,Soviet Union,1964.0,90,71,60,221
19831,Soviet Union,1980.0,205,158,133,496
19832,Soviet Union,1956.0,94,51,61,206
19833,Soviet Union,1952.0,36,62,19,117
19834,Soviet Union,1960.0,68,70,73,211
19835,Soviet Union,1964.0,90,71,60,221
19836,Soviet Union,1968.0,91,69,69,229
19837,Soviet Union,1976.0,152,102,88,342
19838,Soviet Union,1980.0,205,158,133,496
19839,Soviet Union,1968.0,91,69,69,229
19840,Soviet Union,1988.0,174,81,111,366
19841,Soviet Union,1980.0,205,158,133,496
19842,Soviet Union,1988.0,174,81,111,366
19843,Soviet Union,1968.0,91,69,69,229
19844,Soviet Union,1972.0,143,53,63,259
19845,Soviet Union,1984.0,29,15,12,56
19846,Soviet Union,1988.0,174,81,111,366
19847,Soviet Union,1988.0,174,81,111,366
19848,Soviet Union,1980.0,205,158,133,496
19849,Soviet Union,1956.0,94,51,61,206
19850,Soviet Union,1956.0,94,51,61,206
19851,Soviet Union,1956.0,94,51,61,206
19852,Soviet Union,1956.0,94,51,61,206
19853,Soviet Union,1956.0,94,51,61,206
19854,Soviet Union,1956.0,94,51,61,206
19855,Soviet Union,1960.0,68,70,73,211
19856,Soviet Union,1960.0,68,70,73,211
19857,Soviet Union,1960.0,68,70,73,211
19858,Soviet Union,1960.0,68,70,73,211
19859,Soviet Union,1960.0,68,70,73,211
19860,Soviet Union,1960.0,68,70,73,211
19861,Soviet Union,1964.0,90,71,60,221
19862,Soviet Union,1964.0,90,71,60,221
19863,Soviet Union,1964.0,90,71,60,221
19864,Soviet Union,1964.0,90,71,60,221
19865,Soviet Union,1964.0,90,71,60,221
19866,Soviet Union,1964.0,90,71,60,221
19867,Soviet Union,1956.0,94,51,61,206
19868,Soviet Union,1988.0,174,81,111,366
19869,Soviet Union,1972.0,143,53,63,259
19870,Soviet Union,1972.0,143,53,63,259
19871,Soviet Union,1972.0,143,53,63,259
19872,Soviet Union,1972.0,143,53,63,259
19873,Soviet Union,1976.0,152,102,88,342
19874,Soviet Union,1980.0,205,158,133,496
19875,Soviet Union,1976.0,152,102,88,342
19876,Soviet Union,1968.0,91,69,69,229
19877,Soviet Union,1968.0,91,69,69,229
19878,Soviet Union,1972.0,143,53,63,259
19879,Soviet Union,1972.0,143,53,63,259
19880,Soviet Union,1976.0,152,102,88,342
19881,Soviet Union,1980.0,205,158,133,496
19882,Soviet Union,1980.0,205,158,133,496
19883,Soviet Union,1988.0,174,81,111,366
19884,Soviet Union,1988.0,174,81,111,366
19885,Soviet Union,1972.0,143,53,63,259
19886,Soviet Union,1952.0,36,62,19,117
19887,Soviet Union,1952.0,36,62,19,117
19888,Soviet Union,1960.0,68,70,73,211
19889,Soviet Union,1988.0,174,81,111,366
19890,Soviet Union,1964.0,90,71,60,221
19891,Soviet Union,1968.0,91,69,69,229
19892,Soviet Union,1972.0,143,53,63,259
19893,Soviet Union,1980.0,205,158,133,496
19894,Soviet Union,1988.0,174,81,111,366
19895,Soviet Union,1972.0,143,53,63,259
19896,Soviet Union,1980.0,205,158,133,496
19897,Soviet Union-1,1980.0,205,158,133,496
19898,Soviet Union,1980.0,205,158,133,496
19899,Soviet Union,1964.0,90,71,60,221
19900,Soviet Union,1968.0,91,69,69,229
19901,Soviet Union,1964.0,90,71,60,221
19902,Soviet Union,1964.0,90,71,60,221
19903,Soviet Union,1964.0,90,71,60,221
19904,Soviet Union,1964.0,90,71,60,221
19905,Soviet Union,1968.0,91,69,69,229
19906,Soviet Union,1988.0,174,81,111,366
19907,Soviet Union,1976.0,152,102,88,342
19908,Soviet Union,1952.0,36,62,19,117
19909,Soviet Union,1980.0,205,158,133,496
19910,Soviet Union,1988.0,174,81,111,366
19911,Soviet Union,1988.0,174,81,111,366
19912,Soviet Union,1988.0,174,81,111,366
19913,Soviet Union,1980.0,205,158,133,496
19914,Soviet Union,1972.0,143,53,63,259
19915,Soviet Union,1980.0,205,158,133,496
19916,Soviet Union,1976.0,152,102,88,342
19917,Soviet Union,1980.0,205,158,133,496
19918,Soviet Union,1964.0,90,71,60,221
19919,Soviet Union,1980.0,205,158,133,496
19920,Soviet Union,1960.0,68,70,73,211
19921,Soviet Union,1964.0,90,71,60,221
19922,Soviet Union,1988.0,174,81,111,366
19923,Soviet Union,1952.0,36,62,19,117
19924,Soviet Union,1960.0,68,70,73,211
19925,Soviet Union,1968.0,91,69,69,229
19926,Soviet Union,1980.0,205,158,133,496
19927,Soviet Union,1952.0,36,62,19,117
19928,Soviet Union,1980.0,205,158,133,496
19929,Soviet Union,1968.0,91,69,69,229
19930,Soviet Union,1976.0,152,102,88,342
19931,Soviet Union,1980.0,205,158,133,496
19932,Soviet Union,1988.0,174,81,111,366
19933,Soviet Union,1988.0,174,81,111,366
19934,Soviet Union,1952.0,36,62,19,117
19935,Soviet Union,1972.0,143,53,63,259
19936,Soviet Union,1972.0,143,53,63,259
19937,Soviet Union,1988.0,174,81,111,366
19938,Soviet Union,1980.0,205,158,133,496
19939,Soviet Union,1964.0,90,71,60,221
19940,Soviet Union,1980.0,205,158,133,496
19941,Soviet Union,1976.0,152,102,88,342
19942,Soviet Union,1980.0,205,158,133,496
19943,Soviet Union,1988.0,174,81,111,366
19944,Soviet Union,1976.0,152,102,88,342
19945,Soviet Union,1964.0,90,71,60,221
19946,Soviet Union,1968.0,91,69,69,229
19947,Soviet Union,1972.0,143,53,63,259
19948,Soviet Union,1980.0,205,158,133,496
19949,Soviet Union,1972.0,143,53,63,259
19950,Soviet Union,1976.0,152,102,88,342
19951,Soviet Union,1976.0,152,102,88,342
19952,Soviet Union,1960.0,68,70,73,211
19953,Soviet Union,1972.0,143,53,63,259
19954,Soviet Union,1980.0,205,158,133,496
19955,Soviet Union,1960.0,68,70,73,211
19956,Soviet Union,1960.0,68,70,73,211
19957,Soviet Union,1960.0,68,70,73,211
19958,Soviet Union,1964.0,90,71,60,221
19959,Soviet Union,1988.0,174,81,111,366
19960,Soviet Union,1988.0,174,81,111,366
19961,Soviet Union,1988.0,174,81,111,366
19962,Soviet Union,1988.0,174,81,111,366
19963,Soviet Union,1988.0,174,81,111,366
19964,Soviet Union,1960.0,68,70,73,211
19965,Soviet Union,1976.0,152,102,88,342
19966,Soviet Union,1980.0,205,158,133,496
19967,Soviet Union,1980.0,205,158,133,496
19968,Soviet Union-2,1984.0,29,15,12,56
19969,Soviet Union,1980.0,205,158,133,496
19970,Soviet Union,1984.0,29,15,12,56
19971,Soviet Union,1988.0,174,81,111,366
19972,Soviet Union,1976.0,152,102,88,342
19973,Soviet Union,1980.0,205,158,133,496
19974,Soviet Union,1988.0,174,81,111,366
19975,Soviet Union,1980.0,205,158,133,496
19976,Soviet Union,1980.0,205,158,133,496
19977,Soviet Union,1976.0,152,102,88,342
19978,Soviet Union,1980.0,205,158,133,496
19979,Soviet Union,1988.0,174,81,111,366
19980,Soviet Union,1972.0,143,53,63,259
19981,Soviet Union,1984.0,29,15,12,56
19982,Soviet Union,1984.0,29,15,12,56
19983,Soviet Union,1972.0,143,53,63,259
19984,Soviet Union,1976.0,152,102,88,342
19985,Soviet Union,1980.0,205,158,133,496
19986,Soviet Union,1988.0,174,81,111,366
19987,Soviet Union,1972.0,143,53,63,259
19988,Soviet Union,1968.0,91,69,69,229
19989,Soviet Union,1972.0,143,53,63,259
19990,Soviet Union,1988.0,174,81,111,366
19991,Soviet Union,1988.0,174,81,111,366
19992,Soviet Union,1980.0,205,158,133,496
19993,Soviet Union,1956.0,94,51,61,206
19994,Soviet Union,1956.0,94,51,61,206
19995,Soviet Union,1956.0,94,51,61,206
19996,Soviet Union,1956.0,94,51,61,206
19997,Soviet Union,1956.0,94,51,61,206
19998,Soviet Union,1964.0,90,71,60,221
19999,Soviet Union,1964.0,90,71,60,221
20000,Soviet Union,1968.0,91,69,69,229
20001,Soviet Union,1972.0,143,53,63,259
20002,Soviet Union,1976.0,152,102,88,342
20003,Soviet Union,1980.0,205,158,133,496
20004,Soviet Union,1988.0,174,81,111,366
20005,Soviet Union,1980.0,205,158,133,496
20006,Soviet Union,1988.0,174,81,111,366
20007,Soviet Union,1976.0,152,102,88,342
20008,Soviet Union,1976.0,152,102,88,342
20009,Soviet Union,1988.0,174,81,111,366
20010,Soviet Union,1988.0,174,81,111,366
20011,Soviet Union,1956.0,94,51,61,206
20012,Soviet Union,1976.0,152,102,88,342
20013,Soviet Union,1980.0,205,158,133,496
20014,Soviet Union,1980.0,205,158,133,496
20015,Soviet Union,1980.0,205,158,133,496
20016,Soviet Union,1980.0,205,158,133,496
20017,Soviet Union,1968.0,91,69,69,229
20018,Soviet Union,1956.0,94,51,61,206
20019,Soviet Union,1956.0,94,51,61,206
20020,Soviet Union,1980.0,205,158,133,496
20021,Soviet Union,1980.0,205,158,133,496
20022,Soviet Union,1968.0,91,69,69,229
20023,Soviet Union,1976.0,152,102,88,342
20024,Soviet Union,1964.0,90,71,60,221
20025,Soviet Union,1964.0,90,71,60,221
20026,Soviet Union,1968.0,91,69,69,229
20027,Soviet Union,1964.0,90,71,60,221
20028,Soviet Union,1968.0,91,69,69,229
20029,Soviet Union,1964.0,90,71,60,221
20030,Soviet Union,1980.0,205,158,133,496
20031,Soviet Union,1968.0,91,69,69,229
20032,Soviet Union,1968.0,91,69,69,229
20033,Soviet Union,1972.0,143,53,63,259
20034,Soviet Union,1972.0,143,53,63,259
20035,Soviet Union,1980.0,205,158,133,496
20036,Soviet Union,1988.0,174,81,111,366
20037,Soviet Union,1988.0,174,81,111,366
20038,Soviet Union,1952.0,36,62,19,117
20039,Soviet Union,1964.0,90,71,60,221
20040,Soviet Union,1968.0,91,69,69,229
20041,Soviet Union,1972.0,143,53,63,259
20042,Soviet Union,1988.0,174,81,111,366
20043,Soviet Union,1988.0,174,81,111,366
20044,Soviet Union,1988.0,174,81,111,366
20045,Soviet Union,1952.0,36,62,19,117
20046,Soviet Union,1964.0,90,71,60,221
20047,Soviet Union,1964.0,90,71,60,221
20048,Soviet Union,1964.0,90,71,60,221
20049,Soviet Union,1980.0,205,158,133,496
20050,Soviet Union,1960.0,68,70,73,211
20051,Soviet Union,1972.0,143,53,63,259
20052,Soviet Union,1964.0,90,71,60,221
20053,Soviet Union,1972.0,143,53,63,259
20054,Soviet Union,1980.0,205,158,133,496
20055,Soviet Union,1972.0,143,53,63,259
20056,Soviet Union,1988.0,174,81,111,366
20057,Soviet Union,1960.0,68,70,73,211
20058,Soviet Union,1964.0,90,71,60,221
20059,Soviet Union,1988.0,174,81,111,366
20060,Soviet Union,1972.0,143,53,63,259
20061,Soviet Union,1956.0,94,51,61,206
20062,Soviet Union,1964.0,90,71,60,221
20063,Soviet Union,1972.0,143,53,63,259
20064,Soviet Union,1976.0,152,102,88,342
20065,Soviet Union,1980.0,205,158,133,496
20066,Soviet Union,1956.0,94,51,61,206
20067,Soviet Union,1968.0,91,69,69,229
20068,Soviet Union,1976.0,152,102,88,342
20069,Soviet Union,1960.0,68,70,73,211
20070,Soviet Union,1988.0,174,81,111,366
20071,Soviet Union,1976.0,152,102,88,342
20072,Soviet Union,1976.0,152,102,88,342
20073,Soviet Union,1980.0,205,158,133,496
20074,Soviet Union,1952.0,36,62,19,117
20075,Soviet Union,1952.0,36,62,19,117
20076,Soviet Union,1952.0,36,62,19,117
20077,Soviet Union,1960.0,68,70,73,211
20078,Soviet Union,1976.0,152,102,88,342
20079,Soviet Union,1956.0,94,51,61,206
20080,Soviet Union,1960.0,68,70,73,211
20081,Soviet Union,1988.0,174,81,111,366
20082,Soviet Union-2,1976.0,152,102,88,342
20083,Soviet Union-2,1980.0,205,158,133,496
20084,Soviet Union,1964.0,90,71,60,221
20085,Soviet Union,1988.0,174,81,111,366
20086,Soviet Union,1976.0,152,102,88,342
20087,Soviet Union,1988.0,174,81,111,366
20088,Soviet Union,1980.0,205,158,133,496
20089,Soviet Union,1988.0,174,81,111,366
20090,Soviet Union,1980.0,205,158,133,496
20091,Soviet Union,1968.0,91,69,69,229
20092,Soviet Union,1972.0,143,53,63,259
20093,Soviet Union,1976.0,152,102,88,342
20094,Soviet Union,1980.0,205,158,133,496
20095,Soviet Union,1980.0,205,158,133,496
20096,Soviet Union,1980.0,205,158,133,496
20097,Soviet Union,1956.0,94,51,61,206
20098,Soviet Union,1952.0,36,62,19,117
20099,Soviet Union,1968.0,91,69,69,229
20100,Soviet Union,1972.0,143,53,63,259
20101,Soviet Union,1988.0,174,81,111,366
20102,Soviet Union,1952.0,36,62,19,117
20103,Soviet Union,1968.0,91,69,69,229
20104,Soviet Union-2,1976.0,152,102,88,342
20105,Soviet Union-2,1980.0,205,158,133,496
20106,Soviet Union,1964.0,90,71,60,221
20107,Soviet Union,1964.0,90,71,60,221
20108,Soviet Union,1976.0,152,102,88,342
20109,Soviet Union,1980.0,205,158,133,496
20110,Soviet Union,1988.0,174,81,111,366
20111,Soviet Union,1964.0,90,71,60,221
20112,Soviet Union,1968.0,91,69,69,229
20113,Soviet Union,1960.0,68,70,73,211
20114,Soviet Union,1976.0,152,102,88,342
20115,Soviet Union,1964.0,90,71,60,221
20116,Soviet Union,1968.0,91,69,69,229
20117,Soviet Union,1972.0,143,53,63,259
20118,Soviet Union,1988.0,174,81,111,366
20119,Soviet Union,1964.0,90,71,60,221
20120,Soviet Union,1988.0,174,81,111,366
20121,Soviet Union,1960.0,68,70,73,211
20122,Soviet Union,1988.0,174,81,111,366
20123,Soviet Union,1980.0,205,158,133,496
20124,Soviet Union,1980.0,205,158,133,496
20125,Soviet Union,1980.0,205,158,133,496
20126,Soviet Union,1988.0,174,81,111,366
20127,Soviet Union,1956.0,94,51,61,206
20128,Soviet Union,1960.0,68,70,73,211
20129,Soviet Union,1956.0,94,51,61,206
20130,Soviet Union,1960.0,68,70,73,211
20131,Soviet Union,1964.0,90,71,60,221
20132,Soviet Union,1972.0,143,53,63,259
20133,Soviet Union,1988.0,174,81,111,366
20134,Soviet Union,1956.0,94,51,61,206
20135,Soviet Union,1976.0,152,102,88,342
20136,Soviet Union,1952.0,36,62,19,117
20137,Soviet Union,1956.0,94,51,61,206
20138,Soviet Union,1956.0,94,51,61,206
20139,Soviet Union,1956.0,94,51,61,206
20140,Soviet Union,1956.0,94,51,61,206
20141,Soviet Union,1972.0,143,53,63,259
20142,Soviet Union,1976.0,152,102,88,342
20143,Soviet Union,1976.0,152,102,88,342
20144,Soviet Union,1956.0,94,51,61,206
20145,Soviet Union,1956.0,94,51,61,206
20146,Soviet Union,1956.0,94,51,61,206
20147,Soviet Union,1956.0,94,51,61,206
20148,Soviet Union,1960.0,68,70,73,211
20149,Soviet Union,1960.0,68,70,73,211
20150,Soviet Union,1960.0,68,70,73,211
20151,Soviet Union,1960.0,68,70,73,211
20152,Soviet Union,1956.0,94,51,61,206
20153,Soviet Union,1980.0,205,158,133,496
20154,Soviet Union,1988.0,174,81,111,366
20155,Soviet Union,1968.0,91,69,69,229
20156,Soviet Union,1976.0,152,102,88,342
20157,Soviet Union,1980.0,205,158,133,496
20158,Soviet Union,1980.0,205,158,133,496
20159,Soviet Union,1988.0,174,81,111,366
20160,Soviet Union,1968.0,91,69,69,229
20161,Soviet Union,1988.0,174,81,111,366
20162,Soviet Union,1964.0,90,71,60,221
20163,Soviet Union,1976.0,152,102,88,342
20164,Soviet Union,1980.0,205,158,133,496
20165,Soviet Union,1980.0,205,158,133,496
20166,Soviet Union,1984.0,29,15,12,56
20167,Soviet Union,1988.0,174,81,111,366
20168,Soviet Union,1988.0,174,81,111,366
20169,Soviet Union,1988.0,174,81,111,366
20170,Soviet Union,1988.0,174,81,111,366
20171,Soviet Union,1976.0,152,102,88,342
20172,Soviet Union,1976.0,152,102,88,342
20173,Soviet Union,1980.0,205,158,133,496
20174,Soviet Union,1976.0,152,102,88,342
20175,Soviet Union,1988.0,174,81,111,366
20176,Soviet Union,1980.0,205,158,133,496
20177,Soviet Union,1988.0,174,81,111,366
20178,Soviet Union,1972.0,143,53,63,259
20179,Soviet Union,1976.0,152,102,88,342
20180,Soviet Union,1980.0,205,158,133,496
20181,Soviet Union,1988.0,174,81,111,366
20182,Soviet Union,1988.0,174,81,111,366
20183,Soviet Union,1968.0,91,69,69,229
20184,Soviet Union,1972.0,143,53,63,259
20185,Soviet Union,1972.0,143,53,63,259
20186,Soviet Union,1976.0,152,102,88,342
20187,Soviet Union,1976.0,152,102,88,342
20188,Soviet Union,1980.0,205,158,133,496
20189,Soviet Union,1988.0,174,81,111,366
20190,Soviet Union,1988.0,174,81,111,366
20191,Soviet Union,1968.0,91,69,69,229
20192,Soviet Union,1988.0,174,81,111,366
20193,Soviet Union,1956.0,94,51,61,206
20194,Soviet Union,1976.0,152,102,88,342
20195,Soviet Union,1980.0,205,158,133,496
20196,Soviet Union,1956.0,94,51,61,206
20197,Soviet Union,1968.0,91,69,69,229
20198,Soviet Union,1956.0,94,51,61,206
20199,Soviet Union,1980.0,205,158,133,496
20200,Soviet Union,1980.0,205,158,133,496
20201,Soviet Union,1984.0,29,15,12,56
20202,Soviet Union,1960.0,68,70,73,211
20203,Soviet Union,1960.0,68,70,73,211
20204,Soviet Union,1956.0,94,51,61,206
20205,Soviet Union,1956.0,94,51,61,206
20206,Soviet Union,1976.0,152,102,88,342
20207,Soviet Union,1980.0,205,158,133,496
20208,Soviet Union,1988.0,174,81,111,366
20209,Soviet Union,1960.0,68,70,73,211
20210,Soviet Union,1952.0,36,62,19,117
20211,Soviet Union,1980.0,205,158,133,496
20212,Soviet Union,1988.0,174,81,111,366
20213,Soviet Union,1972.0,143,53,63,259
20214,Soviet Union,1956.0,94,51,61,206
20215,Soviet Union,1960.0,68,70,73,211
20216,Soviet Union,1964.0,90,71,60,221
20217,Soviet Union,1964.0,90,71,60,221
20218,Soviet Union,1976.0,152,102,88,342
20219,Soviet Union,1988.0,174,81,111,366
20220,Soviet Union,1960.0,68,70,73,211
20221,Soviet Union,1968.0,91,69,69,229
20222,Soviet Union,1968.0,91,69,69,229
20223,Soviet Union,1972.0,143,53,63,259
20224,Soviet Union,1976.0,152,102,88,342
20225,Soviet Union,1976.0,152,102,88,342
20226,Soviet Union,1980.0,205,158,133,496
20227,Soviet Union,1976.0,152,102,88,342
20228,Soviet Union,1980.0,205,158,133,496
20229,Soviet Union,1988.0,174,81,111,366
20230,Soviet Union,1956.0,94,51,61,206
20231,Soviet Union,1968.0,91,69,69,229
20232,Soviet Union,1968.0,91,69,69,229
20233,Soviet Union,1980.0,205,158,133,496
20234,Soviet Union,1980.0,205,158,133,496
20235,Soviet Union,1972.0,143,53,63,259
20236,Soviet Union,1972.0,143,53,63,259
20237,Soviet Union,1972.0,143,53,63,259
20238,Soviet Union,1988.0,174,81,111,366
20239,Soviet Union,1972.0,143,53,63,259
20240,Soviet Union,1968.0,91,69,69,229
20241,Soviet Union,1972.0,143,53,63,259
20242,Soviet Union,1972.0,143,53,63,259
20243,Soviet Union,1972.0,143,53,63,259
20244,Soviet Union,1976.0,152,102,88,342
20245,Soviet Union,1964.0,90,71,60,221
20246,Soviet Union,1976.0,152,102,88,342
20247,Soviet Union,1964.0,90,71,60,221
20248,Soviet Union,1964.0,90,71,60,221
20249,Soviet Union,1968.0,91,69,69,229
20250,Soviet Union,1972.0,143,53,63,259
20251,Soviet Union-2,1988.0,174,81,111,366
20252,Soviet Union,1980.0,205,158,133,496
20253,Soviet Union,1976.0,152,102,88,342
20254,Soviet Union,1980.0,205,158,133,496
20255,Soviet Union,1988.0,174,81,111,366
20256,Soviet Union,1980.0,205,158,133,496
20257,Soviet Union,1976.0,152,102,88,342
20258,Soviet Union,1980.0,205,158,133,496
20259,Soviet Union,1952.0,36,62,19,117
20260,Soviet Union,1956.0,94,51,61,206
20261,Soviet Union,1960.0,68,70,73,211
20262,Soviet Union,1960.0,68,70,73,211
20263,Soviet Union,1960.0,68,70,73,211
20264,Soviet Union-1,1976.0,152,102,88,342
20265,Soviet Union,1980.0,205,158,133,496
20266,Soviet Union,1980.0,205,158,133,496
20267,Soviet Union,1988.0,174,81,111,366
20268,Soviet Union,1976.0,152,102,88,342
20269,Soviet Union,1980.0,205,158,133,496
20270,Soviet Union,1968.0,91,69,69,229
20271,Soviet Union,1968.0,91,69,69,229
20272,Soviet Union,1988.0,174,81,111,366
20273,Soviet Union,1956.0,94,51,61,206
20274,Soviet Union,1956.0,94,51,61,206
20275,Soviet Union,1972.0,143,53,63,259
20276,Soviet Union,1980.0,205,158,133,496
20277,Soviet Union,1980.0,205,158,133,496
20278,Soviet Union,1980.0,205,158,133,496
20279,Soviet Union,1956.0,94,51,61,206
20280,Soviet Union,1968.0,91,69,69,229
20281,Soviet Union,1988.0,174,81,111,366
20282,Soviet Union,1972.0,143,53,63,259
20283,Soviet Union,1976.0,152,102,88,342
20284,Soviet Union,1972.0,143,53,63,259
20285,Soviet Union,1968.0,91,69,69,229
20286,Soviet Union,1972.0,143,53,63,259
20287,Soviet Union,1960.0,68,70,73,211
20288,Soviet Union,1980.0,205,158,133,496
20289,Soviet Union,1980.0,205,158,133,496
20290,Soviet Union,1968.0,91,69,69,229
20291,Soviet Union,1964.0,90,71,60,221
20292,Soviet Union,1980.0,205,158,133,496
20293,Soviet Union,1952.0,36,62,19,117
20294,Soviet Union,1976.0,152,102,88,342
20295,Soviet Union,1952.0,36,62,19,117
20296,Soviet Union,1980.0,205,158,133,496
20297,Soviet Union,1980.0,205,158,133,496
20298,Soviet Union,1984.0,29,15,12,56
20299,Soviet Union,1952.0,36,62,19,117
20300,Soviet Union,1956.0,94,51,61,206
20301,Soviet Union,1976.0,152,102,88,342
20302,Soviet Union,1980.0,205,158,133,496
20303,Soviet Union,1976.0,152,102,88,342
20304,Soviet Union,1976.0,152,102,88,342
20305,Soviet Union,1988.0,174,81,111,366
20306,Soviet Union,1960.0,68,70,73,211
20307,Soviet Union,1964.0,90,71,60,221
20308,Soviet Union,1968.0,91,69,69,229
20309,Soviet Union,1972.0,143,53,63,259
20310,Soviet Union,1968.0,91,69,69,229
20311,Soviet Union,1968.0,91,69,69,229
20312,Soviet Union,1968.0,91,69,69,229
20313,Soviet Union,1960.0,68,70,73,211
20314,Soviet Union,1964.0,90,71,60,221
20315,Soviet Union,1960.0,68,70,73,211
20316,Soviet Union,1988.0,174,81,111,366
20317,Soviet Union,1972.0,143,53,63,259
20318,Soviet Union,1976.0,152,102,88,342
20319,Soviet Union,1980.0,205,158,133,496
20320,Soviet Union,1956.0,94,51,61,206
20321,Soviet Union,1968.0,91,69,69,229
20322,Soviet Union,1972.0,143,53,63,259
20323,Soviet Union,1980.0,205,158,133,496
20324,Soviet Union,1980.0,205,158,133,496
20325,Soviet Union,1984.0,29,15,12,56
20326,Soviet Union,1984.0,29,15,12,56
20327,Soviet Union,1960.0,68,70,73,211
20328,Soviet Union,1964.0,90,71,60,221
20329,Soviet Union,1968.0,91,69,69,229
20330,Soviet Union,1972.0,143,53,63,259
20331,Soviet Union,1972.0,143,53,63,259
20332,Soviet Union,1980.0,205,158,133,496
20333,Soviet Union,1976.0,152,102,88,342
20334,Soviet Union,1972.0,143,53,63,259
20335,Soviet Union,1980.0,205,158,133,496
20336,Soviet Union,1980.0,205,158,133,496
20337,Soviet Union,1980.0,205,158,133,496
20338,Tornado,1960.0,68,70,73,211
20339,Soviet Union,1976.0,152,102,88,342
20340,Soviet Union,1988.0,174,81,111,366
20341,Soviet Union,1980.0,205,158,133,496
20342,Soviet Union,1956.0,94,51,61,206
20343,Soviet Union,1956.0,94,51,61,206
20344,Soviet Union,1972.0,143,53,63,259
20345,Soviet Union,1980.0,205,158,133,496
20346,Soviet Union,1980.0,205,158,133,496
20347,Soviet Union,1964.0,90,71,60,221
20348,Soviet Union,1980.0,205,158,133,496
20349,Soviet Union,1980.0,205,158,133,496
20350,Soviet Union,1988.0,174,81,111,366
20351,Soviet Union,1964.0,90,71,60,221
20352,Soviet Union,1968.0,91,69,69,229
20353,Soviet Union,1972.0,143,53,63,259
20354,Soviet Union,1976.0,152,102,88,342
20355,Soviet Union,1980.0,205,158,133,496
20356,Soviet Union,1968.0,91,69,69,229
20357,Soviet Union,1952.0,36,62,19,117
20358,Soviet Union,1988.0,174,81,111,366
20359,Soviet Union,1988.0,174,81,111,366
20360,Soviet Union,1988.0,174,81,111,366
20361,Soviet Union,1968.0,91,69,69,229
20362,Soviet Union,1972.0,143,53,63,259
20363,Soviet Union,1988.0,174,81,111,366
20364,Soviet Union-2,1984.0,29,15,12,56
20365,Soviet Union-2,1988.0,174,81,111,366
20366,Soviet Union,1988.0,174,81,111,366
20367,Soviet Union,1968.0,91,69,69,229
20368,Soviet Union,1972.0,143,53,63,259
20369,Soviet Union,1964.0,90,71,60,221
20370,Soviet Union,1968.0,91,69,69,229
20371,Soviet Union,1988.0,174,81,111,366
20372,Soviet Union,1964.0,90,71,60,221
20373,Soviet Union,1988.0,174,81,111,366
20374,Soviet Union,1980.0,205,158,133,496
20375,Soviet Union,1960.0,68,70,73,211
20376,Soviet Union,1960.0,68,70,73,211
20377,Soviet Union,1980.0,205,158,133,496
20378,Soviet Union,1980.0,205,158,133,496
20379,Soviet Union,1972.0,143,53,63,259
20380,Soviet Union,1988.0,174,81,111,366
20381,Soviet Union,1968.0,91,69,69,229
20382,Soviet Union,1980.0,205,158,133,496
20383,Soviet Union,1960.0,68,70,73,211
20384,Soviet Union,1964.0,90,71,60,221
20385,Soviet Union,1960.0,68,70,73,211
20386,Soviet Union,1960.0,68,70,73,211
20387,Soviet Union,1964.0,90,71,60,221
20388,Soviet Union,1964.0,90,71,60,221
20389,Soviet Union,1988.0,174,81,111,366
20390,Soviet Union,1988.0,174,81,111,366
20391,Soviet Union,1988.0,174,81,111,366
20392,Soviet Union,1980.0,205,158,133,496
20393,Soviet Union,1960.0,68,70,73,211
20394,Soviet Union,1964.0,90,71,60,221
20395,Soviet Union,1980.0,205,158,133,496
20396,Soviet Union,1980.0,205,158,133,496
20397,Soviet Union,1964.0,90,71,60,221
20398,Soviet Union,1956.0,94,51,61,206
20399,Soviet Union,1968.0,91,69,69,229
20400,Soviet Union,1988.0,174,81,111,366
20401,Soviet Union,1988.0,174,81,111,366
20402,Soviet Union,1976.0,152,102,88,342
20403,Soviet Union,1980.0,205,158,133,496
20404,Soviet Union-1,1964.0,90,71,60,221
20405,Soviet Union-1,1968.0,91,69,69,229
20406,Soviet Union,1980.0,205,158,133,496
20407,Soviet Union,1964.0,90,71,60,221
20408,Soviet Union,1968.0,91,69,69,229
20409,Soviet Union,1968.0,91,69,69,229
20410,Soviet Union,1972.0,143,53,63,259
20411,Soviet Union,1972.0,143,53,63,259
20412,Soviet Union,1960.0,68,70,73,211
20413,Soviet Union,1964.0,90,71,60,221
20414,Soviet Union,1960.0,68,70,73,211
20415,Soviet Union,1980.0,205,158,133,496
20416,Soviet Union,1980.0,205,158,133,496
20417,Soviet Union,1956.0,94,51,61,206
20418,Soviet Union,1960.0,68,70,73,211
20419,Soviet Union,1976.0,152,102,88,342
20420,Soviet Union,1952.0,36,62,19,117
20421,Soviet Union,1980.0,205,158,133,496
20422,Soviet Union,1968.0,91,69,69,229
20423,Soviet Union,1972.0,143,53,63,259
20424,Soviet Union,1972.0,143,53,63,259
20425,Soviet Union,1968.0,91,69,69,229
20426,Soviet Union,1980.0,205,158,133,496
20427,Soviet Union,1960.0,68,70,73,211
20428,Soviet Union,1980.0,205,158,133,496
20429,Soviet Union,1964.0,90,71,60,221
20430,Soviet Union,1968.0,91,69,69,229
20431,Soviet Union,1972.0,143,53,63,259
20432,Soviet Union,1980.0,205,158,133,496
20433,Soviet Union,1964.0,90,71,60,221
20434,Soviet Union,1968.0,91,69,69,229
20435,Soviet Union,1968.0,91,69,69,229
20436,Soviet Union,1972.0,143,53,63,259
20437,Soviet Union,1976.0,152,102,88,342
20438,Soviet Union,1980.0,205,158,133,496
20439,Soviet Union,1976.0,152,102,88,342
20440,Soviet Union,1976.0,152,102,88,342
20441,Soviet Union,1960.0,68,70,73,211
20442,Soviet Union,1960.0,68,70,73,211
20443,Soviet Union,1964.0,90,71,60,221
20444,Soviet Union,1956.0,94,51,61,206
20445,Soviet Union,1980.0,205,158,133,496
20446,Soviet Union,1988.0,174,81,111,366
20447,Soviet Union,1988.0,174,81,111,366
20448,Soviet Union,1980.0,205,158,133,496
20449,Soviet Union,1976.0,152,102,88,342
20450,Soviet Union,1972.0,143,53,63,259
20451,Soviet Union,1976.0,152,102,88,342
20452,Soviet Union,1988.0,174,81,111,366
20453,Soviet Union,1988.0,174,81,111,366
20454,Soviet Union,1988.0,174,81,111,366
20455,Soviet Union,1972.0,143,53,63,259
20456,Soviet Union,1976.0,152,102,88,342
20457,Soviet Union,1976.0,152,102,88,342
20458,Soviet Union,1980.0,205,158,133,496
20459,Soviet Union,1976.0,152,102,88,342
20460,Soviet Union,1980.0,205,158,133,496
20461,Soviet Union,1980.0,205,158,133,496
20462,Soviet Union,1980.0,205,158,133,496
20463,Soviet Union,1952.0,36,62,19,117
20464,Soviet Union-1,1972.0,143,53,63,259
20465,Soviet Union-1,1976.0,152,102,88,342
20466,Soviet Union-1,1980.0,205,158,133,496
20467,Soviet Union,1976.0,152,102,88,342
20468,Soviet Union,1980.0,205,158,133,496
20469,Soviet Union,1980.0,205,158,133,496
20470,Soviet Union,1956.0,94,51,61,206
20471,Soviet Union,1976.0,152,102,88,342
20472,Soviet Union,1980.0,205,158,133,496
20473,Soviet Union,1980.0,205,158,133,496
20474,Soviet Union,1988.0,174,81,111,366
20475,Soviet Union,1988.0,174,81,111,366
20476,Soviet Union,1972.0,143,53,63,259
20477,Soviet Union,1960.0,68,70,73,211
20478,Soviet Union,1976.0,152,102,88,342
20479,Soviet Union,1976.0,152,102,88,342
20480,Soviet Union,1980.0,205,158,133,496
20481,Soviet Union,1952.0,36,62,19,117
20482,Soviet Union,1956.0,94,51,61,206
20483,Soviet Union,1960.0,68,70,73,211
20484,Soviet Union,1968.0,91,69,69,229
20485,Soviet Union,1972.0,143,53,63,259
20486,Soviet Union,1964.0,90,71,60,221
20487,Soviet Union,1968.0,91,69,69,229
20488,Soviet Union,1972.0,143,53,63,259
20489,Soviet Union,1976.0,152,102,88,342
20490,Soviet Union,1964.0,90,71,60,221
20491,Soviet Union,1976.0,152,102,88,342
20492,Soviet Union,1976.0,152,102,88,342
20493,Soviet Union,1960.0,68,70,73,211
20494,Soviet Union,1960.0,68,70,73,211
20495,Soviet Union,1972.0,143,53,63,259
20496,Soviet Union,1960.0,68,70,73,211
20497,Soviet Union,1960.0,68,70,73,211
20498,Soviet Union,1976.0,152,102,88,342
20499,Soviet Union,1980.0,205,158,133,496
20500,Soviet Union,1988.0,174,81,111,366
20501,Soviet Union,1976.0,152,102,88,342
20502,Soviet Union,1980.0,205,158,133,496
20503,Soviet Union,1964.0,90,71,60,221
20504,Soviet Union,1968.0,91,69,69,229
20505,Soviet Union,1976.0,152,102,88,342
20506,Soviet Union,1976.0,152,102,88,342
20507,Soviet Union,1980.0,205,158,133,496
20508,Soviet Union,1988.0,174,81,111,366
20509,Soviet Union,1976.0,152,102,88,342
20510,Soviet Union,1980.0,205,158,133,496
20511,Soviet Union,1956.0,94,51,61,206
20512,Soviet Union,1976.0,152,102,88,342
20513,Soviet Union,1980.0,205,158,133,496
20514,Soviet Union,1960.0,68,70,73,211
20515,Soviet Union,1956.0,94,51,61,206
20516,Soviet Union,1964.0,90,71,60,221
20517,Soviet Union,1988.0,174,81,111,366
20518,Soviet Union,1964.0,90,71,60,221
20519,Soviet Union,1968.0,91,69,69,229
20520,Soviet Union,1972.0,143,53,63,259
20521,Soviet Union,1976.0,152,102,88,342
20522,Soviet Union,1956.0,94,51,61,206
20523,Soviet Union,1956.0,94,51,61,206
20524,Soviet Union,1964.0,90,71,60,221
20525,Soviet Union,1960.0,68,70,73,211
20526,Soviet Union,1972.0,143,53,63,259
20527,Soviet Union,1976.0,152,102,88,342
20528,Soviet Union,1972.0,143,53,63,259
20529,Soviet Union,1980.0,205,158,133,496
20530,Soviet Union,1972.0,143,53,63,259
20531,Soviet Union,1988.0,174,81,111,366
20532,Soviet Union,1972.0,143,53,63,259
20533,Soviet Union,1952.0,36,62,19,117
20534,Soviet Union,1980.0,205,158,133,496
20535,Soviet Union,1956.0,94,51,61,206
20536,Soviet Union,1964.0,90,71,60,221
20537,Soviet Union,1968.0,91,69,69,229
20538,Soviet Union,1972.0,143,53,63,259
20539,Soviet Union,1988.0,174,81,111,366
20540,Soviet Union,1952.0,36,62,19,117
20541,Soviet Union,1968.0,91,69,69,229
20542,Soviet Union,1972.0,143,53,63,259
20543,Soviet Union,1984.0,29,15,12,56
20544,Soviet Union,1956.0,94,51,61,206
20545,Soviet Union,1980.0,205,158,133,496
20546,Soviet Union,1980.0,205,158,133,496
20547,Soviet Union,1980.0,205,158,133,496
20548,Soviet Union,1988.0,174,81,111,366
20549,Soviet Union,1980.0,205,158,133,496
20550,Soviet Union,1980.0,205,158,133,496
20551,Soviet Union,1976.0,152,102,88,342
20552,Soviet Union,1980.0,205,158,133,496
20553,Soviet Union,1960.0,68,70,73,211
20554,Soviet Union,1988.0,174,81,111,366
20555,Soviet Union,1988.0,174,81,111,366
20556,Soviet Union,1988.0,174,81,111,366
20557,Soviet Union,1988.0,174,81,111,366
20558,Soviet Union,1988.0,174,81,111,366
20559,Soviet Union,1956.0,94,51,61,206
20560,Soviet Union,1972.0,143,53,63,259
20561,Soviet Union,1952.0,36,62,19,117
20562,Soviet Union,1952.0,36,62,19,117
20563,Soviet Union,1968.0,91,69,69,229
20564,Soviet Union,1972.0,143,53,63,259
20565,Soviet Union,1976.0,152,102,88,342
20566,Soviet Union,1980.0,205,158,133,496
20567,Soviet Union,1968.0,91,69,69,229
20568,Soviet Union,1988.0,174,81,111,366
20569,Soviet Union,1972.0,143,53,63,259
20570,Soviet Union,1988.0,174,81,111,366
20571,Soviet Union,1980.0,205,158,133,496
20572,Soviet Union,1968.0,91,69,69,229
20573,Soviet Union,1972.0,143,53,63,259
20574,Soviet Union,1968.0,91,69,69,229
20575,Soviet Union,1976.0,152,102,88,342
20576,Soviet Union,1980.0,205,158,133,496
20577,Soviet Union,1976.0,152,102,88,342
20578,Soviet Union,1976.0,152,102,88,342
20579,Soviet Union,1964.0,90,71,60,221
20580,Soviet Union,1988.0,174,81,111,366
20581,Soviet Union,1976.0,152,102,88,342
20582,Soviet Union,1980.0,205,158,133,496
20583,Soviet Union,1988.0,174,81,111,366
20584,Soviet Union,1952.0,36,62,19,117
20585,Soviet Union,1988.0,174,81,111,366
20586,Soviet Union,1980.0,205,158,133,496
20587,Soviet Union,1988.0,174,81,111,366
20588,Soviet Union-2,1984.0,29,15,12,56
20589,Soviet Union,1960.0,68,70,73,211
20590,Soviet Union,1968.0,91,69,69,229
20591,Soviet Union,1968.0,91,69,69,229
20592,Soviet Union,1976.0,152,102,88,342
20593,Soviet Union,1980.0,205,158,133,496
20594,Soviet Union,1976.0,152,102,88,342
20595,Soviet Union,1972.0,143,53,63,259
20596,Soviet Union,1972.0,143,53,63,259
20597,Soviet Union,1988.0,174,81,111,366
20598,Soviet Union,1976.0,152,102,88,342
20599,Soviet Union,1980.0,205,158,133,496
20600,Soviet Union,1988.0,174,81,111,366
20601,Soviet Union,1956.0,94,51,61,206
20602,Soviet Union,1960.0,68,70,73,211
20603,Soviet Union,1960.0,68,70,73,211
20604,Soviet Union,1964.0,90,71,60,221
20605,Soviet Union,1968.0,91,69,69,229
20606,Soviet Union,1980.0,205,158,133,496
20607,Soviet Union,1964.0,90,71,60,221
20608,Soviet Union,1980.0,205,158,133,496
20609,Soviet Union,1960.0,68,70,73,211
20610,Soviet Union,1960.0,68,70,73,211
20611,Soviet Union,1968.0,91,69,69,229
20612,Soviet Union,1980.0,205,158,133,496
20613,Soviet Union,1976.0,152,102,88,342
20614,Soviet Union,1956.0,94,51,61,206
20615,Soviet Union,1976.0,152,102,88,342
20616,Soviet Union,1972.0,143,53,63,259
20617,Soviet Union,1976.0,152,102,88,342
20618,Soviet Union,1980.0,205,158,133,496
20619,Soviet Union,1952.0,36,62,19,117
20620,Soviet Union,1952.0,36,62,19,117
20621,Soviet Union,1952.0,36,62,19,117
20622,Soviet Union,1952.0,36,62,19,117
20623,Soviet Union,1956.0,94,51,61,206
20624,Soviet Union,1956.0,94,51,61,206
20625,Soviet Union,1960.0,68,70,73,211
20626,Soviet Union,1960.0,68,70,73,211
20627,Soviet Union,1960.0,68,70,73,211
20628,Soviet Union,1960.0,68,70,73,211
20629,Soviet Union,1960.0,68,70,73,211
20630,Soviet Union,1960.0,68,70,73,211
20631,Soviet Union,1960.0,68,70,73,211
20632,Soviet Union,1964.0,90,71,60,221
20633,Soviet Union,1964.0,90,71,60,221
20634,Soviet Union,1964.0,90,71,60,221
20635,Soviet Union,1964.0,90,71,60,221
20636,Soviet Union,1956.0,94,51,61,206
20637,Soviet Union-2,1980.0,205,158,133,496
20638,Soviet Union,1976.0,152,102,88,342
20639,Soviet Union,1960.0,68,70,73,211
20640,Soviet Union,1952.0,36,62,19,117
20641,Soviet Union,1952.0,36,62,19,117
20642,Soviet Union,1988.0,174,81,111,366
20643,Soviet Union,1968.0,91,69,69,229
20644,Soviet Union,1972.0,143,53,63,259
20645,Soviet Union,1968.0,91,69,69,229
20646,Soviet Union,1968.0,91,69,69,229
20647,Soviet Union,1972.0,143,53,63,259
20648,Soviet Union,1980.0,205,158,133,496
20649,Soviet Union,1980.0,205,158,133,496
20650,Soviet Union,1980.0,205,158,133,496
20651,Soviet Union,1980.0,205,158,133,496
20652,Soviet Union,1980.0,205,158,133,496
20653,Soviet Union,1980.0,205,158,133,496
20654,Soviet Union,1980.0,205,158,133,496
20655,Soviet Union,1988.0,174,81,111,366
20656,Soviet Union,1964.0,90,71,60,221
20657,Soviet Union,1968.0,91,69,69,229
20658,Soviet Union,1988.0,174,81,111,366
20659,Soviet Union,1976.0,152,102,88,342
20660,Soviet Union,1956.0,94,51,61,206
20661,Soviet Union,1960.0,68,70,73,211
20662,Soviet Union,1980.0,205,158,133,496
20663,Soviet Union,1964.0,90,71,60,221
20664,Soviet Union,1952.0,36,62,19,117
20665,Soviet Union,1952.0,36,62,19,117
20666,Soviet Union,1976.0,152,102,88,342
20667,Soviet Union,1972.0,143,53,63,259
20668,Soviet Union,1980.0,205,158,133,496
20669,Soviet Union,1960.0,68,70,73,211
20670,Soviet Union,1980.0,205,158,133,496
20671,Soviet Union,1984.0,29,15,12,56
20672,Soviet Union,1976.0,152,102,88,342
20673,Soviet Union,1980.0,205,158,133,496
20674,Soviet Union,1988.0,174,81,111,366
20675,Soviet Union,1988.0,174,81,111,366
20676,Soviet Union,1988.0,174,81,111,366
20677,Soviet Union,1968.0,91,69,69,229
20678,Soviet Union,1972.0,143,53,63,259
20679,Soviet Union,1956.0,94,51,61,206
20680,Soviet Union,1988.0,174,81,111,366
20681,Soviet Union,1960.0,68,70,73,211
20682,Soviet Union,1964.0,90,71,60,221
20683,Soviet Union,1984.0,29,15,12,56
20684,Soviet Union,1988.0,174,81,111,366
20685,Soviet Union,1988.0,174,81,111,366
20686,Soviet Union,1956.0,94,51,61,206
20687,Soviet Union,1972.0,143,53,63,259
20688,Soviet Union,1976.0,152,102,88,342
20689,Soviet Union,1960.0,68,70,73,211
20690,Soviet Union,1972.0,143,53,63,259
20691,Soviet Union,1976.0,152,102,88,342
20692,Soviet Union,1976.0,152,102,88,342
20693,Soviet Union,1988.0,174,81,111,366
20694,Soviet Union,1988.0,174,81,111,366
20695,Soviet Union,1988.0,174,81,111,366
20696,Soviet Union,1988.0,174,81,111,366
20697,Tornado,1960.0,68,70,73,211
20698,Soviet Union,1988.0,174,81,111,366
20699,Soviet Union,1988.0,174,81,111,366
20700,Soviet Union,1956.0,94,51,61,206
20701,Soviet Union,1976.0,152,102,88,342
20702,Soviet Union,1980.0,205,158,133,496
20703,Soviet Union,1980.0,205,158,133,496
20704,Soviet Union,1964.0,90,71,60,221
20705,Soviet Union,1968.0,91,69,69,229
20706,Soviet Union,1976.0,152,102,88,342
20707,Soviet Union,1988.0,174,81,111,366
20708,Soviet Union,1956.0,94,51,61,206
20709,Soviet Union,1960.0,68,70,73,211
20710,Soviet Union,1980.0,205,158,133,496
20711,Soviet Union,1964.0,90,71,60,221
20712,Soviet Union,1976.0,152,102,88,342
20713,Soviet Union,1980.0,205,158,133,496
20714,Soviet Union,1968.0,91,69,69,229
20715,Soviet Union,1972.0,143,53,63,259
20716,Soviet Union,1972.0,143,53,63,259
20717,Soviet Union,1976.0,152,102,88,342
20718,Soviet Union,1976.0,152,102,88,342
20719,Soviet Union,1980.0,205,158,133,496
20720,Soviet Union,1976.0,152,102,88,342
20721,Soviet Union,1980.0,205,158,133,496
20722,Soviet Union,1988.0,174,81,111,366
20723,Soviet Union,1960.0,68,70,73,211
20724,Soviet Union,1972.0,143,53,63,259
20725,Soviet Union,1976.0,152,102,88,342
20726,Soviet Union,1972.0,143,53,63,259
20727,Soviet Union,1972.0,143,53,63,259
20728,Soviet Union,1956.0,94,51,61,206
20729,Soviet Union,1960.0,68,70,73,211
20730,Soviet Union,1960.0,68,70,73,211
20731,Soviet Union,1964.0,90,71,60,221
20732,Soviet Union,1968.0,91,69,69,229
20733,Soviet Union,1960.0,68,70,73,211
20734,Soviet Union,1980.0,205,158,133,496
20735,Soviet Union,1956.0,94,51,61,206
20736,Soviet Union,1960.0,68,70,73,211
20737,Soviet Union,1988.0,174,81,111,366
20738,Soviet Union,1960.0,68,70,73,211
20739,Soviet Union,1960.0,68,70,73,211
20740,Soviet Union,1964.0,90,71,60,221
20741,Soviet Union,1964.0,90,71,60,221
20742,Soviet Union,1964.0,90,71,60,221
20743,Soviet Union,1964.0,90,71,60,221
20744,Soviet Union,1972.0,143,53,63,259
20745,Soviet Union,1968.0,91,69,69,229
20746,Soviet Union,1980.0,205,158,133,496
20747,Soviet Union,1984.0,29,15,12,56
20748,Soviet Union,1988.0,174,81,111,366
20749,Soviet Union,1968.0,91,69,69,229
20750,Soviet Union,1976.0,152,102,88,342
20751,Soviet Union,1976.0,152,102,88,342
20752,Soviet Union,1976.0,152,102,88,342
20753,Soviet Union,1980.0,205,158,133,496
20754,Soviet Union,1980.0,205,158,133,496
20755,Soviet Union,1984.0,29,15,12,56
20756,Soviet Union,1984.0,29,15,12,56
20757,Soviet Union,1988.0,174,81,111,366
20758,Soviet Union,1988.0,174,81,111,366
20759,Soviet Union,1976.0,152,102,88,342
20760,Soviet Union,1976.0,152,102,88,342
20761,Soviet Union,1988.0,174,81,111,366
20762,Soviet Union,1988.0,174,81,111,366
20763,Soviet Union,1988.0,174,81,111,366
20764,Soviet Union-2,1972.0,143,53,63,259
20765,Soviet Union,1988.0,174,81,111,366
20766,Soviet Union,1968.0,91,69,69,229
20767,Soviet Union,1972.0,143,53,63,259
20768,Soviet Union,1976.0,152,102,88,342
20769,Soviet Union,1968.0,91,69,69,229
20770,Soviet Union,1988.0,174,81,111,366
20771,Soviet Union,1980.0,205,158,133,496
20772,Soviet Union,1980.0,205,158,133,496
20773,Soviet Union,1980.0,205,158,133,496
20774,Soviet Union,1972.0,143,53,63,259
20775,Soviet Union,1980.0,205,158,133,496
20776,Soviet Union,1988.0,174,81,111,366
20777,Soviet Union,1980.0,205,158,133,496
20778,Soviet Union,1960.0,68,70,73,211
20779,Soviet Union,1968.0,91,69,69,229
20780,Soviet Union,1976.0,152,102,88,342
20781,Soviet Union,1976.0,152,102,88,342
20782,Soviet Union,1972.0,143,53,63,259
20783,Soviet Union,1980.0,205,158,133,496
20784,Soviet Union,1956.0,94,51,61,206
20785,Soviet Union,1960.0,68,70,73,211
20786,Soviet Union,1976.0,152,102,88,342
20787,Soviet Union,1980.0,205,158,133,496
20788,Soviet Union,1956.0,94,51,61,206
20789,Soviet Union,1988.0,174,81,111,366
20790,Soviet Union,1964.0,90,71,60,221
20791,Soviet Union,1956.0,94,51,61,206
20792,Soviet Union,1980.0,205,158,133,496
20793,Soviet Union,1976.0,152,102,88,342
20794,Soviet Union,1956.0,94,51,61,206
20795,Soviet Union,1968.0,91,69,69,229
20796,Soviet Union,1972.0,143,53,63,259
20797,Soviet Union,1980.0,205,158,133,496
20798,Soviet Union,1984.0,29,15,12,56
20799,Soviet Union,1988.0,174,81,111,366
20800,Soviet Union,1980.0,205,158,133,496
20801,Soviet Union,1980.0,205,158,133,496
20802,Soviet Union,1964.0,90,71,60,221
20803,Soviet Union,1968.0,91,69,69,229
20804,Soviet Union,1972.0,143,53,63,259
20805,Soviet Union,1976.0,152,102,88,342
20806,Soviet Union,1984.0,29,15,12,56
20807,Soviet Union,1988.0,174,81,111,366
20808,Soviet Union,1960.0,68,70,73,211
20809,Soviet Union,1960.0,68,70,73,211
20810,Soviet Union,1964.0,90,71,60,221
20811,Soviet Union,1964.0,90,71,60,221
20812,Soviet Union,1956.0,94,51,61,206
20813,Soviet Union,1976.0,152,102,88,342
20814,Soviet Union,1964.0,90,71,60,221
20815,Soviet Union,1968.0,91,69,69,229
20816,Soviet Union,1980.0,205,158,133,496
20817,Soviet Union,1972.0,143,53,63,259
20818,Soviet Union,1956.0,94,51,61,206
20819,Soviet Union,1956.0,94,51,61,206
20820,Soviet Union,1952.0,36,62,19,117
20821,Soviet Union,1956.0,94,51,61,206
20822,Soviet Union,1972.0,143,53,63,259
20823,Soviet Union,1988.0,174,81,111,366
20824,Soviet Union,1980.0,205,158,133,496
20825,Soviet Union,1956.0,94,51,61,206
20826,Soviet Union,1980.0,205,158,133,496
20827,Soviet Union,1956.0,94,51,61,206
20828,Soviet Union,1956.0,94,51,61,206
20829,Soviet Union,1980.0,205,158,133,496
20830,Soviet Union,1980.0,205,158,133,496
20831,Soviet Union,1980.0,205,158,133,496
20832,Soviet Union,1952.0,36,62,19,117
20833,Soviet Union,1956.0,94,51,61,206
20834,Soviet Union,1976.0,152,102,88,342
20835,Soviet Union,1980.0,205,158,133,496
20836,Soviet Union,1980.0,205,158,133,496
20837,Soviet Union,1980.0,205,158,133,496
20838,Soviet Union,1968.0,91,69,69,229
20839,Soviet Union,1988.0,174,81,111,366
20840,Soviet Union-2,1972.0,143,53,63,259
20841,Soviet Union,1968.0,91,69,69,229
20842,Soviet Union,1968.0,91,69,69,229
20843,Soviet Union,1960.0,68,70,73,211
20844,Soviet Union,1964.0,90,71,60,221
20845,Soviet Union,1968.0,91,69,69,229
20846,Soviet Union,1988.0,174,81,111,366
20847,Soviet Union,1988.0,174,81,111,366
20848,Soviet Union,1980.0,205,158,133,496
20849,Soviet Union,1980.0,205,158,133,496
20850,Soviet Union,1960.0,68,70,73,211
20851,Soviet Union,1980.0,205,158,133,496
20852,Soviet Union,1980.0,205,158,133,496
20853,Soviet Union,1976.0,152,102,88,342
20854,Soviet Union,1968.0,91,69,69,229
20855,Soviet Union,1972.0,143,53,63,259
20856,Soviet Union,1968.0,91,69,69,229
20857,Soviet Union,1980.0,205,158,133,496
20858,Soviet Union,1988.0,174,81,111,366
20859,Soviet Union,1964.0,90,71,60,221
20860,Soviet Union,1960.0,68,70,73,211
20861,Soviet Union,1980.0,205,158,133,496
20862,Soviet Union,1988.0,174,81,111,366
20863,Soviet Union,1976.0,152,102,88,342
20864,Soviet Union,1980.0,205,158,133,496
20865,Soviet Union,1956.0,94,51,61,206
20866,Soviet Union,1972.0,143,53,63,259
20867,Soviet Union,1988.0,174,81,111,366
20868,Soviet Union,1960.0,68,70,73,211
20869,Soviet Union,1956.0,94,51,61,206
20870,Soviet Union,1972.0,143,53,63,259
20871,Soviet Union,1976.0,152,102,88,342
20872,Soviet Union,1988.0,174,81,111,366
20873,Soviet Union,1960.0,68,70,73,211
20874,Soviet Union,1964.0,90,71,60,221
20875,Soviet Union,1956.0,94,51,61,206
20876,Soviet Union,1956.0,94,51,61,206
20877,Soviet Union,1968.0,91,69,69,229
20878,Soviet Union,1980.0,205,158,133,496
20879,Soviet Union,1952.0,36,62,19,117
20880,Soviet Union,1988.0,174,81,111,366
20881,Soviet Union,1988.0,174,81,111,366
20882,Soviet Union,1964.0,90,71,60,221
20883,Soviet Union,1968.0,91,69,69,229
20884,Soviet Union,1968.0,91,69,69,229
20885,Soviet Union,1972.0,143,53,63,259
20886,Soviet Union,1976.0,152,102,88,342
20887,Soviet Union,1980.0,205,158,133,496
20888,Soviet Union,1988.0,174,81,111,366
20889,Soviet Union,1976.0,152,102,88,342
20890,Soviet Union,1988.0,174,81,111,366
20891,Soviet Union,1988.0,174,81,111,366
20892,Soviet Union,1988.0,174,81,111,366
20893,Soviet Union,1980.0,205,158,133,496
20894,Soviet Union,1968.0,91,69,69,229
20895,Soviet Union,1972.0,143,53,63,259
20896,Soviet Union,1956.0,94,51,61,206
20897,Soviet Union,1952.0,36,62,19,117
20898,Soviet Union,1956.0,94,51,61,206
20899,Soviet Union,1956.0,94,51,61,206
20900,Soviet Union,1956.0,94,51,61,206
20901,Soviet Union,1956.0,94,51,61,206
20902,Soviet Union,1960.0,68,70,73,211
20903,Soviet Union,1960.0,68,70,73,211
20904,Soviet Union,1960.0,68,70,73,211
20905,Soviet Union,1964.0,90,71,60,221
20906,Soviet Union,1964.0,90,71,60,221
20907,Soviet Union,1968.0,91,69,69,229
20908,Soviet Union,1968.0,91,69,69,229
20909,Soviet Union,1972.0,143,53,63,259
20910,Soviet Union,1980.0,205,158,133,496
20911,Soviet Union,1980.0,205,158,133,496
20912,Soviet Union,1988.0,174,81,111,366
20913,Soviet Union,1976.0,152,102,88,342
20914,Soviet Union,1980.0,205,158,133,496
20915,Soviet Union,1980.0,205,158,133,496
20916,Soviet Union,1980.0,205,158,133,496
20917,Soviet Union,1980.0,205,158,133,496
20918,Soviet Union,1988.0,174,81,111,366
20919,Soviet Union,1952.0,36,62,19,117
20920,Soviet Union,1988.0,174,81,111,366
20921,Soviet Union,1952.0,36,62,19,117
20922,Soviet Union,1956.0,94,51,61,206
20923,Soviet Union,1976.0,152,102,88,342
20924,Soviet Union,1980.0,205,158,133,496
20925,Soviet Union,1968.0,91,69,69,229
20926,Soviet Union-2,1988.0,174,81,111,366
20927,Soviet Union,1988.0,174,81,111,366
20928,Soviet Union,1988.0,174,81,111,366
20929,Soviet Union,1956.0,94,51,61,206
20930,Soviet Union,1976.0,152,102,88,342
20931,Soviet Union,1972.0,143,53,63,259
20932,Soviet Union,1988.0,174,81,111,366
20933,Soviet Union,1964.0,90,71,60,221
20934,Soviet Union,1956.0,94,51,61,206
20935,Soviet Union,1972.0,143,53,63,259
20936,Soviet Union,1976.0,152,102,88,342
20937,Soviet Union,1980.0,205,158,133,496
20938,Soviet Union,1984.0,29,15,12,56
20939,Soviet Union,1976.0,152,102,88,342
20940,Soviet Union,1964.0,90,71,60,221
20941,Soviet Union,1980.0,205,158,133,496
20942,Soviet Union,1956.0,94,51,61,206
20943,Soviet Union,1964.0,90,71,60,221
20944,Soviet Union,1964.0,90,71,60,221
20945,Soviet Union,1972.0,143,53,63,259
20946,Soviet Union,1952.0,36,62,19,117
20947,Soviet Union,1968.0,91,69,69,229
20948,Soviet Union,1972.0,143,53,63,259
20949,Soviet Union,1960.0,68,70,73,211
20950,Soviet Union,1980.0,205,158,133,496
20951,Soviet Union,1960.0,68,70,73,211
20952,Soviet Union,1956.0,94,51,61,206
20953,Soviet Union,1960.0,68,70,73,211
20954,Soviet Union,1972.0,143,53,63,259
20955,Soviet Union,1976.0,152,102,88,342
20956,Soviet Union,1988.0,174,81,111,366
20957,Soviet Union,1988.0,174,81,111,366
20958,Soviet Union,1976.0,152,102,88,342
20959,Soviet Union,1980.0,205,158,133,496
20960,Soviet Union,1988.0,174,81,111,366
20961,Soviet Union,1968.0,91,69,69,229
20962,Soviet Union,1972.0,143,53,63,259
20963,Soviet Union,1972.0,143,53,63,259
20964,Soviet Union,1972.0,143,53,63,259
20965,Soviet Union,1972.0,143,53,63,259
20966,Soviet Union,1976.0,152,102,88,342
20967,Soviet Union,1976.0,152,102,88,342
20968,Soviet Union,1976.0,152,102,88,342
20969,Soviet Union,1976.0,152,102,88,342
20970,Soviet Union,1988.0,174,81,111,366
20971,Soviet Union,1988.0,174,81,111,366
20972,Soviet Union,1980.0,205,158,133,496
20973,Soviet Union,1956.0,94,51,61,206
20974,Soviet Union,1988.0,174,81,111,366
20975,Soviet Union,1956.0,94,51,61,206
20976,Soviet Union,1952.0,36,62,19,117
20977,Soviet Union,1956.0,94,51,61,206
20978,Soviet Union,1960.0,68,70,73,211
20979,Soviet Union,1984.0,29,15,12,56
20980,Soviet Union,1988.0,174,81,111,366
20981,Soviet Union,1964.0,90,71,60,221
20982,Soviet Union,1972.0,143,53,63,259
20983,Soviet Union,1988.0,174,81,111,366
20984,Soviet Union,1952.0,36,62,19,117
20985,Soviet Union,1960.0,68,70,73,211
20986,Soviet Union,1980.0,205,158,133,496
20987,Soviet Union,1980.0,205,158,133,496
20988,Soviet Union,1956.0,94,51,61,206
20989,Soviet Union-1,1972.0,143,53,63,259
20990,Soviet Union,1976.0,152,102,88,342
20991,Soviet Union,1980.0,205,158,133,496
20992,Soviet Union,1988.0,174,81,111,366
20993,Soviet Union,1988.0,174,81,111,366
20994,Soviet Union,1988.0,174,81,111,366
20995,Soviet Union,1956.0,94,51,61,206
20996,Soviet Union,1960.0,68,70,73,211
20997,Soviet Union,1952.0,36,62,19,117
20998,Soviet Union,1952.0,36,62,19,117
20999,Soviet Union,1980.0,205,158,133,496
21000,Soviet Union,1980.0,205,158,133,496
21001,Soviet Union,1964.0,90,71,60,221
21002,Soviet Union,1964.0,90,71,60,221
21003,Soviet Union,1980.0,205,158,133,496
21004,Soviet Union,1956.0,94,51,61,206
21005,Soviet Union,1960.0,68,70,73,211
21006,Soviet Union,1964.0,90,71,60,221
21007,Soviet Union,1964.0,90,71,60,221
21008,Soviet Union,1952.0,36,62,19,117
21009,Soviet Union,1956.0,94,51,61,206
21010,Soviet Union,1960.0,68,70,73,211
21011,Soviet Union,1972.0,143,53,63,259
21012,Soviet Union,1980.0,205,158,133,496
21013,Soviet Union-1,1984.0,29,15,12,56
21014,Soviet Union-2,1988.0,174,81,111,366
21015,Soviet Union,1960.0,68,70,73,211
21016,Soviet Union,1988.0,174,81,111,366
21017,Soviet Union,1988.0,174,81,111,366
21018,Soviet Union,1980.0,205,158,133,496
21019,Soviet Union,1980.0,205,158,133,496
21020,Soviet Union,1960.0,68,70,73,211
21021,Soviet Union,1980.0,205,158,133,496
21022,Soviet Union,1980.0,205,158,133,496
21023,Soviet Union,1980.0,205,158,133,496
21024,Soviet Union,1988.0,174,81,111,366
21025,Soviet Union,1960.0,68,70,73,211
21026,Soviet Union,1984.0,29,15,12,56
21027,Soviet Union,1988.0,174,81,111,366
21028,Soviet Union,1988.0,174,81,111,366
21029,Soviet Union,1984.0,29,15,12,56
21030,Soviet Union-1,1984.0,29,15,12,56
21031,Soviet Union-2,1988.0,174,81,111,366
21032,Soviet Union,1972.0,143,53,63,259
21033,Soviet Union,1976.0,152,102,88,342
21034,Soviet Union,1980.0,205,158,133,496
21035,Soviet Union,1972.0,143,53,63,259
21036,Soviet Union,1952.0,36,62,19,117
21037,Soviet Union,1976.0,152,102,88,342
21038,Soviet Union,1968.0,91,69,69,229
21039,Soviet Union,1972.0,143,53,63,259
21040,Soviet Union,1972.0,143,53,63,259
21041,Soviet Union,1972.0,143,53,63,259
21042,Soviet Union,1988.0,174,81,111,366
21043,Soviet Union,1988.0,174,81,111,366
21044,Soviet Union,1964.0,90,71,60,221
21045,Soviet Union,1976.0,152,102,88,342
21046,Soviet Union,1988.0,174,81,111,366
21047,Soviet Union,1968.0,91,69,69,229
21048,Soviet Union,1972.0,143,53,63,259
21049,Soviet Union,1988.0,174,81,111,366
21050,Soviet Union,1976.0,152,102,88,342
21051,Soviet Union,1976.0,152,102,88,342
21052,Soviet Union,1968.0,91,69,69,229
21053,Soviet Union,1972.0,143,53,63,259
21054,Soviet Union,1976.0,152,102,88,342
21055,Soviet Union,1968.0,91,69,69,229
21056,Soviet Union,1980.0,205,158,133,496
21057,Soviet Union,1952.0,36,62,19,117
21058,Soviet Union,1960.0,68,70,73,211
21059,Soviet Union,1964.0,90,71,60,221
21060,Soviet Union,1964.0,90,71,60,221
21061,Soviet Union,1988.0,174,81,111,366
21062,Soviet Union,1988.0,174,81,111,366
21063,Soviet Union,1980.0,205,158,133,496
21064,Soviet Union,1964.0,90,71,60,221
21065,Soviet Union,1988.0,174,81,111,366
21066,Soviet Union,1980.0,205,158,133,496
21067,Soviet Union,1988.0,174,81,111,366
21068,Soviet Union,1960.0,68,70,73,211
21069,Soviet Union,1964.0,90,71,60,221
21070,Soviet Union,1968.0,91,69,69,229
21071,Soviet Union,1972.0,143,53,63,259
21072,Soviet Union,1952.0,36,62,19,117
21073,Soviet Union,1956.0,94,51,61,206
21074,Soviet Union,1960.0,68,70,73,211
21075,Soviet Union,1964.0,90,71,60,221
21076,Soviet Union,1964.0,90,71,60,221
21077,Soviet Union,1976.0,152,102,88,342
21078,Soviet Union,1968.0,91,69,69,229
21079,Soviet Union,1968.0,91,69,69,229
21080,Soviet Union,1968.0,91,69,69,229
21081,Soviet Union,1968.0,91,69,69,229
21082,Soviet Union,1968.0,91,69,69,229
21083,Soviet Union,1968.0,91,69,69,229
21084,Soviet Union,1968.0,91,69,69,229
21085,Soviet Union,1972.0,143,53,63,259
21086,Soviet Union,1972.0,143,53,63,259
21087,Soviet Union,1968.0,91,69,69,229
21088,Soviet Union,1968.0,91,69,69,229
21089,Soviet Union,1968.0,91,69,69,229
21090,Soviet Union,1968.0,91,69,69,229
21091,Soviet Union,1972.0,143,53,63,259
21092,Soviet Union,1964.0,90,71,60,221
21093,Soviet Union,1956.0,94,51,61,206
21094,Soviet Union,1960.0,68,70,73,211
21095,Soviet Union,1980.0,205,158,133,496
21096,Soviet Union,1976.0,152,102,88,342
21097,Soviet Union,1968.0,91,69,69,229
21098,Soviet Union,1972.0,143,53,63,259
21099,Soviet Union,1988.0,174,81,111,366
21100,Soviet Union,1972.0,143,53,63,259
21101,Soviet Union,1980.0,205,158,133,496
21102,Soviet Union,1988.0,174,81,111,366
21103,Soviet Union,1972.0,143,53,63,259
21104,Soviet Union,1976.0,152,102,88,342
21105,Soviet Union,1960.0,68,70,73,211
21106,Soviet Union,1964.0,90,71,60,221
21107,Soviet Union,1980.0,205,158,133,496
21108,Soviet Union,1988.0,174,81,111,366
21109,Soviet Union,1972.0,143,53,63,259
21110,Soviet Union,1980.0,205,158,133,496
21111,Soviet Union,1988.0,174,81,111,366
21112,Soviet Union,1988.0,174,81,111,366
21113,Soviet Union,1988.0,174,81,111,366
21114,Soviet Union,1972.0,143,53,63,259
21115,Soviet Union,1976.0,152,102,88,342
21116,Soviet Union,1956.0,94,51,61,206
21117,Soviet Union,1988.0,174,81,111,366
21118,Soviet Union,1972.0,143,53,63,259
21119,Soviet Union,1976.0,152,102,88,342
21120,Soviet Union,1964.0,90,71,60,221
21121,Soviet Union,1988.0,174,81,111,366
21122,Soviet Union,1964.0,90,71,60,221
21123,Soviet Union,1964.0,90,71,60,221
21124,Soviet Union,1956.0,94,51,61,206
21125,Soviet Union,1956.0,94,51,61,206
21126,Soviet Union,1988.0,174,81,111,366
21127,Soviet Union,1972.0,143,53,63,259
21128,Soviet Union,1980.0,205,158,133,496
21129,Soviet Union,1976.0,152,102,88,342
21130,Soviet Union,1976.0,152,102,88,342
21131,Soviet Union,1980.0,205,158,133,496
21132,Soviet Union,1952.0,36,62,19,117
21133,Soviet Union,1956.0,94,51,61,206
21134,Soviet Union,1964.0,90,71,60,221
21135,Soviet Union,1980.0,205,158,133,496
21136,Soviet Union,1976.0,152,102,88,342
21137,Soviet Union,1980.0,205,158,133,496
21138,Soviet Union,1976.0,152,102,88,342
21139,Soviet Union,1956.0,94,51,61,206
21140,Soviet Union,1956.0,94,51,61,206
21141,Soviet Union,1960.0,68,70,73,211
21142,Soviet Union,1960.0,68,70,73,211
21143,Soviet Union,1980.0,205,158,133,496
21144,Soviet Union,1988.0,174,81,111,366
21145,Soviet Union,1976.0,152,102,88,342
21146,Soviet Union,1988.0,174,81,111,366
21147,Soviet Union,1972.0,143,53,63,259
21148,Soviet Union,1988.0,174,81,111,366
21149,Soviet Union,1988.0,174,81,111,366
21150,Soviet Union,1960.0,68,70,73,211
21151,Soviet Union,1976.0,152,102,88,342
21152,Soviet Union,1956.0,94,51,61,206
21153,Soviet Union,1976.0,152,102,88,342
21154,Soviet Union,1976.0,152,102,88,342
21155,Soviet Union,1980.0,205,158,133,496
21156,Soviet Union,1976.0,152,102,88,342
21157,Soviet Union,1960.0,68,70,73,211
21158,Soviet Union,1960.0,68,70,73,211
21159,Soviet Union,1968.0,91,69,69,229
21160,Soviet Union,1972.0,143,53,63,259
21161,Soviet Union,1988.0,174,81,111,366
21162,Soviet Union,1980.0,205,158,133,496
21163,Soviet Union,1988.0,174,81,111,366
21164,Soviet Union,1976.0,152,102,88,342
21165,Soviet Union,1976.0,152,102,88,342
21166,Soviet Union,1980.0,205,158,133,496
21167,Soviet Union,1976.0,152,102,88,342
21168,Soviet Union,1980.0,205,158,133,496
21169,Soviet Union,1968.0,91,69,69,229
21170,Soviet Union,1972.0,143,53,63,259
21171,Soviet Union,1988.0,174,81,111,366
21172,Soviet Union,1980.0,205,158,133,496
21173,Soviet Union,1984.0,29,15,12,56
21174,Soviet Union,1984.0,29,15,12,56
21175,Soviet Union,1980.0,205,158,133,496
21176,Soviet Union,1972.0,143,53,63,259
21177,Soviet Union-1,1976.0,152,102,88,342
21178,Soviet Union-1,1980.0,205,158,133,496
21179,Soviet Union,1964.0,90,71,60,221
21180,Soviet Union,1964.0,90,71,60,221
21181,Soviet Union,1968.0,91,69,69,229
21182,Soviet Union,1976.0,152,102,88,342
21183,Soviet Union,1980.0,205,158,133,496
21184,Soviet Union,1988.0,174,81,111,366
21185,Soviet Union,1976.0,152,102,88,342
21186,Soviet Union,1980.0,205,158,133,496
21187,Soviet Union,1972.0,143,53,63,259
21188,Soviet Union,1964.0,90,71,60,221
21189,Soviet Union,1968.0,91,69,69,229
21190,Soviet Union,1968.0,91,69,69,229
21191,Soviet Union,1976.0,152,102,88,342
21192,Soviet Union,1980.0,205,158,133,496
21193,Soviet Union,1972.0,143,53,63,259
21194,Soviet Union,1976.0,152,102,88,342
21195,Soviet Union,1960.0,68,70,73,211
21196,Soviet Union,1960.0,68,70,73,211
21197,Soviet Union,1964.0,90,71,60,221
21198,Soviet Union,1980.0,205,158,133,496
21199,Soviet Union,1972.0,143,53,63,259
21200,Soviet Union,1988.0,174,81,111,366
21201,Soviet Union,1976.0,152,102,88,342
21202,Soviet Union,1980.0,205,158,133,496
21203,Soviet Union,1988.0,174,81,111,366
21204,Soviet Union,1976.0,152,102,88,342
21205,Soviet Union,1980.0,205,158,133,496
21206,Soviet Union,1972.0,143,53,63,259
21207,Soviet Union,1980.0,205,158,133,496
21208,Soviet Union-2,1968.0,91,69,69,229
21209,Soviet Union,1980.0,205,158,133,496
21210,Soviet Union,1988.0,174,81,111,366
21211,Soviet Union,1952.0,36,62,19,117
21212,Soviet Union,1956.0,94,51,61,206
21213,Soviet Union,1980.0,205,158,133,496
21214,Soviet Union,1988.0,174,81,111,366
21215,Soviet Union,1968.0,91,69,69,229
21216,Soviet Union,1972.0,143,53,63,259
21217,Soviet Union,1980.0,205,158,133,496
21218,Soviet Union,1980.0,205,158,133,496
21219,Soviet Union,1980.0,205,158,133,496
21220,Soviet Union,1984.0,29,15,12,56
21221,Soviet Union,1984.0,29,15,12,56
21222,Soviet Union,1968.0,91,69,69,229
21223,Soviet Union,1980.0,205,158,133,496
21224,Soviet Union,1980.0,205,158,133,496
21225,Soviet Union,1980.0,205,158,133,496
21226,Soviet Union,1976.0,152,102,88,342
21227,Soviet Union,1956.0,94,51,61,206
21228,Soviet Union,1960.0,68,70,73,211
21229,Soviet Union,1980.0,205,158,133,496
21230,Soviet Union,1976.0,152,102,88,342
21231,Soviet Union,1952.0,36,62,19,117
21232,Soviet Union,1956.0,94,51,61,206
21233,Soviet Union,1964.0,90,71,60,221
21234,Uzbekistan,2000.0,1,1,2,4
21235,Uzbekistan,2016.0,4,2,7,13
21236,Uzbekistan,2012.0,1,0,2,3
21237,Uzbekistan,1996.0,0,1,1,2
21238,Uzbekistan,1994.0,1,0,0,1
21239,Uzbekistan,2004.0,2,1,2,5
21240,Uzbekistan,2016.0,4,2,7,13
21241,Uzbekistan,2008.0,1,2,3,6
21242,Uzbekistan,2016.0,4,2,7,13
21243,Uzbekistan,2016.0,4,2,7,13
21244,Uzbekistan,2016.0,4,2,7,13
21245,Uzbekistan,2004.0,2,1,2,5
21246,Uzbekistan,2004.0,2,1,2,5
21247,Uzbekistan,2008.0,1,2,3,6
21248,Uzbekistan,2016.0,4,2,7,13
21249,Uzbekistan,2000.0,1,1,2,4
21250,Uzbekistan,2016.0,4,2,7,13
21251,Uzbekistan,2016.0,4,2,7,13
21252,Uzbekistan,2000.0,1,1,2,4
21253,Uzbekistan,2008.0,1,2,3,6
21254,Uzbekistan,2012.0,1,0,2,3
21255,Uzbekistan,2016.0,4,2,7,13
21256,Uzbekistan,2004.0,2,1,2,5
21257,Uzbekistan,2008.0,1,2,3,6
21258,Uzbekistan,2016.0,4,2,7,13
21259,Uzbekistan,2000.0,1,1,2,4
21260,Uzbekistan,2004.0,2,1,2,5
21261,Uzbekistan,2008.0,1,2,3,6
21262,Uzbekistan,2012.0,1,0,2,3
21263,Uzbekistan,2008.0,1,2,3,6
21264,Uzbekistan,2016.0,4,2,7,13
21265,Uzbekistan,1996.0,0,1,1,2
21266,Uzbekistan,2016.0,4,2,7,13
21267,Uzbekistan,2016.0,4,2,7,13
21268,Tajikistan,2008.0,0,1,1,2
21269,Tajikistan,2008.0,0,1,1,2
21270,Tajikistan,2012.0,0,0,1,1
21271,Tajikistan,2016.0,1,0,0,1
21272,Unified Team,1992.0,127,71,81,279
21273,Unified Team,1992.0,127,71,81,279
21274,Unified Team,1992.0,127,71,81,279
21275,Unified Team,1992.0,127,71,81,279
21276,Unified Team,1992.0,127,71,81,279
21277,Unified Team,1992.0,127,71,81,279
21278,Unified Team,1992.0,127,71,81,279
21279,Unified Team,1992.0,127,71,81,279
21280,Unified Team,1992.0,127,71,81,279
21281,Unified Team,1992.0,127,71,81,279
21282,Unified Team,1992.0,127,71,81,279
21283,Unified Team,1992.0,127,71,81,279
21284,Unified Team,1992.0,127,71,81,279
21285,Unified Team,1992.0,127,71,81,279
21286,Unified Team,1992.0,127,71,81,279
21287,Unified Team,1992.0,127,71,81,279
21288,Unified Team-2,1992.0,127,71,81,279
21289,Unified Team,1992.0,127,71,81,279
21290,Unified Team,1992.0,127,71,81,279
21291,Unified Team,1992.0,127,71,81,279
21292,Unified Team,1992.0,127,71,81,279
21293,Unified Team,1992.0,127,71,81,279
21294,Unified Team,1992.0,127,71,81,279
21295,Unified Team,1992.0,127,71,81,279
21296,Unified Team,1992.0,127,71,81,279
21297,Unified Team,1992.0,127,71,81,279
21298,Unified Team,1992.0,127,71,81,279
21299,Unified Team,1992.0,127,71,81,279
21300,Unified Team,1992.0,127,71,81,279
21301,Unified Team,1992.0,127,71,81,279
21302,Unified Team,1992.0,127,71,81,279
21303,Unified Team,1992.0,127,71,81,279
21304,Unified Team,1992.0,127,71,81,279
21305,Unified Team,1992.0,127,71,81,279
21306,Unified Team,1992.0,127,71,81,279
21307,Unified Team,1992.0,127,71,81,279
21308,Unified Team,1992.0,127,71,81,279
21309,Unified Team,1992.0,127,71,81,279
21310,Unified Team,1992.0,127,71,81,279
21311,Unified Team,1992.0,127,71,81,279
21312,Unified Team,1992.0,127,71,81,279
21313,Unified Team,1992.0,127,71,81,279
21314,Unified Team-1,1992.0,127,71,81,279
21315,Unified Team,1992.0,127,71,81,279
21316,Unified Team,1992.0,127,71,81,279
21317,Unified Team,1992.0,127,71,81,279
21318,Unified Team,1992.0,127,71,81,279
21319,Unified Team,1992.0,127,71,81,279
21320,Unified Team,1992.0,127,71,81,279
21321,Unified Team,1992.0,127,71,81,279
21322,Unified Team,1992.0,127,71,81,279
21323,Unified Team,1992.0,127,71,81,279
21324,Unified Team,1992.0,127,71,81,279
21325,Unified Team,1992.0,127,71,81,279
21326,Unified Team,1992.0,127,71,81,279
21327,Unified Team,1992.0,127,71,81,279
21328,Unified Team,1992.0,127,71,81,279
21329,Unified Team,1992.0,127,71,81,279
21330,Unified Team,1992.0,127,71,81,279
21331,Unified Team,1992.0,127,71,81,279
21332,Unified Team,1992.0,127,71,81,279
21333,Unified Team,1992.0,127,71,81,279
21334,Unified Team,1992.0,127,71,81,279
21335,Unified Team,1992.0,127,71,81,279
21336,Unified Team,1992.0,127,71,81,279
21337,Unified Team,1992.0,127,71,81,279
21338,Unified Team,1992.0,127,71,81,279
21339,Unified Team,1992.0,127,71,81,279
21340,Unified Team,1992.0,127,71,81,279
21341,Unified Team,1992.0,127,71,81,279
21342,Unified Team,1992.0,127,71,81,279
21343,Unified Team,1992.0,127,71,81,279
21344,Unified Team,1992.0,127,71,81,279
21345,Unified Team,1992.0,127,71,81,279
21346,Unified Team,1992.0,127,71,81,279
21347,Unified Team,1992.0,127,71,81,279
21348,Unified Team,1992.0,127,71,81,279
21349,Unified Team,1992.0,127,71,81,279
21350,Unified Team,1992.0,127,71,81,279
21351,Unified Team,1992.0,127,71,81,279
21352,Unified Team,1992.0,127,71,81,279
21353,Unified Team,1992.0,127,71,81,279
21354,Unified Team,1992.0,127,71,81,279
21355,Unified Team,1992.0,127,71,81,279
21356,Unified Team,1992.0,127,71,81,279
21357,Unified Team,1992.0,127,71,81,279
21358,Unified Team,1992.0,127,71,81,279
21359,Unified Team,1992.0,127,71,81,279
21360,Unified Team,1992.0,127,71,81,279
21361,Unified Team,1992.0,127,71,81,279
21362,Unified Team,1992.0,127,71,81,279
21363,Unified Team-1,1992.0,127,71,81,279
21364,Unified Team,1992.0,127,71,81,279
21365,Unified Team,1992.0,127,71,81,279
21366,Unified Team,1992.0,127,71,81,279
21367,Unified Team,1992.0,127,71,81,279
21368,Unified Team,1992.0,127,71,81,279
21369,Unified Team,1992.0,127,71,81,279
21370,Unified Team,1992.0,127,71,81,279
21371,Unified Team,1992.0,127,71,81,279
21372,Unified Team,1992.0,127,71,81,279
21373,Unified Team,1992.0,127,71,81,279
21374,Unified Team,1992.0,127,71,81,279
21375,Unified Team,1992.0,127,71,81,279
21376,Unified Team,1992.0,127,71,81,279
21377,Unified Team,1992.0,127,71,81,279
21378,Unified Team,1992.0,127,71,81,279
21379,Unified Team,1992.0,127,71,81,279
21380,Unified Team,1992.0,127,71,81,279
21381,Unified Team,1992.0,127,71,81,279
21382,Unified Team,1992.0,127,71,81,279
21383,Unified Team,1992.0,127,71,81,279
21384,Unified Team,1992.0,127,71,81,279
21385,Unified Team,1992.0,127,71,81,279
21386,Unified Team,1992.0,127,71,81,279
21387,Unified Team,1992.0,127,71,81,279
21388,Unified Team,1992.0,127,71,81,279
21389,Unified Team,1992.0,127,71,81,279
21390,Unified Team,1992.0,127,71,81,279
21391,Unified Team,1992.0,127,71,81,279
21392,Unified Team,1992.0,127,71,81,279
21393,Unified Team,1992.0,127,71,81,279
21394,Unified Team,1992.0,127,71,81,279
21395,Unified Team,1992.0,127,71,81,279
21396,Unified Team,1992.0,127,71,81,279
21397,Unified Team,1992.0,127,71,81,279
21398,Unified Team,1992.0,127,71,81,279
21399,Unified Team,1992.0,127,71,81,279
21400,Unified Team,1992.0,127,71,81,279
21401,Unified Team,1992.0,127,71,81,279
21402,Unified Team,1992.0,127,71,81,279
21403,Unified Team,1992.0,127,71,81,279
21404,Unified Team,1992.0,127,71,81,279
21405,Unified Team,1992.0,127,71,81,279
21406,Unified Team,1992.0,127,71,81,279
21407,Unified Team,1992.0,127,71,81,279
21408,Unified Team,1992.0,127,71,81,279
21409,Unified Team,1992.0,127,71,81,279
21410,Unified Team,1992.0,127,71,81,279
21411,Unified Team-1,1992.0,127,71,81,279
21412,Unified Team,1992.0,127,71,81,279
21413,Unified Team,1992.0,127,71,81,279
21414,Unified Team,1992.0,127,71,81,279
21415,Unified Team,1992.0,127,71,81,279
21416,Unified Team,1992.0,127,71,81,279
21417,Unified Team,1992.0,127,71,81,279
21418,Unified Team,1992.0,127,71,81,279
21419,Unified Team,1992.0,127,71,81,279
21420,Unified Team,1992.0,127,71,81,279
21421,Unified Team,1992.0,127,71,81,279
21422,Unified Team,1992.0,127,71,81,279
21423,Unified Team,1992.0,127,71,81,279
21424,Unified Team,1992.0,127,71,81,279
21425,Unified Team,1992.0,127,71,81,279
21426,Unified Team,1992.0,127,71,81,279
21427,Unified Team,1992.0,127,71,81,279
21428,Unified Team,1992.0,127,71,81,279
21429,Unified Team,1992.0,127,71,81,279
21430,Unified Team,1992.0,127,71,81,279
21431,Unified Team,1992.0,127,71,81,279
21432,Unified Team,1992.0,127,71,81,279
21433,Unified Team,1992.0,127,71,81,279
21434,Unified Team,1992.0,127,71,81,279
21435,Unified Team,1992.0,127,71,81,279
21436,Unified Team,1992.0,127,71,81,279
21437,Unified Team,1992.0,127,71,81,279
21438,Unified Team-2,1992.0,127,71,81,279
21439,Unified Team,1992.0,127,71,81,279
21440,Unified Team,1992.0,127,71,81,279
21441,Unified Team-1,1992.0,127,71,81,279
21442,Unified Team,1992.0,127,71,81,279
21443,Unified Team,1992.0,127,71,81,279
21444,Unified Team,1992.0,127,71,81,279
21445,Unified Team,1992.0,127,71,81,279
21446,Unified Team,1992.0,127,71,81,279
21447,Unified Team,1992.0,127,71,81,279
21448,Unified Team,1992.0,127,71,81,279
21449,Unified Team,1992.0,127,71,81,279
21450,Unified Team,1992.0,127,71,81,279
21451,Unified Team,1992.0,127,71,81,279
21452,Unified Team,1992.0,127,71,81,279
21453,Unified Team,1992.0,127,71,81,279
21454,Unified Team,1992.0,127,71,81,279
21455,Unified Team,1992.0,127,71,81,279
21456,Unified Team,1992.0,127,71,81,279
21457,Unified Team,1992.0,127,71,81,279
21458,Unified Team,1992.0,127,71,81,279
21459,Unified Team,1992.0,127,71,81,279
21460,Unified Team,1992.0,127,71,81,279
21461,Unified Team,1992.0,127,71,81,279
21462,Unified Team,1992.0,127,71,81,279
21463,Unified Team,1992.0,127,71,81,279
21464,Unified Team,1992.0,127,71,81,279
21465,Unified Team,1992.0,127,71,81,279
21466,Unified Team,1992.0,127,71,81,279
21467,Unified Team,1992.0,127,71,81,279
21468,Unified Team,1992.0,127,71,81,279
21469,Unified Team,1992.0,127,71,81,279
21470,Unified Team,1992.0,127,71,81,279
21471,Unified Team,1992.0,127,71,81,279
21472,Unified Team,1992.0,127,71,81,279
21473,Unified Team,1992.0,127,71,81,279
21474,Unified Team,1992.0,127,71,81,279
21475,Unified Team,1992.0,127,71,81,279
21476,Unified Team,1992.0,127,71,81,279
21477,Unified Team,1992.0,127,71,81,279
21478,Unified Team,1992.0,127,71,81,279
21479,Unified Team,1992.0,127,71,81,279
21480,Unified Team,1992.0,127,71,81,279
21481,Unified Team,1992.0,127,71,81,279
21482,Unified Team,1992.0,127,71,81,279
21483,Unified Team,1992.0,127,71,81,279
21484,Unified Team,1992.0,127,71,81,279
21485,Unified Team,1992.0,127,71,81,279
21486,Unified Team,1992.0,127,71,81,279
21487,Unified Team,1992.0,127,71,81,279
21488,Unified Team,1992.0,127,71,81,279
21489,Unified Team,1992.0,127,71,81,279
21490,Unified Team,1992.0,127,71,81,279
21491,Unified Team,1992.0,127,71,81,279
21492,Unified Team,1992.0,127,71,81,279
21493,Unified Team,1992.0,127,71,81,279
21494,Unified Team,1992.0,127,71,81,279
21495,Unified Team,1992.0,127,71,81,279
21496,Unified Team,1992.0,127,71,81,279
21497,Unified Team,1992.0,127,71,81,279
21498,Unified Team,1992.0,127,71,81,279
21499,Unified Team,1992.0,127,71,81,279
21500,Unified Team,1992.0,127,71,81,279
21501,Unified Team,1992.0,127,71,81,279
21502,Unified Team,1992.0,127,71,81,279
21503,Unified Team,1992.0,127,71,81,279
21504,Unified Team,1992.0,127,71,81,279
21505,Unified Team,1992.0,127,71,81,279
21506,Unified Team,1992.0,127,71,81,279
21507,Unified Team,1992.0,127,71,81,279
21508,Unified Team,1992.0,127,71,81,279
21509,Unified Team,1992.0,127,71,81,279
21510,Unified Team,1992.0,127,71,81,279
21511,Unified Team,1992.0,127,71,81,279
21512,Unified Team,1992.0,127,71,81,279
21513,Unified Team,1992.0,127,71,81,279
21514,Unified Team-2,1992.0,127,71,81,279
21515,Unified Team,1992.0,127,71,81,279
21516,Unified Team,1992.0,127,71,81,279
21517,Unified Team,1992.0,127,71,81,279
21518,Unified Team,1992.0,127,71,81,279
21519,Unified Team,1992.0,127,71,81,279
21520,Unified Team,1992.0,127,71,81,279
21521,Unified Team,1992.0,127,71,81,279
21522,Unified Team,1992.0,127,71,81,279
21523,Unified Team,1992.0,127,71,81,279
21524,Unified Team,1992.0,127,71,81,279
21525,Unified Team,1992.0,127,71,81,279
21526,Unified Team,1992.0,127,71,81,279
21527,Unified Team,1992.0,127,71,81,279
21528,Unified Team,1992.0,127,71,81,279
21529,Unified Team,1992.0,127,71,81,279
21530,Unified Team,1992.0,127,71,81,279
21531,Unified Team,1992.0,127,71,81,279
21532,Unified Team,1992.0,127,71,81,279
21533,Unified Team,1992.0,127,71,81,279
21534,Unified Team,1992.0,127,71,81,279
21535,Unified Team,1992.0,127,71,81,279
21536,Unified Team,1992.0,127,71,81,279
21537,Unified Team,1992.0,127,71,81,279
21538,Unified Team,1992.0,127,71,81,279
21539,Unified Team,1992.0,127,71,81,279
21540,Unified Team,1992.0,127,71,81,279
21541,Unified Team,1992.0,127,71,81,279
21542,Unified Team,1992.0,127,71,81,279
21543,Unified Team,1992.0,127,71,81,279
21544,Unified Team,1992.0,127,71,81,279
21545,Unified Team,1992.0,127,71,81,279
21546,Unified Team,1992.0,127,71,81,279
21547,Unified Team-2,1992.0,127,71,81,279
21548,Unified Team,1992.0,127,71,81,279
21549,Unified Team,1992.0,127,71,81,279
21550,Unified Team,1992.0,127,71,81,279
21551,Japan,1994.0,3,5,2,10
21552,Japan,1964.0,32,5,25,62
21553,Japan,1956.0,4,16,5,25
21554,Japan,1956.0,4,16,5,25
21555,Japan,1960.0,9,10,12,31
21556,Japan,1960.0,9,10,12,31
21557,Japan,1992.0,6,10,43,59
21558,Japan,2004.0,21,20,52,93
21559,Japan,1984.0,10,9,31,50
21560,Japan,1992.0,6,10,43,59
21561,Japan,1992.0,6,10,43,59
21562,Japan,1976.0,25,6,10,41
21563,Japan,2012.0,7,44,33,84
21564,Japan,2000.0,5,31,8,44
21565,Japan,2004.0,21,20,52,93
21566,Japan,2004.0,21,20,52,93
21567,Japan,1972.0,30,20,9,59
21568,Japan,1972.0,30,20,9,59
21569,Japan,2016.0,17,13,34,64
21570,Japan,1976.0,25,6,10,41
21571,Japan,1928.0,2,6,1,9
21572,Japan,1936.0,9,4,10,23
21573,Japan,1936.0,9,4,10,23
21574,Japan,2006.0,1,0,0,1
21575,Japan,2012.0,7,44,33,84
21576,Japan,1976.0,25,6,10,41
21577,Japan,1992.0,6,10,43,59
21578,Japan,1996.0,3,26,13,42
21579,Japan,2010.0,0,5,2,7
21580,Japan,2008.0,23,15,13,51
21581,Japan,2012.0,7,44,33,84
21582,Japan,2016.0,17,13,34,64
21583,Japan,2016.0,17,13,34,64
21584,Japan,2012.0,7,44,33,84
21585,Japan,1992.0,6,10,43,59
21586,Japan,1976.0,25,6,10,41
21587,Japan,1964.0,32,5,25,62
21588,Japan,2016.0,17,13,34,64
21589,Japan,2012.0,7,44,33,84
21590,Japan,2012.0,7,44,33,84
21591,Japan,2016.0,17,13,34,64
21592,Japan,2000.0,5,31,8,44
21593,Japan,1984.0,10,9,31,50
21594,Japan,2016.0,17,13,34,64
21595,Japan,2008.0,23,15,13,51
21596,Japan,1996.0,3,26,13,42
21597,Japan,1976.0,25,6,10,41
21598,Japan,1960.0,9,10,12,31
21599,Japan,1964.0,32,5,25,62
21600,Japan,1964.0,32,5,25,62
21601,Japan,1964.0,32,5,25,62
21602,Japan,1964.0,32,5,25,62
21603,Japan,1968.0,16,25,22,63
21604,Japan,1968.0,16,25,22,63
21605,Japan,1984.0,10,9,31,50
21606,Japan-1,2012.0,7,44,33,84
21607,Japan,1996.0,3,26,13,42
21608,Japan,2000.0,5,31,8,44
21609,Japan,2008.0,23,15,13,51
21610,Japan,2012.0,7,44,33,84
21611,Japan,2000.0,5,31,8,44
21612,Japan,2004.0,21,20,52,93
21613,Japan,2004.0,21,20,52,93
21614,Japan,1968.0,16,25,22,63
21615,Japan,2008.0,23,15,13,51
21616,Japan,1976.0,25,6,10,41
21617,Japan,1960.0,9,10,12,31
21618,Japan,1964.0,32,5,25,62
21619,Japan,1936.0,9,4,10,23
21620,Japan,1972.0,30,20,9,59
21621,Japan,1996.0,3,26,13,42
21622,Japan,2004.0,21,20,52,93
21623,Japan,2012.0,7,44,33,84
21624,Japan,2016.0,17,13,34,64
21625,Japan,1960.0,9,10,12,31
21626,Japan,1964.0,32,5,25,62
21627,Japan,2012.0,7,44,33,84
21628,Japan,1968.0,16,25,22,63
21629,Japan,1998.0,8,1,4,13
21630,Japan,1998.0,8,1,4,13
21631,Japan,1998.0,8,1,4,13
21632,Japan,1972.0,30,20,9,59
21633,Japan,1956.0,4,16,5,25
21634,Japan,2012.0,7,44,33,84
21635,Japan,2004.0,21,20,52,93
21636,Japan,1952.0,1,9,2,12
21637,Japan,1984.0,10,9,31,50
21638,Japan,1984.0,10,9,31,50
21639,Japan,1984.0,10,9,31,50
21640,Japan,1984.0,10,9,31,50
21641,Japan,1984.0,10,9,31,50
21642,Japan,2016.0,17,13,34,64
21643,Japan,2012.0,7,44,33,84
21644,Japan,2016.0,17,13,34,64
21645,Japan,2016.0,17,13,34,64
21646,Japan,2016.0,17,13,34,64
21647,Japan,2016.0,17,13,34,64
21648,Japan,1968.0,16,25,22,63
21649,Japan,1972.0,30,20,9,59
21650,Japan,1932.0,10,17,4,31
21651,Japan,2004.0,21,20,52,93
21652,Japan,2008.0,23,15,13,51
21653,Japan,1952.0,1,9,2,12
21654,Japan,1936.0,9,4,10,23
21655,Japan,1964.0,32,5,25,62
21656,Japan,1964.0,32,5,25,62
21657,Japan,2016.0,17,13,34,64
21658,Japan,2014.0,1,4,6,11
21659,Japan,1994.0,3,5,2,10
21660,Japan,1998.0,8,1,4,13
21661,Japan,1998.0,8,1,4,13
21662,Japan,1936.0,9,4,10,23
21663,Japan,2004.0,21,20,52,93
21664,Japan,2008.0,23,15,13,51
21665,Japan,2016.0,17,13,34,64
21666,Japan,1988.0,4,3,14,21
21667,Japan,1992.0,6,10,43,59
21668,Japan,1952.0,1,9,2,12
21669,Japan,1992.0,6,10,43,59
21670,Japan,2012.0,7,44,33,84
21671,Japan,1964.0,32,5,25,62
21672,Japan,1964.0,32,5,25,62
21673,Japan,2016.0,17,13,34,64
21674,Japan,1976.0,25,6,10,41
21675,Japan,1960.0,9,10,12,31
21676,Japan,2014.0,1,4,6,11
21677,Japan,2012.0,7,44,33,84
21678,Japan,2012.0,7,44,33,84
21679,Japan,2014.0,1,4,6,11
21680,Japan,1984.0,10,9,31,50
21681,Japan,1972.0,30,20,9,59
21682,Japan,1976.0,25,6,10,41
21683,Japan,1984.0,10,9,31,50
21684,Japan,2008.0,23,15,13,51
21685,Japan,1984.0,10,9,31,50
21686,Japan,1928.0,2,6,1,9
21687,Japan,1994.0,3,5,2,10
21688,Japan,1964.0,32,5,25,62
21689,Japan,2012.0,7,44,33,84
21690,Japan,2016.0,17,13,34,64
21691,Japan,1984.0,10,9,31,50
21692,Japan,1988.0,4,3,14,21
21693,Japan,2010.0,0,5,2,7
21694,Japan,1964.0,32,5,25,62
21695,Japan,1964.0,32,5,25,62
21696,Japan,2004.0,21,20,52,93
21697,Japan,2008.0,23,15,13,51
21698,Japan,2004.0,21,20,52,93
21699,Japan,2008.0,23,15,13,51
21700,Japan,2012.0,7,44,33,84
21701,Japan,2016.0,17,13,34,64
21702,Japan,1976.0,25,6,10,41
21703,Japan,1956.0,4,16,5,25
21704,Japan,1996.0,3,26,13,42
21705,Japan,1972.0,30,20,9,59
21706,Japan,1976.0,25,6,10,41
21707,Japan,2016.0,17,13,34,64
21708,Japan,1956.0,4,16,5,25
21709,Japan,1964.0,32,5,25,62
21710,Japan,1988.0,4,3,14,21
21711,Japan,1988.0,4,3,14,21
21712,Japan,1992.0,6,10,43,59
21713,Japan,1992.0,6,10,43,59
21714,Japan,1996.0,3,26,13,42
21715,Japan,1932.0,10,17,4,31
21716,Japan,1964.0,32,5,25,62
21717,Japan,1992.0,6,10,43,59
21718,Japan,2012.0,7,44,33,84
21719,Japan,2004.0,21,20,52,93
21720,Japan,2000.0,5,31,8,44
21721,Japan,2004.0,21,20,52,93
21722,Japan,1968.0,16,25,22,63
21723,Japan,2008.0,23,15,13,51
21724,Japan,2016.0,17,13,34,64
21725,Japan,2016.0,17,13,34,64
21726,Japan,2012.0,7,44,33,84
21727,Japan,2012.0,7,44,33,84
21728,Japan,2012.0,7,44,33,84
21729,Japan,1984.0,10,9,31,50
21730,Japan,1932.0,10,17,4,31
21731,Japan,1984.0,10,9,31,50
21732,Japan,1984.0,10,9,31,50
21733,Japan,1960.0,9,10,12,31
21734,Japan,1992.0,6,10,43,59
21735,Japan,1960.0,9,10,12,31
21736,Japan,2004.0,21,20,52,93
21737,Japan,2008.0,23,15,13,51
21738,Japan,1952.0,1,9,2,12
21739,Japan,2012.0,7,44,33,84
21740,Japan,2016.0,17,13,34,64
21741,Japan,2000.0,5,31,8,44
21742,Japan,1956.0,4,16,5,25
21743,Japan,1964.0,32,5,25,62
21744,Japan,2000.0,5,31,8,44
21745,Japan,2014.0,1,4,6,11
21746,Japan,2000.0,5,31,8,44
21747,Japan,2004.0,21,20,52,93
21748,Japan,1992.0,6,10,43,59
21749,Japan,2016.0,17,13,34,64
21750,Japan,2008.0,23,15,13,51
21751,Japan,1992.0,6,10,43,59
21752,Japan,2012.0,7,44,33,84
21753,Japan,2004.0,21,20,52,93
21754,Japan,1968.0,16,25,22,63
21755,Japan,1972.0,30,20,9,59
21756,Japan,2004.0,21,20,52,93
21757,Japan,1964.0,32,5,25,62
21758,Japan,1992.0,6,10,43,59
21759,Japan,2004.0,21,20,52,93
21760,Japan,2012.0,7,44,33,84
21761,Japan,2004.0,21,20,52,93
21762,Japan,1996.0,3,26,13,42
21763,Japan,2000.0,5,31,8,44
21764,Japan,2004.0,21,20,52,93
21765,Japan,1996.0,3,26,13,42
21766,Japan,1984.0,10,9,31,50
21767,Japan,2012.0,7,44,33,84
21768,Japan,1984.0,10,9,31,50
21769,Japan,1984.0,10,9,31,50
21770,Japan,1976.0,25,6,10,41
21771,Japan,1976.0,25,6,10,41
21772,Japan-1,2012.0,7,44,33,84
21773,Japan,1984.0,10,9,31,50
21774,Japan,1968.0,16,25,22,63
21775,Japan,1968.0,16,25,22,63
21776,Japan,1964.0,32,5,25,62
21777,Japan,2004.0,21,20,52,93
21778,Japan,1968.0,16,25,22,63
21779,Japan,1976.0,25,6,10,41
21780,Japan,2016.0,17,13,34,64
21781,Japan,2012.0,7,44,33,84
21782,Japan,2012.0,7,44,33,84
21783,Japan,2008.0,23,15,13,51
21784,Japan,1956.0,4,16,5,25
21785,Japan,1964.0,32,5,25,62
21786,Japan,1994.0,3,5,2,10
21787,Japan,2014.0,1,4,6,11
21788,Japan,2014.0,1,4,6,11
21789,Japan,1972.0,30,20,9,59
21790,Japan,1972.0,30,20,9,59
21791,Japan,1972.0,30,20,9,59
21792,Japan,1972.0,30,20,9,59
21793,Japan,1972.0,30,20,9,59
21794,Japan,2004.0,21,20,52,93
21795,Japan,2004.0,21,20,52,93
21796,Japan,2008.0,23,15,13,51
21797,Japan,1920.0,0,3,0,3
21798,Japan,1968.0,16,25,22,63
21799,Japan,2010.0,0,5,2,7
21800,Japan,1976.0,25,6,10,41
21801,Japan,1972.0,30,20,9,59
21802,Japan,2012.0,7,44,33,84
21803,Japan,2016.0,17,13,34,64
21804,Japan,1968.0,16,25,22,63
21805,Japan,1968.0,16,25,22,63
21806,Japan,1968.0,16,25,22,63
21807,Japan,1968.0,16,25,22,63
21808,Japan,1972.0,30,20,9,59
21809,Japan,1972.0,30,20,9,59
21810,Japan,1972.0,30,20,9,59
21811,Japan,1972.0,30,20,9,59
21812,Japan,1972.0,30,20,9,59
21813,Japan,1976.0,25,6,10,41
21814,Japan,1976.0,25,6,10,41
21815,Japan,1976.0,25,6,10,41
21816,Japan,1968.0,16,25,22,63
21817,Japan,1968.0,16,25,22,63
21818,Japan,2012.0,7,44,33,84
21819,Japan,1992.0,6,10,43,59
21820,Japan,1996.0,3,26,13,42
21821,Japan,1972.0,30,20,9,59
21822,Japan,2016.0,17,13,34,64
21823,Japan,1992.0,6,10,43,59
21824,Japan,1932.0,10,17,4,31
21825,Japan,1996.0,3,26,13,42
21826,Japan,2012.0,7,44,33,84
21827,Japan,1992.0,6,10,43,59
21828,Japan,1996.0,3,26,13,42
21829,Japan,2004.0,21,20,52,93
21830,Japan,2012.0,7,44,33,84
21831,Japan,1932.0,10,17,4,31
21832,Japan,1968.0,16,25,22,63
21833,Japan,1968.0,16,25,22,63
21834,Japan,1972.0,30,20,9,59
21835,Japan,1972.0,30,20,9,59
21836,Japan,1972.0,30,20,9,59
21837,Japan,1972.0,30,20,9,59
21838,Japan,1976.0,25,6,10,41
21839,Japan,1976.0,25,6,10,41
21840,Japan,1976.0,25,6,10,41
21841,Japan,1968.0,16,25,22,63
21842,Japan,1996.0,3,26,13,42
21843,Japan,1968.0,16,25,22,63
21844,Japan,1972.0,30,20,9,59
21845,Japan,1984.0,10,9,31,50
21846,Japan,2012.0,7,44,33,84
21847,Japan,2004.0,21,20,52,93
21848,Japan,2012.0,7,44,33,84
21849,Japan,1996.0,3,26,13,42
21850,Japan,2016.0,17,13,34,64
21851,Japan,2004.0,21,20,52,93
21852,Japan,2004.0,21,20,52,93
21853,Japan,2004.0,21,20,52,93
21854,Japan,2008.0,23,15,13,51
21855,Japan,2008.0,23,15,13,51
21856,Japan,2008.0,23,15,13,51
21857,Japan,2012.0,7,44,33,84
21858,Japan,1932.0,10,17,4,31
21859,Japan,1952.0,1,9,2,12
21860,Japan,2004.0,21,20,52,93
21861,Japan,1984.0,10,9,31,50
21862,Japan,1932.0,10,17,4,31
21863,Japan,1936.0,9,4,10,23
21864,Japan,1992.0,6,10,43,59
21865,Japan,2004.0,21,20,52,93
21866,Japan,1932.0,10,17,4,31
21867,Japan,1988.0,4,3,14,21
21868,Japan,2000.0,5,31,8,44
21869,Japan,2016.0,17,13,34,64
21870,Japan,2010.0,0,5,2,7
21871,Japan,1992.0,6,10,43,59
21872,Japan,1996.0,3,26,13,42
21873,Japan,1992.0,6,10,43,59
21874,Japan,1932.0,10,17,4,31
21875,Japan,1936.0,9,4,10,23
21876,Japan,1968.0,16,25,22,63
21877,Japan,1992.0,6,10,43,59
21878,Japan,1968.0,16,25,22,63
21879,Japan,1992.0,6,10,43,59
21880,Japan,1932.0,10,17,4,31
21881,Japan,2016.0,17,13,34,64
21882,Japan,1964.0,32,5,25,62
21883,Japan,1988.0,4,3,14,21
21884,Japan,1932.0,10,17,4,31
21885,Japan,1972.0,30,20,9,59
21886,Japan,1956.0,4,16,5,25
21887,Japan,1992.0,6,10,43,59
21888,Japan,1994.0,3,5,2,10
21889,Japan,1994.0,3,5,2,10
21890,Japan,1964.0,32,5,25,62
21891,Japan,2000.0,5,31,8,44
21892,Japan,1992.0,6,10,43,59
21893,Japan,1984.0,10,9,31,50
21894,Japan,1988.0,4,3,14,21
21895,Japan,1988.0,4,3,14,21
21896,Japan,1964.0,32,5,25,62
21897,Japan,1956.0,4,16,5,25
21898,Japan,1956.0,4,16,5,25
21899,Japan,1956.0,4,16,5,25
21900,Japan,1976.0,25,6,10,41
21901,Japan,1920.0,0,3,0,3
21902,Japan,1920.0,0,3,0,3
21903,Japan,2012.0,7,44,33,84
21904,Japan,1976.0,25,6,10,41
21905,Japan,2004.0,21,20,52,93
21906,Japan,1988.0,4,3,14,21
21907,Japan,1992.0,6,10,43,59
21908,Japan,1996.0,3,26,13,42
21909,Japan,2000.0,5,31,8,44
21910,Japan,1968.0,16,25,22,63
21911,Japan,1996.0,3,26,13,42
21912,Japan,2008.0,23,15,13,51
21913,Japan,1976.0,25,6,10,41
21914,Japan,1932.0,10,17,4,31
21915,Japan,1936.0,9,4,10,23
21916,Japan,1932.0,10,17,4,31
21917,Japan,1936.0,9,4,10,23
21918,Japan,1984.0,10,9,31,50
21919,Japan,2016.0,17,13,34,64
21920,Japan,2012.0,7,44,33,84
21921,Japan,2000.0,5,31,8,44
21922,Japan,1960.0,9,10,12,31
21923,Japan,1976.0,25,6,10,41
21924,Japan,2008.0,23,15,13,51
21925,Japan,2012.0,7,44,33,84
21926,Japan,2012.0,7,44,33,84
21927,Japan,2016.0,17,13,34,64
21928,Japan,1968.0,16,25,22,63
21929,Japan,2012.0,7,44,33,84
21930,Japan,2016.0,17,13,34,64
21931,Japan,2000.0,5,31,8,44
21932,Japan,2012.0,7,44,33,84
21933,Japan,1964.0,32,5,25,62
21934,Japan,1972.0,30,20,9,59
21935,Japan,1964.0,32,5,25,62
21936,Japan,1992.0,6,10,43,59
21937,Japan,1992.0,6,10,43,59
21938,Japan,2008.0,23,15,13,51
21939,Japan,1996.0,3,26,13,42
21940,Japan,1984.0,10,9,31,50
21941,Japan,2016.0,17,13,34,64
21942,Japan,2004.0,21,20,52,93
21943,Japan,1976.0,25,6,10,41
21944,Japan,1992.0,6,10,43,59
21945,Japan,1964.0,32,5,25,62
21946,Japan,1968.0,16,25,22,63
21947,Japan,1972.0,30,20,9,59
21948,Japan,2000.0,5,31,8,44
21949,Japan,2008.0,23,15,13,51
21950,Japan,1996.0,3,26,13,42
21951,Japan,2004.0,21,20,52,93
21952,Japan,2008.0,23,15,13,51
21953,Japan,2016.0,17,13,34,64
21954,Japan,2016.0,17,13,34,64
21955,Japan,1960.0,9,10,12,31
21956,Japan,1964.0,32,5,25,62
21957,Japan,1968.0,16,25,22,63
21958,Japan,1984.0,10,9,31,50
21959,Japan,2004.0,21,20,52,93
21960,Japan,1992.0,6,10,43,59
21961,Japan,1992.0,6,10,43,59
21962,Japan,1984.0,10,9,31,50
21963,Japan,1988.0,4,3,14,21
21964,Japan,1984.0,10,9,31,50
21965,Japan,2012.0,7,44,33,84
21966,Japan,2016.0,17,13,34,64
21967,Japan,2012.0,7,44,33,84
21968,Japan,1960.0,9,10,12,31
21969,Japan,1964.0,32,5,25,62
21970,Japan,1968.0,16,25,22,63
21971,Japan,1968.0,16,25,22,63
21972,Japan,2012.0,7,44,33,84
21973,Japan,1964.0,32,5,25,62
21974,Japan,1968.0,16,25,22,63
21975,Japan,2004.0,21,20,52,93
21976,Japan,1968.0,16,25,22,63
21977,Japan,2008.0,23,15,13,51
21978,Japan,1932.0,10,17,4,31
21979,Japan,1932.0,10,17,4,31
21980,Japan,1992.0,6,10,43,59
21981,Japan,1988.0,4,3,14,21
21982,Japan,2016.0,17,13,34,64
21983,Japan,2016.0,17,13,34,64
21984,Japan,2004.0,21,20,52,93
21985,Japan,1996.0,3,26,13,42
21986,Japan,1968.0,16,25,22,63
21987,Japan,1996.0,3,26,13,42
21988,Japan,1968.0,16,25,22,63
21989,Japan,1992.0,6,10,43,59
21990,Japan,1984.0,10,9,31,50
21991,Japan,1984.0,10,9,31,50
21992,Japan,1984.0,10,9,31,50
21993,Japan,1968.0,16,25,22,63
21994,Japan,1972.0,30,20,9,59
21995,Japan,1984.0,10,9,31,50
21996,Japan,2004.0,21,20,52,93
21997,Japan,2004.0,21,20,52,93
21998,Japan,1964.0,32,5,25,62
21999,Japan,1984.0,10,9,31,50
22000,Japan,1984.0,10,9,31,50
22001,Japan,1968.0,16,25,22,63
22002,Japan,2004.0,21,20,52,93
22003,Japan,2012.0,7,44,33,84
22004,Japan,2004.0,21,20,52,93
22005,Japan,2012.0,7,44,33,84
22006,Japan,2008.0,23,15,13,51
22007,Japan,2012.0,7,44,33,84
22008,Japan,2016.0,17,13,34,64
22009,Japan,1984.0,10,9,31,50
22010,Japan,2010.0,0,5,2,7
22011,Japan,1932.0,10,17,4,31
22012,Japan,2000.0,5,31,8,44
22013,Japan,2004.0,21,20,52,93
22014,Japan,2000.0,5,31,8,44
22015,Japan,2004.0,21,20,52,93
22016,Japan,1924.0,0,0,1,1
22017,Japan,1984.0,10,9,31,50
22018,Japan,1996.0,3,26,13,42
22019,Japan,2016.0,17,13,34,64
22020,Japan,2012.0,7,44,33,84
22021,Japan,1992.0,6,10,43,59
22022,Japan,1996.0,3,26,13,42
22023,Japan,1932.0,10,17,4,31
22024,Japan,1996.0,3,26,13,42
22025,Japan,2000.0,5,31,8,44
22026,Japan,2000.0,5,31,8,44
22027,Japan,2016.0,17,13,34,64
22028,Japan,2008.0,23,15,13,51
22029,Japan,2016.0,17,13,34,64
22030,Japan,2004.0,21,20,52,93
22031,Japan,2004.0,21,20,52,93
22032,Japan,2008.0,23,15,13,51
22033,Japan,1996.0,3,26,13,42
22034,Japan,1972.0,30,20,9,59
22035,Japan,1964.0,32,5,25,62
22036,Japan,2004.0,21,20,52,93
22037,Japan,2004.0,21,20,52,93
22038,Japan,2000.0,5,31,8,44
22039,Japan,2008.0,23,15,13,51
22040,Japan,1968.0,16,25,22,63
22041,Japan,1964.0,32,5,25,62
22042,Japan,2012.0,7,44,33,84
22043,Japan,1968.0,16,25,22,63
22044,Japan,1968.0,16,25,22,63
22045,Japan,1968.0,16,25,22,63
22046,Japan,1968.0,16,25,22,63
22047,Japan,1968.0,16,25,22,63
22048,Japan,1968.0,16,25,22,63
22049,Japan,1972.0,30,20,9,59
22050,Japan,1972.0,30,20,9,59
22051,Japan,1972.0,30,20,9,59
22052,Japan,1972.0,30,20,9,59
22053,Japan,1936.0,9,4,10,23
22054,Japan,1932.0,10,17,4,31
22055,Japan,1932.0,10,17,4,31
22056,Japan,1964.0,32,5,25,62
22057,Japan,1968.0,16,25,22,63
22058,Japan,1972.0,30,20,9,59
22059,Japan,1976.0,25,6,10,41
22060,Japan,1992.0,6,10,43,59
22061,Japan,1932.0,10,17,4,31
22062,Japan,1932.0,10,17,4,31
22063,Japan,1936.0,9,4,10,23
22064,Japan,1994.0,3,5,2,10
22065,Japan,1988.0,4,3,14,21
22066,Japan,1992.0,6,10,43,59
22067,Japan,2016.0,17,13,34,64
22068,Japan,1972.0,30,20,9,59
22069,Japan,1972.0,30,20,9,59
22070,Japan,1998.0,8,1,4,13
22071,Japan,1992.0,6,10,43,59
22072,Japan,2012.0,7,44,33,84
22073,Japan,2008.0,23,15,13,51
22074,Japan,2016.0,17,13,34,64
22075,Japan,1928.0,2,6,1,9
22076,Japan,2004.0,21,20,52,93
22077,Japan,1972.0,30,20,9,59
22078,Japan,1996.0,3,26,13,42
22079,Japan,1996.0,3,26,13,42
22080,Japan,2000.0,5,31,8,44
22081,Japan,2004.0,21,20,52,93
22082,Japan,1972.0,30,20,9,59
22083,Japan,1984.0,10,9,31,50
22084,Japan,2012.0,7,44,33,84
22085,Japan,1928.0,2,6,1,9
22086,Japan,1984.0,10,9,31,50
22087,Japan,1936.0,9,4,10,23
22088,Japan,2004.0,21,20,52,93
22089,Japan,1992.0,6,10,43,59
22090,Japan,1968.0,16,25,22,63
22091,Japan,1992.0,6,10,43,59
22092,Japan,1994.0,3,5,2,10
22093,Japan,2012.0,7,44,33,84
22094,Japan,1964.0,32,5,25,62
22095,Japan,1968.0,16,25,22,63
22096,Japan,1968.0,16,25,22,63
22097,Japan,1972.0,30,20,9,59
22098,Japan,1994.0,3,5,2,10
22099,Japan,1998.0,8,1,4,13
22100,Japan,1964.0,32,5,25,62
22101,Japan,1992.0,6,10,43,59
22102,Japan,1972.0,30,20,9,59
22103,Japan,1976.0,25,6,10,41
22104,Japan,2000.0,5,31,8,44
22105,Japan,1972.0,30,20,9,59
22106,Japan,1964.0,32,5,25,62
22107,Japan,1998.0,8,1,4,13
22108,Japan,2008.0,23,15,13,51
22109,Japan,1968.0,16,25,22,63
22110,Japan,1972.0,30,20,9,59
22111,Japan,1996.0,3,26,13,42
22112,Japan,2016.0,17,13,34,64
22113,Japan,2004.0,21,20,52,93
22114,Japan,1992.0,6,10,43,59
22115,Japan,1992.0,6,10,43,59
22116,Japan,2016.0,17,13,34,64
22117,Japan,2000.0,5,31,8,44
22118,Japan,1996.0,3,26,13,42
22119,Japan,1964.0,32,5,25,62
22120,Japan,2016.0,17,13,34,64
22121,Japan,1952.0,1,9,2,12
22122,Japan,1956.0,4,16,5,25
22123,Japan,1956.0,4,16,5,25
22124,Japan,1956.0,4,16,5,25
22125,Japan,1956.0,4,16,5,25
22126,Japan,1956.0,4,16,5,25
22127,Japan,1960.0,9,10,12,31
22128,Japan,1960.0,9,10,12,31
22129,Japan,1960.0,9,10,12,31
22130,Japan,1960.0,9,10,12,31
22131,Japan,1960.0,9,10,12,31
22132,Japan,1960.0,9,10,12,31
22133,Japan,1964.0,32,5,25,62
22134,Japan,2014.0,1,4,6,11
22135,Japan,1960.0,9,10,12,31
22136,Japan,1960.0,9,10,12,31
22137,Japan,1988.0,4,3,14,21
22138,Japan,1932.0,10,17,4,31
22139,Japan,1992.0,6,10,43,59
22140,Japan,1984.0,10,9,31,50
22141,Japan,1988.0,4,3,14,21
22142,Japan,2016.0,17,13,34,64
22143,Japan,1996.0,3,26,13,42
22144,Japan,2008.0,23,15,13,51
22145,Japan,2012.0,7,44,33,84
22146,Japan,1984.0,10,9,31,50
22147,Japan,2012.0,7,44,33,84
22148,Japan,1932.0,10,17,4,31
22149,Japan,1996.0,3,26,13,42
22150,Japan,2000.0,5,31,8,44
22151,Japan,2004.0,21,20,52,93
22152,Japan,1998.0,8,1,4,13
22153,Japan,1984.0,10,9,31,50
22154,Japan,1988.0,4,3,14,21
22155,Japan,1984.0,10,9,31,50
22156,Japan,1992.0,6,10,43,59
22157,Japan,2012.0,7,44,33,84
22158,Japan,2004.0,21,20,52,93
22159,Japan,2008.0,23,15,13,51
22160,Japan,2016.0,17,13,34,64
22161,Japan,1932.0,10,17,4,31
22162,Japan,2008.0,23,15,13,51
22163,Japan,2004.0,21,20,52,93
22164,Japan,1984.0,10,9,31,50
22165,Japan,1992.0,6,10,43,59
22166,Japan,2012.0,7,44,33,84
22167,Japan,1964.0,32,5,25,62
22168,Japan,2012.0,7,44,33,84
22169,Japan,2012.0,7,44,33,84
22170,Japan,1956.0,4,16,5,25
22171,Japan,1964.0,32,5,25,62
22172,Japan,1928.0,2,6,1,9
22173,Japan,2008.0,23,15,13,51
22174,Japan,1988.0,4,3,14,21
22175,Japan,2004.0,21,20,52,93
22176,Japan,2008.0,23,15,13,51
22177,Japan,1992.0,6,10,43,59
22178,Japan,1968.0,16,25,22,63
22179,Japan,1972.0,30,20,9,59
22180,Japan,1996.0,3,26,13,42
22181,Japan,1988.0,4,3,14,21
22182,Japan,1992.0,6,10,43,59
22183,Japan,1964.0,32,5,25,62
22184,Japan,2004.0,21,20,52,93
22185,Japan,1998.0,8,1,4,13
22186,Japan,2002.0,0,1,1,2
22187,Japan,2012.0,7,44,33,84
22188,Japan,2004.0,21,20,52,93
22189,Japan,1972.0,30,20,9,59
22190,Japan,2016.0,17,13,34,64
22191,Japan,2004.0,21,20,52,93
22192,Japan,1932.0,10,17,4,31
22193,Japan,1964.0,32,5,25,62
22194,Japan,1996.0,3,26,13,42
22195,Japan,1972.0,30,20,9,59
22196,Japan,1968.0,16,25,22,63
22197,Japan,1972.0,30,20,9,59
22198,Japan,1998.0,8,1,4,13
22199,Japan,1998.0,8,1,4,13
22200,Japan,2002.0,0,1,1,2
22201,Japan,1960.0,9,10,12,31
22202,Japan,2004.0,21,20,52,93
22203,Japan,2014.0,1,4,6,11
22204,Japan,2012.0,7,44,33,84
22205,Japan,2012.0,7,44,33,84
22206,Japan,2000.0,5,31,8,44
22207,Japan,1964.0,32,5,25,62
22208,Japan,1972.0,30,20,9,59
22209,Japan,1968.0,16,25,22,63
22210,Japan,2016.0,17,13,34,64
22211,Japan,2016.0,17,13,34,64
22212,Japan,1972.0,30,20,9,59
22213,Japan,1976.0,25,6,10,41
22214,Japan,1964.0,32,5,25,62
22215,Japan,1968.0,16,25,22,63
22216,Japan,1964.0,32,5,25,62
22217,Japan,1932.0,10,17,4,31
22218,Japan,2008.0,23,15,13,51
22219,Japan,1936.0,9,4,10,23
22220,Japan,1976.0,25,6,10,41
22221,Japan,1984.0,10,9,31,50
22222,Japan,1984.0,10,9,31,50
22223,Japan,2008.0,23,15,13,51
22224,Japan,1964.0,32,5,25,62
22225,Japan,1976.0,25,6,10,41
22226,Japan,1996.0,3,26,13,42
22227,Japan,2000.0,5,31,8,44
22228,Japan,2012.0,7,44,33,84
22229,Japan,1992.0,6,10,43,59
22230,Japan,1996.0,3,26,13,42
22231,Japan,1936.0,9,4,10,23
22232,Japan,1984.0,10,9,31,50
22233,Japan,1992.0,6,10,43,59
22234,Japan,1968.0,16,25,22,63
22235,Japan,1988.0,4,3,14,21
22236,Japan,2004.0,21,20,52,93
22237,Japan,2008.0,23,15,13,51
22238,Japan,1952.0,1,9,2,12
22239,Japan,1952.0,1,9,2,12
22240,Japan,2004.0,21,20,52,93
22241,Japan,2012.0,7,44,33,84
22242,Japan,2012.0,7,44,33,84
22243,Japan,2012.0,7,44,33,84
22244,Japan,1936.0,9,4,10,23
22245,Japan,2010.0,0,5,2,7
22246,Japan,1996.0,3,26,13,42
22247,Japan,2000.0,5,31,8,44
22248,Japan,2000.0,5,31,8,44
22249,Japan,2004.0,21,20,52,93
22250,Japan,2004.0,21,20,52,93
22251,Japan,2016.0,17,13,34,64
22252,Japan,1936.0,9,4,10,23
22253,Japan,1972.0,30,20,9,59
22254,Japan,1972.0,30,20,9,59
22255,Japan,1936.0,9,4,10,23
22256,Japan,1936.0,9,4,10,23
22257,Japan,2000.0,5,31,8,44
22258,Japan,1996.0,3,26,13,42
22259,Japan,1976.0,25,6,10,41
22260,Japan,1984.0,10,9,31,50
22261,Japan,2016.0,17,13,34,64
22262,Japan,2010.0,0,5,2,7
22263,Japan,1996.0,3,26,13,42
22264,Japan,2000.0,5,31,8,44
22265,Japan,2004.0,21,20,52,93
22266,Japan,2008.0,23,15,13,51
22267,Japan,1928.0,2,6,1,9
22268,Japan,1928.0,2,6,1,9
22269,Japan,1992.0,6,10,43,59
22270,Japan,2012.0,7,44,33,84
22271,Japan,2016.0,17,13,34,64
22272,Japan,1992.0,6,10,43,59
22273,Japan,2000.0,5,31,8,44
22274,Japan,2004.0,21,20,52,93
22275,Japan,1968.0,16,25,22,63
22276,Japan,1976.0,25,6,10,41
22277,Japan,1996.0,3,26,13,42
22278,Japan,2000.0,5,31,8,44
22279,Japan,2000.0,5,31,8,44
22280,Japan,2004.0,21,20,52,93
22281,Japan,2004.0,21,20,52,93
22282,Japan,1952.0,1,9,2,12
22283,Japan,1956.0,4,16,5,25
22284,Japan,1956.0,4,16,5,25
22285,Japan,1956.0,4,16,5,25
22286,Japan,1956.0,4,16,5,25
22287,Japan,1960.0,9,10,12,31
22288,Japan,1960.0,9,10,12,31
22289,Japan,2012.0,7,44,33,84
22290,Japan,2014.0,1,4,6,11
22291,Japan,2014.0,1,4,6,11
22292,Japan,2000.0,5,31,8,44
22293,Japan,2000.0,5,31,8,44
22294,Japan,1992.0,6,10,43,59
22295,Japan,1996.0,3,26,13,42
22296,Japan,2000.0,5,31,8,44
22297,Japan,2004.0,21,20,52,93
22298,Japan,2008.0,23,15,13,51
22299,Japan,2004.0,21,20,52,93
22300,Japan,1960.0,9,10,12,31
22301,Japan,1992.0,6,10,43,59
22302,Japan,1996.0,3,26,13,42
22303,Japan,2012.0,7,44,33,84
22304,Japan,1996.0,3,26,13,42
22305,Japan,2012.0,7,44,33,84
22306,Japan,2000.0,5,31,8,44
22307,Japan,1988.0,4,3,14,21
22308,Japan,1960.0,9,10,12,31
22309,Japan,2012.0,7,44,33,84
22310,Japan,2016.0,17,13,34,64
22311,Japan,1964.0,32,5,25,62
22312,Japan,1996.0,3,26,13,42
22313,Japan,2004.0,21,20,52,93
22314,Japan,1964.0,32,5,25,62
22315,Japan,1952.0,1,9,2,12
22316,Japan,2004.0,21,20,52,93
22317,Japan,2008.0,23,15,13,51
22318,Japan,2012.0,7,44,33,84
22319,Japan,1992.0,6,10,43,59
22320,Japan,2000.0,5,31,8,44
22321,Japan,2004.0,21,20,52,93
22322,Japan,1936.0,9,4,10,23
22323,Japan,2012.0,7,44,33,84
22324,Japan,2012.0,7,44,33,84
22325,Japan,2004.0,21,20,52,93
22326,Japan,1992.0,6,10,43,59
22327,Japan,1992.0,6,10,43,59
22328,Japan,2004.0,21,20,52,93
22329,Japan,2004.0,21,20,52,93
22330,Japan,2008.0,23,15,13,51
22331,Japan,1960.0,9,10,12,31
22332,Japan,1984.0,10,9,31,50
22333,Japan,1968.0,16,25,22,63
22334,Japan,2016.0,17,13,34,64
22335,Japan,1932.0,10,17,4,31
22336,Japan,1964.0,32,5,25,62
22337,Japan,1964.0,32,5,25,62
22338,Japan,2004.0,21,20,52,93
22339,Japan,2008.0,23,15,13,51
22340,Japan,1968.0,16,25,22,63
22341,Japan,1972.0,30,20,9,59
22342,Japan,1972.0,30,20,9,59
22343,Japan,1972.0,30,20,9,59
22344,Japan,1976.0,25,6,10,41
22345,Japan,1976.0,25,6,10,41
22346,Japan,1976.0,25,6,10,41
22347,Japan,1976.0,25,6,10,41
22348,Japan,1976.0,25,6,10,41
22349,Japan,2008.0,23,15,13,51
22350,Japan,2004.0,21,20,52,93
22351,Japan,1956.0,4,16,5,25
22352,Japan,1960.0,9,10,12,31
22353,Japan,1960.0,9,10,12,31
22354,Japan,1964.0,32,5,25,62
22355,Japan,1964.0,32,5,25,62
22356,Japan,1964.0,32,5,25,62
22357,Japan,1964.0,32,5,25,62
22358,Japan,1928.0,2,6,1,9
22359,Japan,1932.0,10,17,4,31
22360,Japan,2008.0,23,15,13,51
22361,Japan,2008.0,23,15,13,51
22362,Japan,2012.0,7,44,33,84
22363,Japan,2012.0,7,44,33,84
22364,Japan,2012.0,7,44,33,84
22365,Japan,2016.0,17,13,34,64
22366,Japan,2016.0,17,13,34,64
22367,Japan,2004.0,21,20,52,93
22368,Japan,2008.0,23,15,13,51
22369,Japan,2012.0,7,44,33,84
22370,Japan,2004.0,21,20,52,93
22371,Japan,1998.0,8,1,4,13
22372,Japan,1976.0,25,6,10,41
22373,Japan,2004.0,21,20,52,93
22374,Japan,2008.0,23,15,13,51
22375,Japan,2012.0,7,44,33,84
22376,Japan,2004.0,21,20,52,93
22377,Japan,2008.0,23,15,13,51
22378,Japan,1952.0,1,9,2,12
22379,Japan,1952.0,1,9,2,12
22380,Japan,1964.0,32,5,25,62
22381,Japan,1968.0,16,25,22,63
22382,Japan,1932.0,10,17,4,31
22383,Japan,1936.0,9,4,10,23
22384,Japan,1936.0,9,4,10,23
22385,Japan,2000.0,5,31,8,44
22386,Japan,2004.0,21,20,52,93
22387,Japan,2004.0,21,20,52,93
22388,Japan,1972.0,30,20,9,59
22389,Japan,2004.0,21,20,52,93
22390,Japan,1992.0,6,10,43,59
22391,Japan,2014.0,1,4,6,11
22392,Japan,1992.0,6,10,43,59
22393,Japan,1992.0,6,10,43,59
22394,Japan,1960.0,9,10,12,31
22395,Japan,1968.0,16,25,22,63
22396,Japan,1964.0,32,5,25,62
22397,Japan,1968.0,16,25,22,63
22398,Japan,1980.0,0,1,0,1
22399,Japan,2016.0,17,13,34,64
22400,Japan,2004.0,21,20,52,93
22401,Japan,2008.0,23,15,13,51
22402,Japan,2000.0,5,31,8,44
22403,Japan,1988.0,4,3,14,21
22404,Japan,2016.0,17,13,34,64
22405,Japan,2012.0,7,44,33,84
22406,Japan,1968.0,16,25,22,63
22407,Japan,2000.0,5,31,8,44
22408,Japan,2004.0,21,20,52,93
22409,Japan,1994.0,3,5,2,10
22410,Japan,1984.0,10,9,31,50
22411,Japan,2004.0,21,20,52,93
22412,Japan,2004.0,21,20,52,93
22413,Japan,2004.0,21,20,52,93
22414,Japan,1988.0,4,3,14,21
22415,Japan,2012.0,7,44,33,84
22416,Japan,2016.0,17,13,34,64
22417,Japan,1956.0,4,16,5,25
22418,Japan,1956.0,4,16,5,25
22419,Japan,1960.0,9,10,12,31
22420,Japan,1960.0,9,10,12,31
22421,Japan,1964.0,32,5,25,62
22422,Japan,1964.0,32,5,25,62
22423,Japan,1964.0,32,5,25,62
22424,Japan,2000.0,5,31,8,44
22425,Japan,1972.0,30,20,9,59
22426,Japan,1984.0,10,9,31,50
22427,Japan,1984.0,10,9,31,50
22428,Japan,1972.0,30,20,9,59
22429,Japan,1972.0,30,20,9,59
22430,Japan,1976.0,25,6,10,41
22431,Japan,2012.0,7,44,33,84
22432,Japan,2004.0,21,20,52,93
22433,Japan,1968.0,16,25,22,63
22434,Japan,1972.0,30,20,9,59
22435,Japan,1976.0,25,6,10,41
22436,Japan,1968.0,16,25,22,63
22437,Japan,1932.0,10,17,4,31
22438,Japan,2004.0,21,20,52,93
22439,Japan,2004.0,21,20,52,93
22440,Japan,2000.0,5,31,8,44
22441,Japan,2004.0,21,20,52,93
22442,Japan,2000.0,5,31,8,44
22443,Japan,2012.0,7,44,33,84
22444,Japan,1928.0,2,6,1,9
22445,Japan,1992.0,6,10,43,59
22446,Japan,2016.0,17,13,34,64
22447,Japan,1976.0,25,6,10,41
22448,Japan,2004.0,21,20,52,93
22449,Japan,2008.0,23,15,13,51
22450,Japan,2012.0,7,44,33,84
22451,Japan,2016.0,17,13,34,64
22452,Japan,1968.0,16,25,22,63
22453,Japan,1964.0,32,5,25,62
22454,Japan,1960.0,9,10,12,31
22455,Japan,1964.0,32,5,25,62
22456,Japan,2016.0,17,13,34,64
22457,Japan,1956.0,4,16,5,25
22458,Japan,1968.0,16,25,22,63
22459,Japan,2008.0,23,15,13,51
22460,Japan,2012.0,7,44,33,84
22461,Japan,1932.0,10,17,4,31
22462,Japan,1936.0,9,4,10,23
22463,Japan,1936.0,9,4,10,23
22464,Ethiopia,1992.0,1,0,2,3
22465,Ethiopia,2000.0,4,1,3,8
22466,Ethiopia,2012.0,3,1,3,7
22467,Ethiopia,2016.0,1,2,5,8
22468,Ethiopia,2016.0,1,2,5,8
22469,Ethiopia,1992.0,1,0,2,3
22470,Ethiopia,2004.0,2,3,2,7
22471,Ethiopia,2004.0,2,3,2,7
22472,Ethiopia,2008.0,4,1,2,7
22473,Ethiopia,2008.0,4,1,2,7
22474,Ethiopia,2012.0,3,1,3,7
22475,Ethiopia,1960.0,1,0,0,1
22476,Ethiopia,1964.0,1,0,0,1
22477,Ethiopia,2004.0,2,3,2,7
22478,Ethiopia,2008.0,4,1,2,7
22479,Ethiopia,2012.0,3,1,3,7
22480,Ethiopia,2004.0,2,3,2,7
22481,Ethiopia,2016.0,1,2,5,8
22482,Ethiopia,2016.0,1,2,5,8
22483,Ethiopia,2004.0,2,3,2,7
22484,Ethiopia,2008.0,4,1,2,7
22485,Ethiopia,2008.0,4,1,2,7
22486,Ethiopia,2012.0,3,1,3,7
22487,Ethiopia,2012.0,3,1,3,7
22488,Ethiopia,2016.0,1,2,5,8
22489,Ethiopia,2012.0,3,1,3,7
22490,Ethiopia,2016.0,1,2,5,8
22491,Ethiopia,1996.0,2,0,1,3
22492,Ethiopia,2000.0,4,1,3,8
22493,Ethiopia,2012.0,3,1,3,7
22494,Ethiopia,2008.0,4,1,2,7
22495,Ethiopia,1980.0,2,0,2,4
22496,Ethiopia,2016.0,1,2,5,8
22497,Ethiopia,2000.0,4,1,3,8
22498,Ethiopia,1996.0,2,0,1,3
22499,Ethiopia,2004.0,2,3,2,7
22500,Ethiopia,2008.0,4,1,2,7
22501,Ethiopia,2016.0,1,2,5,8
22502,Ethiopia,2000.0,4,1,3,8
22503,Ethiopia,1992.0,1,0,2,3
22504,Ethiopia,2000.0,4,1,3,8
22505,Ethiopia,2004.0,2,3,2,7
22506,Ethiopia,1980.0,2,0,2,4
22507,Ethiopia,1996.0,2,0,1,3
22508,Ethiopia,2000.0,4,1,3,8
22509,Ethiopia,2000.0,4,1,3,8
22510,Ethiopia,1968.0,1,1,0,2
22511,Ethiopia,1968.0,1,1,0,2
22512,Ethiopia,1972.0,0,0,2,2
22513,Ethiopia,2000.0,4,1,3,8
22514,Ethiopia,1972.0,0,0,2,2
22515,Ethiopia,1980.0,2,0,2,4
22516,Ethiopia,1980.0,2,0,2,4
22517,Switzerland,1924.0,22,25,22,69
22518,Switzerland,1988.0,8,13,7,28
22519,Switzerland,1984.0,2,11,8,21
22520,Switzerland-1,1992.0,3,0,5,8
22521,Switzerland-1,1992.0,3,0,5,8
22522,Switzerland-1,1994.0,4,8,4,16
22523,Switzerland-1,1994.0,4,8,4,16
22524,Switzerland-2,1994.0,4,8,4,16
22525,Switzerland,1920.0,6,2,21,29
22526,Switzerland-1,1936.0,9,29,24,62
22527,Switzerland,1924.0,22,25,22,69
22528,Switzerland,1924.0,22,25,22,69
22529,Switzerland,2002.0,3,7,14,24
22530,Switzerland-1,1956.0,6,2,5,13
22531,Switzerland,2014.0,6,4,20,30
22532,Switzerland,2002.0,3,7,14,24
22533,Switzerland,2002.0,3,7,14,24
22534,Switzerland,2010.0,6,0,6,12
22535,Switzerland,2010.0,6,0,6,12
22536,Switzerland,1920.0,6,2,21,29
22537,Switzerland,1920.0,6,2,21,29
22538,Switzerland-1,2002.0,3,7,14,24
22539,Switzerland,1928.0,16,10,16,42
22540,Switzerland,1928.0,16,10,16,42
22541,Switzerland,1998.0,6,5,3,14
22542,Switzerland-1,1956.0,6,2,5,13
22543,Switzerland-1,1956.0,6,2,5,13
22544,Switzerland-2,2002.0,3,7,14,24
22545,Switzerland-1,2006.0,5,7,9,21
22546,Switzerland-1,2006.0,5,7,9,21
22547,Switzerland,2000.0,1,11,2,14
22548,Switzerland,2008.0,3,1,7,11
22549,Switzerland,1924.0,22,25,22,69
22550,Switzerland,1936.0,9,29,24,62
22551,Switzerland-2,1976.0,2,9,8,19
22552,Switzerland-1,1980.0,4,4,3,11
22553,Switzerland,1936.0,9,29,24,62
22554,Switzerland,1936.0,9,29,24,62
22555,Switzerland,1972.0,7,11,7,25
22556,Switzerland,2016.0,6,3,2,11
22557,Switzerland,1948.0,9,30,25,64
22558,Switzerland,1952.0,2,19,18,39
22559,Switzerland-1,2014.0,6,4,20,30
22560,Switzerland,1948.0,9,30,25,64
22561,Switzerland,1996.0,5,6,0,11
22562,Switzerland,1936.0,9,29,24,62
22563,Switzerland,1924.0,22,25,22,69
22564,Switzerland,2006.0,5,7,9,21
22565,Switzerland-2,1936.0,9,29,24,62
22566,Switzerland-2,1936.0,9,29,24,62
22567,Switzerland,2014.0,6,4,20,30
22568,Switzerland,2014.0,6,4,20,30
22569,Switzerland-1,1976.0,2,9,8,19
22570,Switzerland-2,1976.0,2,9,8,19
22571,Switzerland-2,1980.0,4,4,3,11
22572,Switzerland-1,1980.0,4,4,3,11
22573,Switzerland,1936.0,9,29,24,62
22574,Switzerland,1936.0,9,29,24,62
22575,Switzerland,1952.0,2,19,18,39
22576,Switzerland,2002.0,3,7,14,24
22577,Switzerland,1948.0,9,30,25,64
22578,Switzerland,2000.0,1,11,2,14
22579,Switzerland,1936.0,9,29,24,62
22580,Switzerland,1968.0,0,5,17,22
22581,Switzerland,1900.0,16,4,1,21
22582,Switzerland,1988.0,8,13,7,28
22583,Switzerland,1928.0,16,10,16,42
22584,Switzerland,1948.0,9,30,25,64
22585,Switzerland,1968.0,0,5,17,22
22586,Switzerland,1928.0,16,10,16,42
22587,Switzerland,1924.0,22,25,22,69
22588,Switzerland,1928.0,16,10,16,42
22589,Switzerland-2,1936.0,9,29,24,62
22590,Switzerland,1998.0,6,5,3,14
22591,Switzerland,1928.0,16,10,16,42
22592,Switzerland,1920.0,6,2,21,29
22593,Switzerland,1972.0,7,11,7,25
22594,Switzerland,1928.0,16,10,16,42
22595,Switzerland,1936.0,9,29,24,62
22596,Switzerland,1924.0,22,25,22,69
22597,Switzerland,1960.0,2,6,6,14
22598,Switzerland,1960.0,2,6,6,14
22599,Switzerland,2014.0,6,4,20,30
22600,Switzerland,1952.0,2,19,18,39
22601,Switzerland-1,1936.0,9,29,24,62
22602,Switzerland-1,1972.0,7,11,7,25
22603,Switzerland,2008.0,3,1,7,11
22604,Switzerland,2008.0,3,1,7,11
22605,Switzerland,2016.0,6,3,2,11
22606,Switzerland,1920.0,6,2,21,29
22607,Switzerland,1924.0,22,25,22,69
22608,Switzerland-1,1968.0,0,5,17,22
22609,Switzerland-2,1932.0,0,3,0,3
22610,Switzerland-1,1936.0,9,29,24,62
22611,Switzerland,1948.0,9,30,25,64
22612,Switzerland,1948.0,9,30,25,64
22613,Switzerland,1952.0,2,19,18,39
22614,Switzerland,1956.0,6,2,5,13
22615,Switzerland,1964.0,1,4,1,6
22616,Switzerland,1964.0,1,4,1,6
22617,Switzerland,1968.0,0,5,17,22
22618,Switzerland,1956.0,6,2,5,13
22619,Switzerland,1956.0,6,2,5,13
22620,Switzerland,1972.0,7,11,7,25
22621,Switzerland,2010.0,6,0,6,12
22622,Switzerland,2014.0,6,4,20,30
22623,Switzerland,2014.0,6,4,20,30
22624,Ballerina IV,1960.0,2,6,6,14
22625,Switzerland,1920.0,6,2,21,29
22626,Switzerland,1924.0,22,25,22,69
22627,Switzerland,1998.0,6,5,3,14
22628,Switzerland,1994.0,4,8,4,16
22629,Switzerland,1984.0,2,11,8,21
22630,Switzerland,1956.0,6,2,5,13
22631,Switzerland,1968.0,0,5,17,22
22632,Switzerland,1984.0,2,11,8,21
22633,Lerina,1900.0,16,4,1,21
22634,Lerina,1900.0,16,4,1,21
22635,Lerina,1900.0,16,4,1,21
22636,Lerina,1900.0,16,4,1,21
22637,Lerina,1900.0,16,4,1,21
22638,Lerina,1900.0,16,4,1,21
22639,Switzerland,2010.0,6,0,6,12
22640,Switzerland-1,1956.0,6,2,5,13
22641,Switzerland,2016.0,6,3,2,11
22642,Switzerland,1924.0,22,25,22,69
22643,Switzerland,1984.0,2,11,8,21
22644,Switzerland,1936.0,9,29,24,62
22645,Switzerland,1948.0,9,30,25,64
22646,Switzerland,1948.0,9,30,25,64
22647,Switzerland,1980.0,4,4,3,11
22648,Switzerland,1928.0,16,10,16,42
22649,Switzerland,1968.0,0,5,17,22
22650,Switzerland,1948.0,9,30,25,64
22651,Switzerland,1948.0,9,30,25,64
22652,Switzerland,1936.0,9,29,24,62
22653,Switzerland,1936.0,9,29,24,62
22654,Switzerland-1,1948.0,9,30,25,64
22655,Switzerland,2002.0,3,7,14,24
22656,Switzerland,2014.0,6,4,20,30
22657,Switzerland,2002.0,3,7,14,24
22658,Switzerland,2010.0,6,0,6,12
22659,Switzerland,1920.0,6,2,21,29
22660,Switzerland,1924.0,22,25,22,69
22661,Switzerland,1996.0,5,6,0,11
22662,Switzerland-2,1948.0,9,30,25,64
22663,Switzerland,1952.0,2,19,18,39
22664,Switzerland,1952.0,2,19,18,39
22665,Switzerland,1952.0,2,19,18,39
22666,Switzerland,1952.0,2,19,18,39
22667,Switzerland,1972.0,7,11,7,25
22668,Switzerland,1976.0,2,9,8,19
22669,Switzerland,1936.0,9,29,24,62
22670,Switzerland,1920.0,6,2,21,29
22671,Switzerland,1928.0,16,10,16,42
22672,Switzerland-1,1988.0,8,13,7,28
22673,Switzerland-1,1988.0,8,13,7,28
22674,Switzerland,1924.0,22,25,22,69
22675,Switzerland,1968.0,0,5,17,22
22676,Switzerland,2008.0,3,1,7,11
22677,Switzerland,2012.0,2,2,0,4
22678,Switzerland-2,1936.0,9,29,24,62
22679,Switzerland-1,1936.0,9,29,24,62
22680,Switzerland-1,1948.0,9,30,25,64
22681,Switzerland-1,1952.0,2,19,18,39
22682,Switzerland-1,1952.0,2,19,18,39
22683,Switzerland,1920.0,6,2,21,29
22684,Switzerland,1924.0,22,25,22,69
22685,Switzerland,1956.0,6,2,5,13
22686,Switzerland,1984.0,2,11,8,21
22687,Switzerland,1988.0,8,13,7,28
22688,Switzerland-1,1952.0,2,19,18,39
22689,Switzerland,1952.0,2,19,18,39
22690,Switzerland,1956.0,6,2,5,13
22691,Switzerland,1960.0,2,6,6,14
22692,Switzerland,1964.0,1,4,1,6
22693,Switzerland,1968.0,0,5,17,22
22694,Switzerland,1972.0,7,11,7,25
22695,Switzerland,2004.0,1,2,4,7
22696,Switzerland,1952.0,2,19,18,39
22697,Switzerland,1952.0,2,19,18,39
22698,Switzerland,2014.0,6,4,20,30
22699,Switzerland,2014.0,6,4,20,30
22700,Switzerland,1948.0,9,30,25,64
22701,Switzerland,1948.0,9,30,25,64
22702,Switzerland,2002.0,3,7,14,24
22703,Switzerland-1,1984.0,2,11,8,21
22704,Switzerland,2006.0,5,7,9,21
22705,Switzerland,1996.0,5,6,0,11
22706,Switzerland,1968.0,0,5,17,22
22707,Switzerland,2000.0,1,11,2,14
22708,Switzerland,2014.0,6,4,20,30
22709,Switzerland,1936.0,9,29,24,62
22710,Switzerland-2,1936.0,9,29,24,62
22711,Switzerland,2014.0,6,4,20,30
22712,Switzerland,1924.0,22,25,22,69
22713,Switzerland,1952.0,2,19,18,39
22714,Switzerland,1924.0,22,25,22,69
22715,Switzerland-2,1932.0,0,3,0,3
22716,Switzerland,1924.0,22,25,22,69
22717,Switzerland,1924.0,22,25,22,69
22718,Switzerland,1928.0,16,10,16,42
22719,Switzerland,1948.0,9,30,25,64
22720,Switzerland,1920.0,6,2,21,29
22721,Switzerland,1996.0,5,6,0,11
22722,Switzerland,1996.0,5,6,0,11
22723,Switzerland,1972.0,7,11,7,25
22724,Switzerland,1972.0,7,11,7,25
22725,Switzerland,1976.0,2,9,8,19
22726,Switzerland-1,1984.0,2,11,8,21
22727,Ballerina IV,1960.0,2,6,6,14
22728,Switzerland,2014.0,6,4,20,30
22729,Switzerland,1988.0,8,13,7,28
22730,Switzerland,1948.0,9,30,25,64
22731,Switzerland,1976.0,2,9,8,19
22732,Switzerland,1964.0,1,4,1,6
22733,Switzerland,1968.0,0,5,17,22
22734,Switzerland-2,1994.0,4,8,4,16
22735,Switzerland-1,1968.0,0,5,17,22
22736,Switzerland-1,2006.0,5,7,9,21
22737,Switzerland,2002.0,3,7,14,24
22738,Switzerland,1924.0,22,25,22,69
22739,Switzerland,1928.0,16,10,16,42
22740,Switzerland,1968.0,0,5,17,22
22741,Switzerland,1988.0,8,13,7,28
22742,Switzerland,1948.0,9,30,25,64
22743,Switzerland,1900.0,16,4,1,21
22744,Switzerland,1906.0,8,3,1,12
22745,Switzerland,2008.0,3,1,7,11
22746,Switzerland,2012.0,2,2,0,4
22747,Switzerland,1952.0,2,19,18,39
22748,Switzerland,1952.0,2,19,18,39
22749,Switzerland,1960.0,2,6,6,14
22750,Switzerland,1988.0,8,13,7,28
22751,Switzerland,2014.0,6,4,20,30
22752,Switzerland,1924.0,22,25,22,69
22753,Switzerland,1924.0,22,25,22,69
22754,Switzerland,1924.0,22,25,22,69
22755,Switzerland,1928.0,16,10,16,42
22756,Switzerland,1924.0,22,25,22,69
22757,Switzerland,1924.0,22,25,22,69
22758,Switzerland,1924.0,22,25,22,69
22759,Switzerland,2016.0,6,3,2,11
22760,Switzerland,1936.0,9,29,24,62
22761,Switzerland,1928.0,16,10,16,42
22762,Switzerland,1968.0,0,5,17,22
22763,Switzerland,2000.0,1,11,2,14
22764,Switzerland,2000.0,1,11,2,14
22765,Switzerland,1924.0,22,25,22,69
22766,Switzerland,1948.0,9,30,25,64
22767,Switzerland,1928.0,16,10,16,42
22768,Switzerland,1928.0,16,10,16,42
22769,Switzerland,1928.0,16,10,16,42
22770,Switzerland,1928.0,16,10,16,42
22771,Switzerland,1964.0,1,4,1,6
22772,Switzerland,1996.0,5,6,0,11
22773,Switzerland,1924.0,22,25,22,69
22774,Switzerland,1972.0,7,11,7,25
22775,Switzerland,2010.0,6,0,6,12
22776,Switzerland-2,2002.0,3,7,14,24
22777,Switzerland-1,2006.0,5,7,9,21
22778,Switzerland-1,2006.0,5,7,9,21
22779,Switzerland-1,2014.0,6,4,20,30
22780,Switzerland,1976.0,2,9,8,19
22781,Switzerland,1936.0,9,29,24,62
22782,Switzerland,1980.0,4,4,3,11
22783,Switzerland-2,2004.0,1,2,4,7
22784,Switzerland,2016.0,6,3,2,11
22785,Switzerland,1984.0,2,11,8,21
22786,Switzerland,1984.0,2,11,8,21
22787,Switzerland,1988.0,8,13,7,28
22788,Switzerland,2006.0,5,7,9,21
22789,Switzerland-1,1968.0,0,5,17,22
22790,Switzerland,1936.0,9,29,24,62
22791,Switzerland,1936.0,9,29,24,62
22792,Switzerland,1936.0,9,29,24,62
22793,Switzerland,1936.0,9,29,24,62
22794,Switzerland-1,1972.0,7,11,7,25
22795,Switzerland-1,1972.0,7,11,7,25
22796,Switzerland,2002.0,3,7,14,24
22797,Switzerland,1936.0,9,29,24,62
22798,Switzerland,1936.0,9,29,24,62
22799,Switzerland,1920.0,6,2,21,29
22800,Switzerland,1924.0,22,25,22,69
22801,Switzerland,1960.0,2,6,6,14
22802,Switzerland,1998.0,6,5,3,14
22803,Switzerland,2010.0,6,0,6,12
22804,Switzerland,1920.0,6,2,21,29
22805,Switzerland,1920.0,6,2,21,29
22806,Switzerland,1924.0,22,25,22,69
22807,Switzerland,1924.0,22,25,22,69
22808,Switzerland,1984.0,2,11,8,21
22809,Switzerland,1968.0,0,5,17,22
22810,Switzerland,1972.0,7,11,7,25
22811,Switzerland,1972.0,7,11,7,25
22812,Switzerland,1994.0,4,8,4,16
22813,Switzerland,1948.0,9,30,25,64
22814,Switzerland,1952.0,2,19,18,39
22815,Switzerland,1948.0,9,30,25,64
22816,Switzerland-1,1956.0,6,2,5,13
22817,Switzerland,1972.0,7,11,7,25
22818,Switzerland,1976.0,2,9,8,19
22819,Switzerland,1900.0,16,4,1,21
22820,Switzerland,1900.0,16,4,1,21
22821,Switzerland,1900.0,16,4,1,21
22822,Switzerland,1988.0,8,13,7,28
22823,Switzerland,1988.0,8,13,7,28
22824,Switzerland,1994.0,4,8,4,16
22825,Switzerland,2006.0,5,7,9,21
22826,Switzerland,1998.0,6,5,3,14
22827,Switzerland,1948.0,9,30,25,64
22828,Switzerland,1948.0,9,30,25,64
22829,Switzerland,1948.0,9,30,25,64
22830,Switzerland,1948.0,9,30,25,64
22831,Switzerland-2,2004.0,1,2,4,7
22832,Switzerland,1964.0,1,4,1,6
22833,Switzerland,1928.0,16,10,16,42
22834,Switzerland,1924.0,22,25,22,69
22835,Switzerland,1920.0,6,2,21,29
22836,Switzerland,1920.0,6,2,21,29
22837,Switzerland,1920.0,6,2,21,29
22838,Switzerland,1928.0,16,10,16,42
22839,Switzerland,2014.0,6,4,20,30
22840,Switzerland,1968.0,0,5,17,22
22841,Switzerland,1972.0,7,11,7,25
22842,Switzerland,1928.0,16,10,16,42
22843,Switzerland,1924.0,22,25,22,69
22844,Switzerland,1924.0,22,25,22,69
22845,Switzerland,2006.0,5,7,9,21
22846,Switzerland,2000.0,1,11,2,14
22847,Switzerland-1,2006.0,5,7,9,21
22848,Switzerland,1960.0,2,6,6,14
22849,Switzerland,1912.0,2,0,0,2
22850,Switzerland,1976.0,2,9,8,19
22851,Switzerland,1948.0,9,30,25,64
22852,Switzerland,1948.0,9,30,25,64
22853,Switzerland,1948.0,9,30,25,64
22854,Switzerland,1952.0,2,19,18,39
22855,Switzerland,2002.0,3,7,14,24
22856,Switzerland,2006.0,5,7,9,21
22857,Switzerland-1,1972.0,7,11,7,25
22858,Switzerland,1996.0,5,6,0,11
22859,Switzerland,2008.0,3,1,7,11
22860,Switzerland,1992.0,3,0,5,8
22861,Switzerland,1948.0,9,30,25,64
22862,Switzerland,1948.0,9,30,25,64
22863,Switzerland,1924.0,22,25,22,69
22864,Switzerland,1998.0,6,5,3,14
22865,Switzerland,1972.0,7,11,7,25
22866,Switzerland,1948.0,9,30,25,64
22867,Switzerland,1900.0,16,4,1,21
22868,Switzerland,1980.0,4,4,3,11
22869,Switzerland,2014.0,6,4,20,30
22870,Switzerland,1928.0,16,10,16,42
22871,Switzerland,1928.0,16,10,16,42
22872,Switzerland,1928.0,16,10,16,42
22873,Switzerland,1936.0,9,29,24,62
22874,Switzerland,1936.0,9,29,24,62
22875,Switzerland,1936.0,9,29,24,62
22876,Switzerland,1936.0,9,29,24,62
22877,Switzerland,1936.0,9,29,24,62
22878,Switzerland-1,1952.0,2,19,18,39
22879,Switzerland,2000.0,1,11,2,14
22880,Switzerland-2,1976.0,2,9,8,19
22881,Switzerland-1,1980.0,4,4,3,11
22882,Switzerland,1928.0,16,10,16,42
22883,Switzerland,1928.0,16,10,16,42
22884,Switzerland,1924.0,22,25,22,69
22885,Switzerland,2014.0,6,4,20,30
22886,Switzerland,2014.0,6,4,20,30
22887,Switzerland,2004.0,1,2,4,7
22888,Switzerland,1972.0,7,11,7,25
22889,Switzerland,2000.0,1,11,2,14
22890,Switzerland,2000.0,1,11,2,14
22891,Switzerland-1,1988.0,8,13,7,28
22892,Switzerland-1,1994.0,4,8,4,16
22893,Switzerland,1952.0,2,19,18,39
22894,Switzerland,1996.0,5,6,0,11
22895,Switzerland,2000.0,1,11,2,14
22896,Switzerland,1928.0,16,10,16,42
22897,Switzerland,1924.0,22,25,22,69
22898,Switzerland,2000.0,1,11,2,14
22899,Ballerina IV,1960.0,2,6,6,14
22900,Switzerland,2006.0,5,7,9,21
22901,Switzerland,1948.0,9,30,25,64
22902,Switzerland,1928.0,16,10,16,42
22903,Switzerland,1936.0,9,29,24,62
22904,Switzerland,1906.0,8,3,1,12
22905,Switzerland,1906.0,8,3,1,12
22906,Switzerland,1924.0,22,25,22,69
22907,Switzerland,1928.0,16,10,16,42
22908,Switzerland,1928.0,16,10,16,42
22909,Switzerland,1928.0,16,10,16,42
22910,Switzerland,1928.0,16,10,16,42
22911,Switzerland,1932.0,0,3,0,3
22912,Switzerland,1936.0,9,29,24,62
22913,Switzerland,1936.0,9,29,24,62
22914,Switzerland,1928.0,16,10,16,42
22915,Switzerland,1936.0,9,29,24,62
22916,Switzerland,1948.0,9,30,25,64
22917,Switzerland,1948.0,9,30,25,64
22918,Switzerland,1948.0,9,30,25,64
22919,Switzerland,1912.0,2,0,0,2
22920,Switzerland,1928.0,16,10,16,42
22921,Switzerland-1,1992.0,3,0,5,8
22922,Switzerland,1928.0,16,10,16,42
22923,Switzerland,1948.0,9,30,25,64
22924,Switzerland,2006.0,5,7,9,21
22925,Switzerland,1948.0,9,30,25,64
22926,Switzerland,2014.0,6,4,20,30
22927,Switzerland,1998.0,6,5,3,14
22928,Switzerland,1996.0,5,6,0,11
22929,Switzerland,1968.0,0,5,17,22
22930,Switzerland,1924.0,22,25,22,69
22931,Switzerland,1984.0,2,11,8,21
22932,Switzerland,1988.0,8,13,7,28
22933,Switzerland,1996.0,5,6,0,11
22934,Switzerland,2000.0,1,11,2,14
22935,Switzerland-2,1936.0,9,29,24,62
22936,Switzerland,2014.0,6,4,20,30
22937,Switzerland,1972.0,7,11,7,25
22938,Switzerland,1972.0,7,11,7,25
22939,Switzerland,1980.0,4,4,3,11
22940,Switzerland,2002.0,3,7,14,24
22941,Switzerland-1,1924.0,22,25,22,69
22942,Switzerland,2016.0,6,3,2,11
22943,Switzerland,1936.0,9,29,24,62
22944,Switzerland,1936.0,9,29,24,62
22945,Switzerland,1984.0,2,11,8,21
22946,Switzerland,2010.0,6,0,6,12
22947,Switzerland,1968.0,0,5,17,22
22948,Switzerland-1,1998.0,6,5,3,14
22949,Switzerland,1924.0,22,25,22,69
22950,Switzerland,1988.0,8,13,7,28
22951,Switzerland,1988.0,8,13,7,28
22952,Switzerland,1948.0,9,30,25,64
22953,Switzerland,1968.0,0,5,17,22
22954,Switzerland,1936.0,9,29,24,62
22955,Switzerland,2002.0,3,7,14,24
22956,Switzerland,2006.0,5,7,9,21
22957,Switzerland,1924.0,22,25,22,69
22958,Switzerland,2006.0,5,7,9,21
22959,Switzerland,1948.0,9,30,25,64
22960,Switzerland,1998.0,6,5,3,14
22961,Switzerland,1924.0,22,25,22,69
22962,Switzerland,1928.0,16,10,16,42
22963,Switzerland,1920.0,6,2,21,29
22964,Switzerland,2014.0,6,4,20,30
22965,Switzerland,1976.0,2,9,8,19
22966,Switzerland,1924.0,22,25,22,69
22967,Switzerland,1948.0,9,30,25,64
22968,Switzerland,1948.0,9,30,25,64
22969,Switzerland,1924.0,22,25,22,69
22970,Switzerland,1924.0,22,25,22,69
22971,Switzerland,1900.0,16,4,1,21
22972,Switzerland,1924.0,22,25,22,69
22973,Switzerland,1988.0,8,13,7,28
22974,Switzerland,1976.0,2,9,8,19
22975,Switzerland,1924.0,22,25,22,69
22976,Switzerland,2002.0,3,7,14,24
22977,Switzerland,2014.0,6,4,20,30
22978,Switzerland,1924.0,22,25,22,69
22979,Switzerland,1924.0,22,25,22,69
22980,Switzerland-1,2002.0,3,7,14,24
22981,Switzerland,1906.0,8,3,1,12
22982,Switzerland,1906.0,8,3,1,12
22983,Switzerland,1906.0,8,3,1,12
22984,Switzerland,1948.0,9,30,25,64
22985,Switzerland,1948.0,9,30,25,64
22986,Switzerland,1924.0,22,25,22,69
22987,Switzerland,1936.0,9,29,24,62
22988,Switzerland,1936.0,9,29,24,62
22989,Switzerland,1948.0,9,30,25,64
22990,Switzerland,1948.0,9,30,25,64
22991,Switzerland,1948.0,9,30,25,64
22992,Switzerland,2002.0,3,7,14,24
22993,Switzerland,1924.0,22,25,22,69
22994,Switzerland,1996.0,5,6,0,11
22995,Switzerland,1900.0,16,4,1,21
22996,Switzerland,1900.0,16,4,1,21
22997,Switzerland,1906.0,8,3,1,12
22998,Switzerland,1906.0,8,3,1,12
22999,Switzerland,1906.0,8,3,1,12
23000,Switzerland,1906.0,8,3,1,12
23001,Switzerland,2004.0,1,2,4,7
23002,Switzerland,2004.0,1,2,4,7
23003,Switzerland,1984.0,2,11,8,21
23004,Switzerland,2002.0,3,7,14,24
23005,Switzerland,1900.0,16,4,1,21
23006,Switzerland,1900.0,16,4,1,21
23007,Switzerland-1,1998.0,6,5,3,14
23008,Switzerland,2000.0,1,11,2,14
23009,Switzerland,1992.0,3,0,5,8
23010,Switzerland,1920.0,6,2,21,29
23011,Switzerland,1976.0,2,9,8,19
23012,Switzerland,1980.0,4,4,3,11
23013,Switzerland,2002.0,3,7,14,24
23014,Switzerland,1920.0,6,2,21,29
23015,Switzerland,1920.0,6,2,21,29
23016,Switzerland,1948.0,9,30,25,64
23017,Switzerland,1928.0,16,10,16,42
23018,Switzerland,1960.0,2,6,6,14
23019,Switzerland,1952.0,2,19,18,39
23020,Switzerland,1960.0,2,6,6,14
23021,Switzerland,1972.0,7,11,7,25
23022,Switzerland,1976.0,2,9,8,19
23023,Switzerland,1984.0,2,11,8,21
23024,Switzerland,1920.0,6,2,21,29
23025,Switzerland-1,1984.0,2,11,8,21
23026,Switzerland,2000.0,1,11,2,14
23027,Switzerland,1988.0,8,13,7,28
23028,Switzerland,1994.0,4,8,4,16
23029,Switzerland,1936.0,9,29,24,62
23030,Switzerland-1,1976.0,2,9,8,19
23031,Switzerland-2,1976.0,2,9,8,19
23032,Switzerland-2,1980.0,4,4,3,11
23033,Switzerland-1,1980.0,4,4,3,11
23034,Switzerland,1924.0,22,25,22,69
23035,Switzerland,1988.0,8,13,7,28
23036,Switzerland,1952.0,2,19,18,39
23037,Switzerland,2014.0,6,4,20,30
23038,Switzerland-1,1924.0,22,25,22,69
23039,Switzerland,1936.0,9,29,24,62
23040,Switzerland,2006.0,5,7,9,21
23041,Switzerland-1,1992.0,3,0,5,8
23042,Switzerland,1948.0,9,30,25,64
23043,Switzerland-1,1924.0,22,25,22,69
23044,Switzerland-1,1924.0,22,25,22,69
23045,Switzerland,1948.0,9,30,25,64
23046,Switzerland,1936.0,9,29,24,62
23047,Switzerland,1936.0,9,29,24,62
23048,Switzerland,1936.0,9,29,24,62
23049,Switzerland,1952.0,2,19,18,39
23050,Switzerland,2010.0,6,0,6,12
23051,Switzerland,1924.0,22,25,22,69
23052,Switzerland,1936.0,9,29,24,62
23053,Switzerland,1920.0,6,2,21,29
23054,Switzerland,1920.0,6,2,21,29
23055,Switzerland,1924.0,22,25,22,69
23056,Switzerland,1988.0,8,13,7,28
23057,Switzerland,1988.0,8,13,7,28
23058,Switzerland,1994.0,4,8,4,16
23059,Switzerland,1994.0,4,8,4,16
23060,Switzerland,1994.0,4,8,4,16
23061,Switzerland,1948.0,9,30,25,64
23062,Switzerland,2002.0,3,7,14,24
23063,Switzerland,2006.0,5,7,9,21
23064,Switzerland,2006.0,5,7,9,21
23065,Switzerland,1928.0,16,10,16,42
23066,Switzerland,1928.0,16,10,16,42
23067,Switzerland,1994.0,4,8,4,16
23068,Switzerland,1936.0,9,29,24,62
23069,Switzerland,1948.0,9,30,25,64
23070,Switzerland,1948.0,9,30,25,64
23071,Switzerland,2016.0,6,3,2,11
23072,Switzerland,2008.0,3,1,7,11
23073,Switzerland,2008.0,3,1,7,11
23074,Switzerland,2012.0,2,2,0,4
23075,Switzerland,2016.0,6,3,2,11
23076,Switzerland,1936.0,9,29,24,62
23077,Switzerland,1948.0,9,30,25,64
23078,Switzerland,1952.0,2,19,18,39
23079,Switzerland,2002.0,3,7,14,24
23080,Switzerland,2002.0,3,7,14,24
23081,Switzerland,1960.0,2,6,6,14
23082,Switzerland,1952.0,2,19,18,39
23083,Switzerland,1928.0,16,10,16,42
23084,Switzerland,1988.0,8,13,7,28
23085,Switzerland,2008.0,3,1,7,11
23086,Switzerland,1936.0,9,29,24,62
23087,Switzerland-1,1998.0,6,5,3,14
23088,Switzerland-1,1994.0,4,8,4,16
23089,Switzerland,1920.0,6,2,21,29
23090,Switzerland,1924.0,22,25,22,69
23091,Switzerland,1924.0,22,25,22,69
23092,Switzerland,1998.0,6,5,3,14
23093,Switzerland,2006.0,5,7,9,21
23094,Switzerland,1960.0,2,6,6,14
23095,Switzerland,1904.0,1,0,2,3
23096,Switzerland,1904.0,1,0,2,3
23097,Switzerland,2012.0,2,2,0,4
23098,Switzerland,2016.0,6,3,2,11
23099,Switzerland,1936.0,9,29,24,62
23100,Switzerland,1900.0,16,4,1,21
23101,Switzerland,1900.0,16,4,1,21
23102,Switzerland,1900.0,16,4,1,21
23103,Switzerland,1900.0,16,4,1,21
23104,Switzerland,1906.0,8,3,1,12
23105,Switzerland,1906.0,8,3,1,12
23106,Switzerland,2002.0,3,7,14,24
23107,Switzerland,2006.0,5,7,9,21
23108,Switzerland,2014.0,6,4,20,30
23109,Switzerland,1948.0,9,30,25,64
23110,Switzerland,1948.0,9,30,25,64
23111,Switzerland,1948.0,9,30,25,64
23112,Switzerland,1952.0,2,19,18,39
23113,Switzerland,1952.0,2,19,18,39
23114,Switzerland,1952.0,2,19,18,39
23115,Switzerland,1952.0,2,19,18,39
23116,Switzerland,2014.0,6,4,20,30
23117,Switzerland,1920.0,6,2,21,29
23118,Switzerland,1960.0,2,6,6,14
23119,Switzerland,1948.0,9,30,25,64
23120,Switzerland,1928.0,16,10,16,42
23121,Switzerland,1936.0,9,29,24,62
23122,Switzerland,1972.0,7,11,7,25
23123,Switzerland,2016.0,6,3,2,11
23124,Switzerland,1968.0,0,5,17,22
23125,Switzerland-1,1984.0,2,11,8,21
23126,Switzerland,2014.0,6,4,20,30
23127,Switzerland-1,1988.0,8,13,7,28
23128,Switzerland,1948.0,9,30,25,64
23129,Switzerland,2010.0,6,0,6,12
23130,Switzerland,1936.0,9,29,24,62
23131,Switzerland,2010.0,6,0,6,12
23132,Switzerland,1924.0,22,25,22,69
23133,Switzerland,1976.0,2,9,8,19
23134,Switzerland,1976.0,2,9,8,19
23135,Switzerland,1984.0,2,11,8,21
23136,Switzerland,1988.0,8,13,7,28
23137,Switzerland,1988.0,8,13,7,28
23138,Switzerland,1948.0,9,30,25,64
23139,Switzerland,1936.0,9,29,24,62
23140,Switzerland,1924.0,22,25,22,69
23141,Switzerland,1972.0,7,11,7,25
23142,Switzerland,1976.0,2,9,8,19
23143,Switzerland,1948.0,9,30,25,64
23144,Switzerland,1952.0,2,19,18,39
23145,Switzerland,2014.0,6,4,20,30
23146,Switzerland,1924.0,22,25,22,69
23147,Switzerland,2004.0,1,2,4,7
23148,Switzerland,2008.0,3,1,7,11
23149,Switzerland,1904.0,1,0,2,3
23150,Switzerland,1928.0,16,10,16,42
23151,Switzerland,1948.0,9,30,25,64
23152,Switzerland,1952.0,2,19,18,39
23153,Switzerland,1956.0,6,2,5,13
23154,Switzerland,2016.0,6,3,2,11
23155,Switzerland,1948.0,9,30,25,64
23156,Switzerland,1984.0,2,11,8,21
23157,Switzerland,1952.0,2,19,18,39
23158,Switzerland,1952.0,2,19,18,39
23159,Switzerland,1924.0,22,25,22,69
23160,Switzerland,1984.0,2,11,8,21
23161,Switzerland,2014.0,6,4,20,30
23162,Switzerland,1924.0,22,25,22,69
23163,Switzerland,1998.0,6,5,3,14
23164,Switzerland,2014.0,6,4,20,30
23165,Switzerland-2,1948.0,9,30,25,64
23166,Switzerland,1984.0,2,11,8,21
23167,Switzerland,1988.0,8,13,7,28
23168,Switzerland,1988.0,8,13,7,28
23169,Switzerland,1920.0,6,2,21,29
23170,Switzerland,1924.0,22,25,22,69
23171,Switzerland,1924.0,22,25,22,69
23172,Switzerland,1936.0,9,29,24,62
23173,Switzerland,1936.0,9,29,24,62
23174,Switzerland-1,1956.0,6,2,5,13
23175,Switzerland,1968.0,0,5,17,22
23176,Switzerland-1,1952.0,2,19,18,39
23177,Switzerland-1,1952.0,2,19,18,39
23178,Switzerland-1,1998.0,6,5,3,14
23179,Switzerland,2008.0,3,1,7,11
23180,Switzerland,1936.0,9,29,24,62
23181,Switzerland-1,1992.0,3,0,5,8
23182,Switzerland-1,1992.0,3,0,5,8
23183,Switzerland-1,1994.0,4,8,4,16
23184,Switzerland-1,1994.0,4,8,4,16
23185,Switzerland,1920.0,6,2,21,29
23186,Switzerland,1952.0,2,19,18,39
23187,Switzerland,1924.0,22,25,22,69
23188,Switzerland,1928.0,16,10,16,42
23189,Switzerland-1,1968.0,0,5,17,22
23190,Switzerland-1,1972.0,7,11,7,25
23191,Switzerland-1,1972.0,7,11,7,25
23192,Switzerland,1924.0,22,25,22,69
23193,Switzerland,1924.0,22,25,22,69
23194,Switzerland,1924.0,22,25,22,69
23195,Switzerland,1936.0,9,29,24,62
23196,Switzerland,1984.0,2,11,8,21
23197,Switzerland,1948.0,9,30,25,64
23198,Switzerland,1952.0,2,19,18,39
23199,Switzerland,1952.0,2,19,18,39
23200,Switzerland,1920.0,6,2,21,29
23201,Switzerland,1920.0,6,2,21,29
23202,Switzerland,1988.0,8,13,7,28
23203,Switzerland,1988.0,8,13,7,28
23204,Switzerland,2010.0,6,0,6,12
23205,Switzerland,1896.0,1,2,0,3
23206,Switzerland,1896.0,1,2,0,3
23207,Switzerland,1896.0,1,2,0,3
23208,East Germany,1972.0,35,67,69,171
23209,East Germany,1976.0,114,57,56,227
23210,East Germany,1980.0,131,99,73,303
23211,East Germany-1,1972.0,35,67,69,171
23212,East Germany,1988.0,89,69,55,213
23213,East Germany,1980.0,131,99,73,303
23214,East Germany,1976.0,114,57,56,227
23215,East Germany,1976.0,114,57,56,227
23216,East Germany,1976.0,114,57,56,227
23217,East Germany,1980.0,131,99,73,303
23218,East Germany,1980.0,131,99,73,303
23219,East Germany,1988.0,89,69,55,213
23220,East Germany-1,1976.0,114,57,56,227
23221,East Germany,1976.0,114,57,56,227
23222,East Germany,1976.0,114,57,56,227
23223,East Germany,1972.0,35,67,69,171
23224,East Germany,1980.0,131,99,73,303
23225,East Germany,1988.0,89,69,55,213
23226,East Germany,1988.0,89,69,55,213
23227,East Germany,1980.0,131,99,73,303
23228,East Germany,1968.0,15,22,21,58
23229,East Germany,1980.0,131,99,73,303
23230,East Germany,1976.0,114,57,56,227
23231,East Germany,1976.0,114,57,56,227
23232,East Germany,1980.0,131,99,73,303
23233,East Germany,1980.0,131,99,73,303
23234,East Germany,1980.0,131,99,73,303
23235,East Germany,1980.0,131,99,73,303
23236,East Germany,1968.0,15,22,21,58
23237,East Germany,1976.0,114,57,56,227
23238,East Germany,1988.0,89,69,55,213
23239,East Germany,1988.0,89,69,55,213
23240,East Germany,1988.0,89,69,55,213
23241,East Germany,1988.0,89,69,55,213
23242,East Germany-2,1988.0,89,69,55,213
23243,East Germany,1988.0,89,69,55,213
23244,East Germany,1988.0,89,69,55,213
23245,East Germany,1968.0,15,22,21,58
23246,East Germany,1972.0,35,67,69,171
23247,East Germany,1972.0,35,67,69,171
23248,East Germany,1976.0,114,57,56,227
23249,East Germany,1976.0,114,57,56,227
23250,East Germany-1,1980.0,131,99,73,303
23251,East Germany,1980.0,131,99,73,303
23252,East Germany,1976.0,114,57,56,227
23253,East Germany,1980.0,131,99,73,303
23254,East Germany,1976.0,114,57,56,227
23255,East Germany,1980.0,131,99,73,303
23256,East Germany,1988.0,89,69,55,213
23257,East Germany,1988.0,89,69,55,213
23258,East Germany,1988.0,89,69,55,213
23259,East Germany,1980.0,131,99,73,303
23260,East Germany,1976.0,114,57,56,227
23261,East Germany,1976.0,114,57,56,227
23262,East Germany,1980.0,131,99,73,303
23263,East Germany,1976.0,114,57,56,227
23264,East Germany,1988.0,89,69,55,213
23265,East Germany,1972.0,35,67,69,171
23266,East Germany,1972.0,35,67,69,171
23267,East Germany,1976.0,114,57,56,227
23268,East Germany,1968.0,15,22,21,58
23269,East Germany-1,1968.0,15,22,21,58
23270,East Germany-2,1972.0,35,67,69,171
23271,East Germany,1976.0,114,57,56,227
23272,East Germany,1980.0,131,99,73,303
23273,East Germany,1968.0,15,22,21,58
23274,East Germany,1972.0,35,67,69,171
23275,East Germany,1972.0,35,67,69,171
23276,East Germany,1968.0,15,22,21,58
23277,East Germany,1972.0,35,67,69,171
23278,East Germany,1976.0,114,57,56,227
23279,East Germany,1988.0,89,69,55,213
23280,East Germany-1,1972.0,35,67,69,171
23281,East Germany,1968.0,15,22,21,58
23282,East Germany,1972.0,35,67,69,171
23283,East Germany,1976.0,114,57,56,227
23284,East Germany,1976.0,114,57,56,227
23285,East Germany,1980.0,131,99,73,303
23286,East Germany,1980.0,131,99,73,303
23287,East Germany,1988.0,89,69,55,213
23288,East Germany,1972.0,35,67,69,171
23289,East Germany,1972.0,35,67,69,171
23290,East Germany,1976.0,114,57,56,227
23291,East Germany,1980.0,131,99,73,303
23292,East Germany,1980.0,131,99,73,303
23293,East Germany,1972.0,35,67,69,171
23294,East Germany,1976.0,114,57,56,227
23295,East Germany,1976.0,114,57,56,227
23296,East Germany,1980.0,131,99,73,303
23297,East Germany,1980.0,131,99,73,303
23298,East Germany,1980.0,131,99,73,303
23299,East Germany,1980.0,131,99,73,303
23300,East Germany,1988.0,89,69,55,213
23301,East Germany,1972.0,35,67,69,171
23302,East Germany,1988.0,89,69,55,213
23303,East Germany,1980.0,131,99,73,303
23304,East Germany,1980.0,131,99,73,303
23305,East Germany,1976.0,114,57,56,227
23306,East Germany,1988.0,89,69,55,213
23307,East Germany,1976.0,114,57,56,227
23308,East Germany,1976.0,114,57,56,227
23309,East Germany,1980.0,131,99,73,303
23310,East Germany,1972.0,35,67,69,171
23311,East Germany,1976.0,114,57,56,227
23312,East Germany,1980.0,131,99,73,303
23313,East Germany,1968.0,15,22,21,58
23314,East Germany,1980.0,131,99,73,303
23315,East Germany,1976.0,114,57,56,227
23316,East Germany,1980.0,131,99,73,303
23317,East Germany,1976.0,114,57,56,227
23318,East Germany,1976.0,114,57,56,227
23319,East Germany,1988.0,89,69,55,213
23320,East Germany,1988.0,89,69,55,213
23321,East Germany,1988.0,89,69,55,213
23322,East Germany,1976.0,114,57,56,227
23323,East Germany,1976.0,114,57,56,227
23324,East Germany,1980.0,131,99,73,303
23325,East Germany,1980.0,131,99,73,303
23326,East Germany,1980.0,131,99,73,303
23327,East Germany,1980.0,131,99,73,303
23328,East Germany,1980.0,131,99,73,303
23329,East Germany,1980.0,131,99,73,303
23330,East Germany,1980.0,131,99,73,303
23331,East Germany,1976.0,114,57,56,227
23332,East Germany,1980.0,131,99,73,303
23333,East Germany,1976.0,114,57,56,227
23334,East Germany,1980.0,131,99,73,303
23335,East Germany,1968.0,15,22,21,58
23336,East Germany,1972.0,35,67,69,171
23337,East Germany,1988.0,89,69,55,213
23338,East Germany,1988.0,89,69,55,213
23339,East Germany,1980.0,131,99,73,303
23340,East Germany,1980.0,131,99,73,303
23341,East Germany,1976.0,114,57,56,227
23342,East Germany,1980.0,131,99,73,303
23343,East Germany,1976.0,114,57,56,227
23344,East Germany,1976.0,114,57,56,227
23345,East Germany,1980.0,131,99,73,303
23346,East Germany,1976.0,114,57,56,227
23347,East Germany,1988.0,89,69,55,213
23348,East Germany,1988.0,89,69,55,213
23349,East Germany,1988.0,89,69,55,213
23350,East Germany,1988.0,89,69,55,213
23351,East Germany,1972.0,35,67,69,171
23352,East Germany,1980.0,131,99,73,303
23353,East Germany,1976.0,114,57,56,227
23354,East Germany,1980.0,131,99,73,303
23355,East Germany,1980.0,131,99,73,303
23356,East Germany,1980.0,131,99,73,303
23357,East Germany,1972.0,35,67,69,171
23358,East Germany,1980.0,131,99,73,303
23359,East Germany,1980.0,131,99,73,303
23360,East Germany,1976.0,114,57,56,227
23361,East Germany,1980.0,131,99,73,303
23362,East Germany,1976.0,114,57,56,227
23363,East Germany,1976.0,114,57,56,227
23364,East Germany,1976.0,114,57,56,227
23365,East Germany,1980.0,131,99,73,303
23366,East Germany,1980.0,131,99,73,303
23367,East Germany,1972.0,35,67,69,171
23368,East Germany,1972.0,35,67,69,171
23369,East Germany,1976.0,114,57,56,227
23370,East Germany,1984.0,13,13,7,33
23371,East Germany,1984.0,13,13,7,33
23372,East Germany,1984.0,13,13,7,33
23373,East Germany,1988.0,89,69,55,213
23374,East Germany,1988.0,89,69,55,213
23375,East Germany,1988.0,89,69,55,213
23376,East Germany,1972.0,35,67,69,171
23377,East Germany,1972.0,35,67,69,171
23378,East Germany,1988.0,89,69,55,213
23379,East Germany,1972.0,35,67,69,171
23380,East Germany,1988.0,89,69,55,213
23381,East Germany,1972.0,35,67,69,171
23382,East Germany,1972.0,35,67,69,171
23383,East Germany,1972.0,35,67,69,171
23384,East Germany,1976.0,114,57,56,227
23385,East Germany,1976.0,114,57,56,227
23386,East Germany,1976.0,114,57,56,227
23387,East Germany,1976.0,114,57,56,227
23388,East Germany,1976.0,114,57,56,227
23389,East Germany,1976.0,114,57,56,227
23390,East Germany,1980.0,131,99,73,303
23391,East Germany,1984.0,13,13,7,33
23392,East Germany,1984.0,13,13,7,33
23393,East Germany,1984.0,13,13,7,33
23394,East Germany,1984.0,13,13,7,33
23395,East Germany,1988.0,89,69,55,213
23396,East Germany,1988.0,89,69,55,213
23397,East Germany,1988.0,89,69,55,213
23398,East Germany,1976.0,114,57,56,227
23399,East Germany,1976.0,114,57,56,227
23400,East Germany,1988.0,89,69,55,213
23401,East Germany,1980.0,131,99,73,303
23402,East Germany,1980.0,131,99,73,303
23403,East Germany,1988.0,89,69,55,213
23404,East Germany,1972.0,35,67,69,171
23405,East Germany-2,1972.0,35,67,69,171
23406,East Germany,1980.0,131,99,73,303
23407,East Germany,1980.0,131,99,73,303
23408,East Germany,1988.0,89,69,55,213
23409,East Germany,1988.0,89,69,55,213
23410,East Germany,1988.0,89,69,55,213
23411,East Germany,1988.0,89,69,55,213
23412,East Germany,1988.0,89,69,55,213
23413,East Germany,1988.0,89,69,55,213
23414,East Germany,1972.0,35,67,69,171
23415,East Germany,1968.0,15,22,21,58
23416,East Germany,1972.0,35,67,69,171
23417,East Germany,1988.0,89,69,55,213
23418,East Germany,1988.0,89,69,55,213
23419,East Germany,1980.0,131,99,73,303
23420,East Germany,1972.0,35,67,69,171
23421,East Germany,1976.0,114,57,56,227
23422,East Germany,1988.0,89,69,55,213
23423,East Germany,1988.0,89,69,55,213
23424,East Germany,1988.0,89,69,55,213
23425,East Germany,1980.0,131,99,73,303
23426,East Germany,1980.0,131,99,73,303
23427,East Germany,1972.0,35,67,69,171
23428,East Germany,1976.0,114,57,56,227
23429,East Germany,1968.0,15,22,21,58
23430,East Germany,1988.0,89,69,55,213
23431,East Germany,1972.0,35,67,69,171
23432,East Germany,1980.0,131,99,73,303
23433,East Germany,1988.0,89,69,55,213
23434,East Germany,1980.0,131,99,73,303
23435,East Germany,1968.0,15,22,21,58
23436,East Germany,1980.0,131,99,73,303
23437,East Germany-2,1980.0,131,99,73,303
23438,East Germany-1,1980.0,131,99,73,303
23439,East Germany,1980.0,131,99,73,303
23440,East Germany-2,1976.0,114,57,56,227
23441,East Germany-1,1976.0,114,57,56,227
23442,East Germany-2,1980.0,131,99,73,303
23443,East Germany-1,1980.0,131,99,73,303
23444,East Germany,1976.0,114,57,56,227
23445,East Germany,1972.0,35,67,69,171
23446,East Germany,1976.0,114,57,56,227
23447,East Germany,1980.0,131,99,73,303
23448,East Germany,1980.0,131,99,73,303
23449,East Germany,1976.0,114,57,56,227
23450,East Germany,1972.0,35,67,69,171
23451,East Germany,1976.0,114,57,56,227
23452,East Germany,1980.0,131,99,73,303
23453,East Germany,1980.0,131,99,73,303
23454,East Germany,1980.0,131,99,73,303
23455,East Germany,1980.0,131,99,73,303
23456,East Germany,1980.0,131,99,73,303
23457,East Germany,1968.0,15,22,21,58
23458,East Germany,1976.0,114,57,56,227
23459,East Germany,1972.0,35,67,69,171
23460,East Germany,1980.0,131,99,73,303
23461,East Germany,1968.0,15,22,21,58
23462,East Germany,1972.0,35,67,69,171
23463,East Germany,1976.0,114,57,56,227
23464,East Germany,1980.0,131,99,73,303
23465,East Germany,1968.0,15,22,21,58
23466,East Germany,1988.0,89,69,55,213
23467,East Germany,1976.0,114,57,56,227
23468,East Germany-1,1972.0,35,67,69,171
23469,East Germany-2,1976.0,114,57,56,227
23470,East Germany,1980.0,131,99,73,303
23471,East Germany,1968.0,15,22,21,58
23472,East Germany,1976.0,114,57,56,227
23473,East Germany,1972.0,35,67,69,171
23474,East Germany,1972.0,35,67,69,171
23475,East Germany,1976.0,114,57,56,227
23476,East Germany,1972.0,35,67,69,171
23477,East Germany,1976.0,114,57,56,227
23478,East Germany,1972.0,35,67,69,171
23479,East Germany,1980.0,131,99,73,303
23480,East Germany,1988.0,89,69,55,213
23481,East Germany,1988.0,89,69,55,213
23482,East Germany,1972.0,35,67,69,171
23483,East Germany,1976.0,114,57,56,227
23484,East Germany,1972.0,35,67,69,171
23485,East Germany-1,1976.0,114,57,56,227
23486,East Germany-1,1980.0,131,99,73,303
23487,East Germany,1980.0,131,99,73,303
23488,East Germany,1976.0,114,57,56,227
23489,East Germany,1980.0,131,99,73,303
23490,East Germany,1980.0,131,99,73,303
23491,East Germany,1972.0,35,67,69,171
23492,East Germany,1980.0,131,99,73,303
23493,East Germany,1976.0,114,57,56,227
23494,East Germany,1980.0,131,99,73,303
23495,East Germany,1980.0,131,99,73,303
23496,East Germany,1980.0,131,99,73,303
23497,East Germany,1972.0,35,67,69,171
23498,East Germany,1980.0,131,99,73,303
23499,East Germany,1972.0,35,67,69,171
23500,East Germany,1976.0,114,57,56,227
23501,East Germany,1988.0,89,69,55,213
23502,East Germany,1976.0,114,57,56,227
23503,East Germany,1976.0,114,57,56,227
23504,East Germany,1976.0,114,57,56,227
23505,East Germany,1980.0,131,99,73,303
23506,East Germany,1980.0,131,99,73,303
23507,East Germany,1980.0,131,99,73,303
23508,East Germany,1968.0,15,22,21,58
23509,East Germany,1972.0,35,67,69,171
23510,East Germany,1980.0,131,99,73,303
23511,East Germany,1976.0,114,57,56,227
23512,East Germany,1988.0,89,69,55,213
23513,East Germany,1968.0,15,22,21,58
23514,East Germany,1980.0,131,99,73,303
23515,East Germany,1972.0,35,67,69,171
23516,East Germany,1988.0,89,69,55,213
23517,East Germany,1976.0,114,57,56,227
23518,East Germany,1980.0,131,99,73,303
23519,East Germany,1988.0,89,69,55,213
23520,East Germany,1976.0,114,57,56,227
23521,East Germany,1980.0,131,99,73,303
23522,East Germany,1980.0,131,99,73,303
23523,East Germany,1980.0,131,99,73,303
23524,East Germany,1988.0,89,69,55,213
23525,East Germany,1988.0,89,69,55,213
23526,East Germany,1980.0,131,99,73,303
23527,East Germany,1980.0,131,99,73,303
23528,East Germany,1988.0,89,69,55,213
23529,East Germany,1988.0,89,69,55,213
23530,East Germany,1976.0,114,57,56,227
23531,East Germany,1988.0,89,69,55,213
23532,East Germany,1980.0,131,99,73,303
23533,East Germany,1980.0,131,99,73,303
23534,East Germany-1,1984.0,13,13,7,33
23535,East Germany-1,1988.0,89,69,55,213
23536,East Germany,1980.0,131,99,73,303
23537,East Germany,1976.0,114,57,56,227
23538,East Germany,1988.0,89,69,55,213
23539,East Germany,1972.0,35,67,69,171
23540,East Germany,1972.0,35,67,69,171
23541,East Germany,1976.0,114,57,56,227
23542,East Germany-1,1972.0,35,67,69,171
23543,East Germany,1980.0,131,99,73,303
23544,East Germany,1968.0,15,22,21,58
23545,East Germany,1980.0,131,99,73,303
23546,East Germany,1980.0,131,99,73,303
23547,East Germany-2,1984.0,13,13,7,33
23548,East Germany-1,1984.0,13,13,7,33
23549,East Germany-1,1988.0,89,69,55,213
23550,East Germany-1,1988.0,89,69,55,213
23551,East Germany,1972.0,35,67,69,171
23552,East Germany,1988.0,89,69,55,213
23553,East Germany,1988.0,89,69,55,213
23554,East Germany,1988.0,89,69,55,213
23555,East Germany,1988.0,89,69,55,213
23556,East Germany-1,1972.0,35,67,69,171
23557,East Germany,1972.0,35,67,69,171
23558,East Germany-2,1988.0,89,69,55,213
23559,East Germany,1980.0,131,99,73,303
23560,East Germany,1980.0,131,99,73,303
23561,East Germany,1988.0,89,69,55,213
23562,East Germany,1988.0,89,69,55,213
23563,East Germany,1988.0,89,69,55,213
23564,East Germany,1972.0,35,67,69,171
23565,East Germany,1976.0,114,57,56,227
23566,East Germany,1972.0,35,67,69,171
23567,East Germany,1968.0,15,22,21,58
23568,East Germany,1984.0,13,13,7,33
23569,East Germany,1976.0,114,57,56,227
23570,East Germany,1976.0,114,57,56,227
23571,East Germany,1976.0,114,57,56,227
23572,East Germany,1980.0,131,99,73,303
23573,East Germany,1988.0,89,69,55,213
23574,East Germany,1980.0,131,99,73,303
23575,East Germany,1972.0,35,67,69,171
23576,East Germany,1972.0,35,67,69,171
23577,East Germany,1968.0,15,22,21,58
23578,East Germany,1968.0,15,22,21,58
23579,East Germany,1972.0,35,67,69,171
23580,East Germany,1972.0,35,67,69,171
23581,East Germany,1972.0,35,67,69,171
23582,East Germany,1972.0,35,67,69,171
23583,East Germany,1972.0,35,67,69,171
23584,East Germany,1980.0,131,99,73,303
23585,East Germany,1980.0,131,99,73,303
23586,East Germany,1988.0,89,69,55,213
23587,East Germany,1972.0,35,67,69,171
23588,East Germany,1988.0,89,69,55,213
23589,East Germany,1980.0,131,99,73,303
23590,East Germany,1972.0,35,67,69,171
23591,East Germany-1,1972.0,35,67,69,171
23592,East Germany-2,1976.0,114,57,56,227
23593,East Germany,1976.0,114,57,56,227
23594,East Germany,1980.0,131,99,73,303
23595,East Germany,1976.0,114,57,56,227
23596,East Germany,1980.0,131,99,73,303
23597,East Germany,1972.0,35,67,69,171
23598,East Germany,1972.0,35,67,69,171
23599,East Germany,1980.0,131,99,73,303
23600,East Germany,1972.0,35,67,69,171
23601,East Germany,1972.0,35,67,69,171
23602,East Germany-1,1976.0,114,57,56,227
23603,East Germany,1988.0,89,69,55,213
23604,East Germany,1988.0,89,69,55,213
23605,East Germany,1980.0,131,99,73,303
23606,East Germany,1988.0,89,69,55,213
23607,East Germany-2,1980.0,131,99,73,303
23608,East Germany-1,1984.0,13,13,7,33
23609,East Germany,1980.0,131,99,73,303
23610,East Germany,1976.0,114,57,56,227
23611,East Germany,1976.0,114,57,56,227
23612,East Germany,1976.0,114,57,56,227
23613,East Germany,1976.0,114,57,56,227
23614,East Germany,1976.0,114,57,56,227
23615,East Germany,1976.0,114,57,56,227
23616,East Germany,1988.0,89,69,55,213
23617,East Germany,1980.0,131,99,73,303
23618,East Germany,1980.0,131,99,73,303
23619,East Germany,1988.0,89,69,55,213
23620,East Germany,1972.0,35,67,69,171
23621,East Germany,1976.0,114,57,56,227
23622,East Germany,1988.0,89,69,55,213
23623,East Germany,1980.0,131,99,73,303
23624,East Germany,1972.0,35,67,69,171
23625,East Germany,1972.0,35,67,69,171
23626,East Germany,1980.0,131,99,73,303
23627,East Germany,1976.0,114,57,56,227
23628,East Germany,1980.0,131,99,73,303
23629,East Germany,1988.0,89,69,55,213
23630,East Germany,1980.0,131,99,73,303
23631,East Germany,1980.0,131,99,73,303
23632,East Germany,1976.0,114,57,56,227
23633,East Germany,1968.0,15,22,21,58
23634,East Germany-1,1968.0,15,22,21,58
23635,East Germany,1976.0,114,57,56,227
23636,East Germany,1980.0,131,99,73,303
23637,East Germany,1980.0,131,99,73,303
23638,East Germany,1988.0,89,69,55,213
23639,East Germany,1972.0,35,67,69,171
23640,East Germany,1968.0,15,22,21,58
23641,East Germany,1972.0,35,67,69,171
23642,East Germany,1972.0,35,67,69,171
23643,East Germany,1976.0,114,57,56,227
23644,East Germany,1980.0,131,99,73,303
23645,East Germany,1976.0,114,57,56,227
23646,East Germany,1976.0,114,57,56,227
23647,East Germany,1976.0,114,57,56,227
23648,East Germany,1976.0,114,57,56,227
23649,East Germany,1980.0,131,99,73,303
23650,East Germany,1980.0,131,99,73,303
23651,East Germany,1980.0,131,99,73,303
23652,East Germany,1980.0,131,99,73,303
23653,East Germany,1980.0,131,99,73,303
23654,East Germany,1980.0,131,99,73,303
23655,East Germany,1980.0,131,99,73,303
23656,East Germany,1968.0,15,22,21,58
23657,East Germany,1976.0,114,57,56,227
23658,East Germany,1980.0,131,99,73,303
23659,East Germany,1976.0,114,57,56,227
23660,East Germany-2,1988.0,89,69,55,213
23661,East Germany,1972.0,35,67,69,171
23662,East Germany,1968.0,15,22,21,58
23663,East Germany,1976.0,114,57,56,227
23664,East Germany,1980.0,131,99,73,303
23665,East Germany,1988.0,89,69,55,213
23666,East Germany,1988.0,89,69,55,213
23667,East Germany,1980.0,131,99,73,303
23668,East Germany,1980.0,131,99,73,303
23669,East Germany,1980.0,131,99,73,303
23670,East Germany,1980.0,131,99,73,303
23671,East Germany,1980.0,131,99,73,303
23672,East Germany,1988.0,89,69,55,213
23673,East Germany,1980.0,131,99,73,303
23674,East Germany,1980.0,131,99,73,303
23675,East Germany,1972.0,35,67,69,171
23676,East Germany,1988.0,89,69,55,213
23677,East Germany,1980.0,131,99,73,303
23678,East Germany,1968.0,15,22,21,58
23679,East Germany,1980.0,131,99,73,303
23680,East Germany,1988.0,89,69,55,213
23681,East Germany,1988.0,89,69,55,213
23682,East Germany,1976.0,114,57,56,227
23683,East Germany,1972.0,35,67,69,171
23684,East Germany,1976.0,114,57,56,227
23685,East Germany,1976.0,114,57,56,227
23686,East Germany,1976.0,114,57,56,227
23687,East Germany,1988.0,89,69,55,213
23688,East Germany,1972.0,35,67,69,171
23689,East Germany,1976.0,114,57,56,227
23690,East Germany,1980.0,131,99,73,303
23691,East Germany,1972.0,35,67,69,171
23692,East Germany,1976.0,114,57,56,227
23693,East Germany,1980.0,131,99,73,303
23694,East Germany,1968.0,15,22,21,58
23695,East Germany,1988.0,89,69,55,213
23696,East Germany,1976.0,114,57,56,227
23697,East Germany,1980.0,131,99,73,303
23698,East Germany,1976.0,114,57,56,227
23699,East Germany-1,1976.0,114,57,56,227
23700,East Germany-1,1984.0,13,13,7,33
23701,East Germany-2,1984.0,13,13,7,33
23702,East Germany-2,1988.0,89,69,55,213
23703,East Germany,1980.0,131,99,73,303
23704,East Germany,1976.0,114,57,56,227
23705,East Germany,1980.0,131,99,73,303
23706,East Germany,1976.0,114,57,56,227
23707,East Germany,1980.0,131,99,73,303
23708,East Germany,1980.0,131,99,73,303
23709,East Germany,1968.0,15,22,21,58
23710,East Germany,1980.0,131,99,73,303
23711,East Germany,1972.0,35,67,69,171
23712,East Germany,1988.0,89,69,55,213
23713,East Germany,1976.0,114,57,56,227
23714,East Germany,1980.0,131,99,73,303
23715,East Germany,1988.0,89,69,55,213
23716,East Germany,1980.0,131,99,73,303
23717,East Germany,1980.0,131,99,73,303
23718,East Germany,1976.0,114,57,56,227
23719,East Germany,1980.0,131,99,73,303
23720,East Germany,1972.0,35,67,69,171
23721,East Germany,1976.0,114,57,56,227
23722,East Germany,1976.0,114,57,56,227
23723,East Germany,1972.0,35,67,69,171
23724,East Germany,1968.0,15,22,21,58
23725,East Germany,1972.0,35,67,69,171
23726,East Germany,1972.0,35,67,69,171
23727,East Germany,1980.0,131,99,73,303
23728,East Germany,1980.0,131,99,73,303
23729,East Germany,1988.0,89,69,55,213
23730,East Germany,1976.0,114,57,56,227
23731,East Germany,1980.0,131,99,73,303
23732,East Germany,1980.0,131,99,73,303
23733,East Germany-1,1980.0,131,99,73,303
23734,East Germany,1972.0,35,67,69,171
23735,East Germany,1976.0,114,57,56,227
23736,East Germany,1972.0,35,67,69,171
23737,East Germany,1976.0,114,57,56,227
23738,East Germany,1980.0,131,99,73,303
23739,East Germany,1980.0,131,99,73,303
23740,East Germany,1972.0,35,67,69,171
23741,East Germany,1988.0,89,69,55,213
23742,East Germany,1976.0,114,57,56,227
23743,East Germany,1976.0,114,57,56,227
23744,East Germany,1968.0,15,22,21,58
23745,East Germany,1968.0,15,22,21,58
23746,East Germany,1968.0,15,22,21,58
23747,East Germany,1972.0,35,67,69,171
23748,East Germany,1972.0,35,67,69,171
23749,East Germany,1972.0,35,67,69,171
23750,East Germany,1972.0,35,67,69,171
23751,East Germany,1976.0,114,57,56,227
23752,East Germany,1976.0,114,57,56,227
23753,East Germany,1980.0,131,99,73,303
23754,East Germany,1972.0,35,67,69,171
23755,East Germany,1980.0,131,99,73,303
23756,East Germany,1972.0,35,67,69,171
23757,East Germany,1988.0,89,69,55,213
23758,East Germany,1988.0,89,69,55,213
23759,East Germany,1972.0,35,67,69,171
23760,East Germany,1988.0,89,69,55,213
23761,East Germany,1988.0,89,69,55,213
23762,East Germany,1988.0,89,69,55,213
23763,East Germany,1976.0,114,57,56,227
23764,East Germany,1980.0,131,99,73,303
23765,East Germany,1980.0,131,99,73,303
23766,East Germany,1980.0,131,99,73,303
23767,East Germany,1980.0,131,99,73,303
23768,East Germany,1968.0,15,22,21,58
23769,East Germany,1976.0,114,57,56,227
23770,East Germany,1980.0,131,99,73,303
23771,East Germany,1988.0,89,69,55,213
23772,East Germany,1988.0,89,69,55,213
23773,East Germany,1976.0,114,57,56,227
23774,East Germany,1968.0,15,22,21,58
23775,East Germany,1988.0,89,69,55,213
23776,East Germany,1988.0,89,69,55,213
23777,East Germany,1980.0,131,99,73,303
23778,East Germany,1972.0,35,67,69,171
23779,East Germany,1976.0,114,57,56,227
23780,East Germany,1988.0,89,69,55,213
23781,East Germany,1980.0,131,99,73,303
23782,East Germany,1988.0,89,69,55,213
23783,East Germany,1988.0,89,69,55,213
23784,East Germany,1980.0,131,99,73,303
23785,East Germany,1988.0,89,69,55,213
23786,East Germany,1980.0,131,99,73,303
23787,East Germany-1,1980.0,131,99,73,303
23788,East Germany-1,1980.0,131,99,73,303
23789,East Germany-1,1984.0,13,13,7,33
23790,East Germany-2,1984.0,13,13,7,33
23791,East Germany-1,1988.0,89,69,55,213
23792,East Germany-1,1988.0,89,69,55,213
23793,East Germany-2,1976.0,114,57,56,227
23794,East Germany-1,1976.0,114,57,56,227
23795,East Germany-1,1980.0,131,99,73,303
23796,East Germany-1,1980.0,131,99,73,303
23797,East Germany,1988.0,89,69,55,213
23798,East Germany,1980.0,131,99,73,303
23799,East Germany,1980.0,131,99,73,303
23800,East Germany,1988.0,89,69,55,213
23801,East Germany,1972.0,35,67,69,171
23802,East Germany,1988.0,89,69,55,213
23803,East Germany,1980.0,131,99,73,303
23804,East Germany,1988.0,89,69,55,213
23805,East Germany,1976.0,114,57,56,227
23806,East Germany,1976.0,114,57,56,227
23807,East Germany,1980.0,131,99,73,303
23808,East Germany,1980.0,131,99,73,303
23809,East Germany,1976.0,114,57,56,227
23810,East Germany,1976.0,114,57,56,227
23811,East Germany,1980.0,131,99,73,303
23812,East Germany,1968.0,15,22,21,58
23813,East Germany,1988.0,89,69,55,213
23814,East Germany,1968.0,15,22,21,58
23815,East Germany,1972.0,35,67,69,171
23816,East Germany,1988.0,89,69,55,213
23817,East Germany,1988.0,89,69,55,213
23818,East Germany,1976.0,114,57,56,227
23819,East Germany,1980.0,131,99,73,303
23820,East Germany,1984.0,13,13,7,33
23821,East Germany,1988.0,89,69,55,213
23822,East Germany,1976.0,114,57,56,227
23823,East Germany,1980.0,131,99,73,303
23824,East Germany,1980.0,131,99,73,303
23825,East Germany,1988.0,89,69,55,213
23826,East Germany-1,1976.0,114,57,56,227
23827,East Germany,1976.0,114,57,56,227
23828,East Germany,1976.0,114,57,56,227
23829,East Germany,1980.0,131,99,73,303
23830,East Germany,1980.0,131,99,73,303
23831,East Germany,1988.0,89,69,55,213
23832,East Germany,1988.0,89,69,55,213
23833,East Germany,1988.0,89,69,55,213
23834,East Germany,1988.0,89,69,55,213
23835,East Germany,1988.0,89,69,55,213
23836,East Germany,1988.0,89,69,55,213
23837,East Germany,1972.0,35,67,69,171
23838,East Germany,1972.0,35,67,69,171
23839,East Germany,1980.0,131,99,73,303
23840,East Germany,1976.0,114,57,56,227
23841,East Germany,1968.0,15,22,21,58
23842,East Germany,1988.0,89,69,55,213
23843,East Germany,1972.0,35,67,69,171
23844,East Germany,1980.0,131,99,73,303
23845,East Germany,1976.0,114,57,56,227
23846,East Germany,1980.0,131,99,73,303
23847,East Germany,1980.0,131,99,73,303
23848,East Germany,1980.0,131,99,73,303
23849,East Germany,1976.0,114,57,56,227
23850,East Germany,1980.0,131,99,73,303
23851,East Germany,1972.0,35,67,69,171
23852,East Germany-1,1984.0,13,13,7,33
23853,East Germany-1,1988.0,89,69,55,213
23854,East Germany,1980.0,131,99,73,303
23855,East Germany,1976.0,114,57,56,227
23856,East Germany,1980.0,131,99,73,303
23857,East Germany,1976.0,114,57,56,227
23858,East Germany,1976.0,114,57,56,227
23859,East Germany,1976.0,114,57,56,227
23860,East Germany,1976.0,114,57,56,227
23861,East Germany,1980.0,131,99,73,303
23862,East Germany,1980.0,131,99,73,303
23863,East Germany,1972.0,35,67,69,171
23864,East Germany,1976.0,114,57,56,227
23865,East Germany,1972.0,35,67,69,171
23866,East Germany,1988.0,89,69,55,213
23867,East Germany,1972.0,35,67,69,171
23868,East Germany,1976.0,114,57,56,227
23869,East Germany,1980.0,131,99,73,303
23870,East Germany,1988.0,89,69,55,213
23871,East Germany,1976.0,114,57,56,227
23872,East Germany,1976.0,114,57,56,227
23873,East Germany,1980.0,131,99,73,303
23874,East Germany,1976.0,114,57,56,227
23875,East Germany,1980.0,131,99,73,303
23876,East Germany,1980.0,131,99,73,303
23877,East Germany,1980.0,131,99,73,303
23878,East Germany,1976.0,114,57,56,227
23879,East Germany,1988.0,89,69,55,213
23880,East Germany,1972.0,35,67,69,171
23881,East Germany,1976.0,114,57,56,227
23882,East Germany,1980.0,131,99,73,303
23883,East Germany,1980.0,131,99,73,303
23884,East Germany,1980.0,131,99,73,303
23885,East Germany,1980.0,131,99,73,303
23886,East Germany,1980.0,131,99,73,303
23887,East Germany,1988.0,89,69,55,213
23888,East Germany,1972.0,35,67,69,171
23889,East Germany-2,1980.0,131,99,73,303
23890,East Germany,1988.0,89,69,55,213
23891,East Germany,1972.0,35,67,69,171
23892,East Germany,1972.0,35,67,69,171
23893,East Germany,1976.0,114,57,56,227
23894,East Germany,1980.0,131,99,73,303
23895,East Germany,1976.0,114,57,56,227
23896,East Germany,1980.0,131,99,73,303
23897,East Germany,1976.0,114,57,56,227
23898,East Germany,1976.0,114,57,56,227
23899,East Germany,1976.0,114,57,56,227
23900,East Germany,1976.0,114,57,56,227
23901,East Germany,1980.0,131,99,73,303
23902,East Germany,1976.0,114,57,56,227
23903,East Germany,1976.0,114,57,56,227
23904,East Germany-1,1976.0,114,57,56,227
23905,East Germany-1,1980.0,131,99,73,303
23906,East Germany,1984.0,13,13,7,33
23907,East Germany,1988.0,89,69,55,213
23908,East Germany,1988.0,89,69,55,213
23909,East Germany,1980.0,131,99,73,303
23910,East Germany,1976.0,114,57,56,227
23911,East Germany,1980.0,131,99,73,303
23912,East Germany,1980.0,131,99,73,303
23913,East Germany,1988.0,89,69,55,213
23914,East Germany,1976.0,114,57,56,227
23915,East Germany,1980.0,131,99,73,303
23916,East Germany,1980.0,131,99,73,303
23917,East Germany,1980.0,131,99,73,303
23918,East Germany,1984.0,13,13,7,33
23919,East Germany,1988.0,89,69,55,213
23920,East Germany,1988.0,89,69,55,213
23921,East Germany,1988.0,89,69,55,213
23922,East Germany,1980.0,131,99,73,303
23923,East Germany,1980.0,131,99,73,303
23924,East Germany,1980.0,131,99,73,303
23925,East Germany,1968.0,15,22,21,58
23926,East Germany,1972.0,35,67,69,171
23927,East Germany,1972.0,35,67,69,171
23928,East Germany,1976.0,114,57,56,227
23929,East Germany,1972.0,35,67,69,171
23930,East Germany,1980.0,131,99,73,303
23931,East Germany,1972.0,35,67,69,171
23932,East Germany,1980.0,131,99,73,303
23933,East Germany,1976.0,114,57,56,227
23934,East Germany,1980.0,131,99,73,303
23935,East Germany,1980.0,131,99,73,303
23936,East Germany,1976.0,114,57,56,227
23937,East Germany,1980.0,131,99,73,303
23938,East Germany-2,1984.0,13,13,7,33
23939,East Germany-1,1984.0,13,13,7,33
23940,East Germany-1,1988.0,89,69,55,213
23941,East Germany,1976.0,114,57,56,227
23942,East Germany,1972.0,35,67,69,171
23943,East Germany,1988.0,89,69,55,213
23944,East Germany,1988.0,89,69,55,213
23945,East Germany,1988.0,89,69,55,213
23946,East Germany,1976.0,114,57,56,227
23947,East Germany,1980.0,131,99,73,303
23948,East Germany,1972.0,35,67,69,171
23949,East Germany,1988.0,89,69,55,213
23950,East Germany,1984.0,13,13,7,33
23951,East Germany,1980.0,131,99,73,303
23952,East Germany,1980.0,131,99,73,303
23953,East Germany,1980.0,131,99,73,303
23954,East Germany,1988.0,89,69,55,213
23955,East Germany,1980.0,131,99,73,303
23956,East Germany,1988.0,89,69,55,213
23957,East Germany,1968.0,15,22,21,58
23958,East Germany,1980.0,131,99,73,303
23959,East Germany,1972.0,35,67,69,171
23960,East Germany,1980.0,131,99,73,303
23961,East Germany,1976.0,114,57,56,227
23962,East Germany,1972.0,35,67,69,171
23963,East Germany,1976.0,114,57,56,227
23964,East Germany,1972.0,35,67,69,171
23965,East Germany,1972.0,35,67,69,171
23966,East Germany,1968.0,15,22,21,58
23967,East Germany,1972.0,35,67,69,171
23968,East Germany,1980.0,131,99,73,303
23969,East Germany,1980.0,131,99,73,303
23970,East Germany,1972.0,35,67,69,171
23971,East Germany,1980.0,131,99,73,303
23972,East Germany,1984.0,13,13,7,33
23973,East Germany,1984.0,13,13,7,33
23974,East Germany,1980.0,131,99,73,303
23975,East Germany-2,1980.0,131,99,73,303
23976,East Germany,1980.0,131,99,73,303
23977,East Germany,1988.0,89,69,55,213
23978,East Germany,1972.0,35,67,69,171
23979,East Germany,1988.0,89,69,55,213
23980,East Germany,1988.0,89,69,55,213
23981,East Germany,1988.0,89,69,55,213
23982,East Germany,1980.0,131,99,73,303
23983,East Germany,1988.0,89,69,55,213
23984,East Germany,1968.0,15,22,21,58
23985,East Germany,1972.0,35,67,69,171
23986,East Germany,1972.0,35,67,69,171
23987,East Germany,1988.0,89,69,55,213
23988,East Germany,1980.0,131,99,73,303
23989,East Germany,1976.0,114,57,56,227
23990,East Germany,1972.0,35,67,69,171
23991,East Germany,1988.0,89,69,55,213
23992,East Germany,1976.0,114,57,56,227
23993,East Germany,1988.0,89,69,55,213
23994,East Germany,1972.0,35,67,69,171
23995,East Germany,1976.0,114,57,56,227
23996,East Germany,1988.0,89,69,55,213
23997,East Germany,1972.0,35,67,69,171
23998,East Germany,1988.0,89,69,55,213
23999,East Germany,1980.0,131,99,73,303
24000,East Germany,1972.0,35,67,69,171
24001,East Germany,1972.0,35,67,69,171
24002,East Germany,1976.0,114,57,56,227
24003,East Germany,1972.0,35,67,69,171
24004,East Germany,1972.0,35,67,69,171
24005,East Germany,1972.0,35,67,69,171
24006,East Germany,1968.0,15,22,21,58
24007,East Germany,1976.0,114,57,56,227
24008,East Germany,1980.0,131,99,73,303
24009,East Germany,1968.0,15,22,21,58
24010,East Germany,1988.0,89,69,55,213
24011,East Germany,1980.0,131,99,73,303
24012,East Germany,1988.0,89,69,55,213
24013,East Germany,1976.0,114,57,56,227
24014,East Germany,1976.0,114,57,56,227
24015,East Germany,1988.0,89,69,55,213
24016,East Germany,1988.0,89,69,55,213
24017,East Germany,1988.0,89,69,55,213
24018,East Germany,1988.0,89,69,55,213
24019,East Germany,1980.0,131,99,73,303
24020,East Germany,1988.0,89,69,55,213
24021,East Germany,1972.0,35,67,69,171
24022,East Germany,1972.0,35,67,69,171
24023,East Germany,1988.0,89,69,55,213
24024,East Germany,1976.0,114,57,56,227
24025,East Germany,1980.0,131,99,73,303
24026,East Germany,1988.0,89,69,55,213
24027,East Germany,1988.0,89,69,55,213
24028,East Germany,1968.0,15,22,21,58
24029,East Germany,1972.0,35,67,69,171
24030,East Germany,1972.0,35,67,69,171
24031,East Germany,1972.0,35,67,69,171
24032,East Germany,1976.0,114,57,56,227
24033,East Germany,1976.0,114,57,56,227
24034,East Germany,1976.0,114,57,56,227
24035,East Germany,1968.0,15,22,21,58
24036,East Germany,1980.0,131,99,73,303
24037,East Germany,1980.0,131,99,73,303
24038,East Germany,1988.0,89,69,55,213
24039,East Germany,1988.0,89,69,55,213
24040,East Germany,1988.0,89,69,55,213
24041,East Germany,1988.0,89,69,55,213
24042,East Germany,1988.0,89,69,55,213
24043,East Germany,1980.0,131,99,73,303
24044,East Germany,1980.0,131,99,73,303
24045,East Germany,1988.0,89,69,55,213
24046,East Germany,1988.0,89,69,55,213
24047,East Germany,1972.0,35,67,69,171
24048,East Germany,1988.0,89,69,55,213
24049,East Germany,1980.0,131,99,73,303
24050,East Germany,1976.0,114,57,56,227
24051,East Germany,1976.0,114,57,56,227
24052,East Germany,1972.0,35,67,69,171
24053,East Germany,1980.0,131,99,73,303
24054,East Germany,1980.0,131,99,73,303
24055,East Germany,1980.0,131,99,73,303
24056,East Germany,1976.0,114,57,56,227
24057,East Germany,1976.0,114,57,56,227
24058,East Germany,1980.0,131,99,73,303
24059,East Germany,1988.0,89,69,55,213
24060,East Germany,1980.0,131,99,73,303
24061,East Germany,1980.0,131,99,73,303
24062,East Germany,1976.0,114,57,56,227
24063,East Germany,1976.0,114,57,56,227
24064,East Germany,1980.0,131,99,73,303
24065,East Germany,1976.0,114,57,56,227
24066,East Germany,1976.0,114,57,56,227
24067,East Germany,1988.0,89,69,55,213
24068,East Germany,1968.0,15,22,21,58
24069,East Germany,1972.0,35,67,69,171
24070,East Germany,1972.0,35,67,69,171
24071,East Germany,1972.0,35,67,69,171
24072,East Germany,1976.0,114,57,56,227
24073,East Germany,1980.0,131,99,73,303
24074,East Germany,1988.0,89,69,55,213
24075,East Germany,1988.0,89,69,55,213
24076,East Germany,1988.0,89,69,55,213
24077,East Germany,1988.0,89,69,55,213
24078,East Germany,1972.0,35,67,69,171
24079,East Germany,1980.0,131,99,73,303
24080,East Germany,1976.0,114,57,56,227
24081,East Germany,1976.0,114,57,56,227
24082,East Germany,1976.0,114,57,56,227
24083,East Germany,1980.0,131,99,73,303
24084,East Germany,1980.0,131,99,73,303
24085,East Germany,1972.0,35,67,69,171
24086,East Germany,1980.0,131,99,73,303
24087,East Germany,1976.0,114,57,56,227
24088,East Germany,1980.0,131,99,73,303
24089,East Germany,1980.0,131,99,73,303
24090,East Germany,1976.0,114,57,56,227
24091,East Germany,1980.0,131,99,73,303
24092,East Germany,1980.0,131,99,73,303
24093,East Germany,1980.0,131,99,73,303
24094,East Germany,1976.0,114,57,56,227
24095,East Germany,1980.0,131,99,73,303
24096,East Germany,1980.0,131,99,73,303
24097,East Germany,1972.0,35,67,69,171
24098,East Germany,1972.0,35,67,69,171
24099,East Germany,1972.0,35,67,69,171
24100,East Germany,1980.0,131,99,73,303
24101,East Germany,1968.0,15,22,21,58
24102,East Germany-2,1984.0,13,13,7,33
24103,East Germany-1,1988.0,89,69,55,213
24104,East Germany,1972.0,35,67,69,171
24105,East Germany,1972.0,35,67,69,171
24106,East Germany,1976.0,114,57,56,227
24107,East Germany,1980.0,131,99,73,303
24108,East Germany,1968.0,15,22,21,58
24109,East Germany,1976.0,114,57,56,227
24110,East Germany,1980.0,131,99,73,303
24111,East Germany,1976.0,114,57,56,227
24112,East Germany,1988.0,89,69,55,213
24113,East Germany,1988.0,89,69,55,213
24114,East Germany,1988.0,89,69,55,213
24115,East Germany,1980.0,131,99,73,303
24116,East Germany,1984.0,13,13,7,33
24117,East Germany,1988.0,89,69,55,213
24118,East Germany,1988.0,89,69,55,213
24119,East Germany,1980.0,131,99,73,303
24120,East Germany,1976.0,114,57,56,227
24121,East Germany,1972.0,35,67,69,171
24122,East Germany,1976.0,114,57,56,227
24123,East Germany,1968.0,15,22,21,58
24124,East Germany,1972.0,35,67,69,171
24125,East Germany,1988.0,89,69,55,213
24126,East Germany,1988.0,89,69,55,213
24127,East Germany,1972.0,35,67,69,171
24128,East Germany,1972.0,35,67,69,171
24129,East Germany,1976.0,114,57,56,227
24130,East Germany,1972.0,35,67,69,171
24131,East Germany,1976.0,114,57,56,227
24132,East Germany,1980.0,131,99,73,303
24133,East Germany,1968.0,15,22,21,58
24134,East Germany,1972.0,35,67,69,171
24135,East Germany,1988.0,89,69,55,213
24136,East Germany,1988.0,89,69,55,213
24137,East Germany,1988.0,89,69,55,213
24138,East Germany,1988.0,89,69,55,213
24139,East Germany,1988.0,89,69,55,213
24140,East Germany,1976.0,114,57,56,227
24141,East Germany,1980.0,131,99,73,303
24142,East Germany-2,1984.0,13,13,7,33
24143,East Germany,1972.0,35,67,69,171
24144,East Germany,1976.0,114,57,56,227
24145,East Germany,1972.0,35,67,69,171
24146,East Germany,1984.0,13,13,7,33
24147,East Germany,1984.0,13,13,7,33
24148,East Germany,1988.0,89,69,55,213
24149,East Germany,1976.0,114,57,56,227
24150,East Germany,1980.0,131,99,73,303
24151,East Germany,1980.0,131,99,73,303
24152,East Germany,1976.0,114,57,56,227
24153,East Germany,1980.0,131,99,73,303
24154,East Germany,1980.0,131,99,73,303
24155,East Germany,1980.0,131,99,73,303
24156,East Germany-2,1980.0,131,99,73,303
24157,East Germany-1,1984.0,13,13,7,33
24158,East Germany,1968.0,15,22,21,58
24159,East Germany,1972.0,35,67,69,171
24160,East Germany,1972.0,35,67,69,171
24161,East Germany,1976.0,114,57,56,227
24162,East Germany,1980.0,131,99,73,303
24163,East Germany,1968.0,15,22,21,58
24164,East Germany,1980.0,131,99,73,303
24165,East Germany,1980.0,131,99,73,303
24166,East Germany,1980.0,131,99,73,303
24167,East Germany,1988.0,89,69,55,213
24168,East Germany,1976.0,114,57,56,227
24169,East Germany,1980.0,131,99,73,303
24170,East Germany,1976.0,114,57,56,227
24171,East Germany,1980.0,131,99,73,303
24172,East Germany,1980.0,131,99,73,303
24173,East Germany,1980.0,131,99,73,303
24174,East Germany,1976.0,114,57,56,227
24175,East Germany,1984.0,13,13,7,33
24176,East Germany,1988.0,89,69,55,213
24177,East Germany,1988.0,89,69,55,213
24178,East Germany,1988.0,89,69,55,213
24179,East Germany,1988.0,89,69,55,213
24180,East Germany,1980.0,131,99,73,303
24181,East Germany,1980.0,131,99,73,303
24182,East Germany,1988.0,89,69,55,213
24183,East Germany,1976.0,114,57,56,227
24184,East Germany,1968.0,15,22,21,58
24185,East Germany,1980.0,131,99,73,303
24186,East Germany,1980.0,131,99,73,303
24187,East Germany,1976.0,114,57,56,227
24188,East Germany,1972.0,35,67,69,171
24189,East Germany,1984.0,13,13,7,33
24190,East Germany,1988.0,89,69,55,213
24191,East Germany,1988.0,89,69,55,213
24192,East Germany,1972.0,35,67,69,171
24193,East Germany,1972.0,35,67,69,171
24194,East Germany,1972.0,35,67,69,171
24195,East Germany,1988.0,89,69,55,213
24196,East Germany,1988.0,89,69,55,213
24197,East Germany,1988.0,89,69,55,213
24198,East Germany,1988.0,89,69,55,213
24199,East Germany,1976.0,114,57,56,227
24200,East Germany,1976.0,114,57,56,227
24201,East Germany,1976.0,114,57,56,227
24202,East Germany,1976.0,114,57,56,227
24203,East Germany,1980.0,131,99,73,303
24204,East Germany,1976.0,114,57,56,227
24205,East Germany,1980.0,131,99,73,303
24206,East Germany,1968.0,15,22,21,58
24207,East Germany,1968.0,15,22,21,58
24208,East Germany,1972.0,35,67,69,171
24209,East Germany,1972.0,35,67,69,171
24210,East Germany,1972.0,35,67,69,171
24211,East Germany,1988.0,89,69,55,213
24212,East Germany,1988.0,89,69,55,213
24213,Sweden,1912.0,103,62,25,190
24214,Sweden,1912.0,103,62,25,190
24215,Sweden,2004.0,5,5,2,12
24216,Sweden,1920.0,52,38,64,154
24217,Sweden,1928.0,9,21,23,53
24218,Sweden,1920.0,52,38,64,154
24219,Sweden,1936.0,9,13,23,45
24220,Sweden,1912.0,103,62,25,190
24221,Sweden,1908.0,48,18,18,84
24222,Sweden,1912.0,103,62,25,190
24223,Sweden,1912.0,103,62,25,190
24224,Sweden,1920.0,52,38,64,154
24225,Sweden,1936.0,9,13,23,45
24226,Sweden,1980.0,6,8,29,43
24227,Sweden,2002.0,0,2,24,26
24228,Sweden,1924.0,8,30,43,81
24229,Sweden,1984.0,10,20,34,64
24230,Sweden,1912.0,103,62,25,190
24231,Sweden,1932.0,14,9,12,35
24232,Sweden,1952.0,23,24,46,93
24233,Sweden,1948.0,37,18,33,88
24234,Sweden,1948.0,37,18,33,88
24235,Sweden,1952.0,23,24,46,93
24236,Bissbi,1932.0,14,9,12,35
24237,Sweden,1948.0,37,18,33,88
24238,Sweden,1976.0,9,1,2,12
24239,Sweden,1924.0,8,30,43,81
24240,Sweden,2006.0,35,21,8,64
24241,Sweden,2014.0,8,32,11,51
24242,Sweden,1994.0,23,1,0,24
24243,Sweden,2012.0,2,17,3,22
24244,Sweden,1920.0,52,38,64,154
24245,Sweden,2002.0,0,2,24,26
24246,Sweden,1936.0,9,13,23,45
24247,Tornado,1952.0,23,24,46,93
24248,Sweden,1912.0,103,62,25,190
24249,Sweden,1920.0,52,38,64,154
24250,Sweden,1952.0,23,24,46,93
24251,Elsie,1920.0,52,38,64,154
24252,Sweden,1948.0,37,18,33,88
24253,Sweden,2000.0,4,20,8,32
24254,Sweden,2000.0,4,20,8,32
24255,Sweden,2000.0,4,20,8,32
24256,Ali-Baba II,1948.0,37,18,33,88
24257,Sweden,1948.0,37,18,33,88
24258,Sweden,1952.0,23,24,46,93
24259,Sweden,1984.0,10,20,34,64
24260,Sweden,1984.0,10,20,34,64
24261,Sweden,1984.0,10,20,34,64
24262,Sweden,1992.0,2,27,13,42
24263,Sweden,1992.0,2,27,13,42
24264,Sweden,1996.0,3,23,5,31
24265,Sweden,1996.0,3,23,5,31
24266,Sweden,1952.0,23,24,46,93
24267,Sweden,1920.0,52,38,64,154
24268,Sweden,1964.0,9,25,9,43
24269,Sweden,1920.0,52,38,64,154
24270,Sweden,2002.0,0,2,24,26
24271,Sweden,1920.0,52,38,64,154
24272,Sweden,1912.0,103,62,25,190
24273,Sweden,1968.0,7,11,7,25
24274,Sweden,2006.0,35,21,8,64
24275,Sweden,1920.0,52,38,64,154
24276,Sweden,1984.0,10,20,34,64
24277,Sweden,1948.0,37,18,33,88
24278,Sweden,1952.0,23,24,46,93
24279,Sweden,2002.0,0,2,24,26
24280,Sweden,2006.0,35,21,8,64
24281,Sweden,1912.0,103,62,25,190
24282,Sweden,1912.0,103,62,25,190
24283,Sweden,2016.0,2,23,3,28
24284,Sweden,2012.0,2,17,3,22
24285,Sweden,1992.0,2,27,13,42
24286,Sweden,2006.0,35,21,8,64
24287,Sweden,1992.0,2,27,13,42
24288,Sweden,1996.0,3,23,5,31
24289,Sweden,2000.0,4,20,8,32
24290,Sweden,2012.0,2,17,3,22
24291,Sweden,1908.0,48,18,18,84
24292,Sweden,1988.0,7,5,34,46
24293,Sweden,1988.0,7,5,34,46
24294,Sweden,1908.0,48,18,18,84
24295,Sweden,1912.0,103,62,25,190
24296,Sweden,1920.0,52,38,64,154
24297,Sweden,1992.0,2,27,13,42
24298,Sweden,1996.0,3,23,5,31
24299,Sweden,1952.0,23,24,46,93
24300,Sweden,1980.0,6,8,29,43
24301,Sweden,1948.0,37,18,33,88
24302,Sweden,1936.0,9,13,23,45
24303,Sweden,1928.0,9,21,23,53
24304,Sweden,1912.0,103,62,25,190
24305,Sweden,1920.0,52,38,64,154
24306,Sweden,1952.0,23,24,46,93
24307,Sweden,1952.0,23,24,46,93
24308,Sweden,1948.0,37,18,33,88
24309,Sweden,1952.0,23,24,46,93
24310,Sweden,1960.0,7,4,5,16
24311,Sweden,2016.0,2,23,3,28
24312,Sweden,1956.0,16,18,15,49
24313,Sweden,1980.0,6,8,29,43
24314,Sweden,1908.0,48,18,18,84
24315,Sweden,1912.0,103,62,25,190
24316,Sweden,1968.0,7,11,7,25
24317,Sweden,1972.0,5,11,10,26
24318,Sweden,1908.0,48,18,18,84
24319,Sweden,1912.0,103,62,25,190
24320,Sweden,1988.0,7,5,34,46
24321,Sweden,2016.0,2,23,3,28
24322,Sweden-2,2008.0,0,5,2,7
24323,Sweden,1964.0,9,25,9,43
24324,Sweden,1952.0,23,24,46,93
24325,Sweden,2006.0,35,21,8,64
24326,Swedish Star,1932.0,14,9,12,35
24327,Kerstin-1,1912.0,103,62,25,190
24328,Sweden,2006.0,35,21,8,64
24329,Sweden,1920.0,52,38,64,154
24330,Sweden,1992.0,2,27,13,42
24331,Sweden,1920.0,52,38,64,154
24332,Sweden,2006.0,35,21,8,64
24333,Sweden,1920.0,52,38,64,154
24334,Sweden,1920.0,52,38,64,154
24335,Sweden,1920.0,52,38,64,154
24336,Sweden,1920.0,52,38,64,154
24337,Sweden,1960.0,7,4,5,16
24338,Sweden,2014.0,8,32,11,51
24339,Sweden,1980.0,6,8,29,43
24340,Sweden,1984.0,10,20,34,64
24341,Sweden,2004.0,5,5,2,12
24342,Sweden,1912.0,103,62,25,190
24343,Sweden,1920.0,52,38,64,154
24344,Sweden,1920.0,52,38,64,154
24345,Sweden,1988.0,7,5,34,46
24346,Kullan,1920.0,52,38,64,154
24347,Sweden,1984.0,10,20,34,64
24348,Sweden,1984.0,10,20,34,64
24349,Sweden,2004.0,5,5,2,12
24350,Sweden,2008.0,0,5,2,7
24351,Sweden,1952.0,23,24,46,93
24352,Sweden,1920.0,52,38,64,154
24353,Sweden,1924.0,8,30,43,81
24354,Sweden,1932.0,14,9,12,35
24355,Sweden,1936.0,9,13,23,45
24356,Sweden,2002.0,0,2,24,26
24357,Sweden,1952.0,23,24,46,93
24358,Sweden,1956.0,16,18,15,49
24359,Sweden,1928.0,9,21,23,53
24360,Sweden,1980.0,6,8,29,43
24361,Sweden,1988.0,7,5,34,46
24362,Sweden,1994.0,23,1,0,24
24363,Sweden,2016.0,2,23,3,28
24364,Sweden,1948.0,37,18,33,88
24365,Sweden,2014.0,8,32,11,51
24366,Sweden,1912.0,103,62,25,190
24367,Sweden,1928.0,9,21,23,53
24368,Erna Signe,1912.0,103,62,25,190
24369,Bissbi,1932.0,14,9,12,35
24370,Sweden,1912.0,103,62,25,190
24371,Sweden,1920.0,52,38,64,154
24372,Sweden,1988.0,7,5,34,46
24373,Sweden,1994.0,23,1,0,24
24374,Sweden,2000.0,4,20,8,32
24375,Sweden,2002.0,0,2,24,26
24376,Erna Signe,1912.0,103,62,25,190
24377,Erna Signe,1912.0,103,62,25,190
24378,Sweden,1908.0,48,18,18,84
24379,Sweden,1952.0,23,24,46,93
24380,Sweden,1956.0,16,18,15,49
24381,Sweden,1908.0,48,18,18,84
24382,Sweden,1912.0,103,62,25,190
24383,Sweden,2014.0,8,32,11,51
24384,Sweden,1972.0,5,11,10,26
24385,Sweden,1920.0,52,38,64,154
24386,Sweden,1912.0,103,62,25,190
24387,Sweden,1912.0,103,62,25,190
24388,Sweden,1912.0,103,62,25,190
24389,Sweden,1912.0,103,62,25,190
24390,Sweden,1952.0,23,24,46,93
24391,Sweden,1928.0,9,21,23,53
24392,Sweden,1924.0,8,30,43,81
24393,Sweden,2016.0,2,23,3,28
24394,Sweden,1936.0,9,13,23,45
24395,Sweden,1936.0,9,13,23,45
24396,Sweden,1952.0,23,24,46,93
24397,Sweden,1964.0,9,25,9,43
24398,Sweden,1912.0,103,62,25,190
24399,Sweden,1912.0,103,62,25,190
24400,Sweden,1920.0,52,38,64,154
24401,Sweden,1952.0,23,24,46,93
24402,Sweden,1924.0,8,30,43,81
24403,Slaghoken,1948.0,37,18,33,88
24404,Slaghoken II,1956.0,16,18,15,49
24405,Sweden,1912.0,103,62,25,190
24406,Tornado,1952.0,23,24,46,93
24407,Sweden,1932.0,14,9,12,35
24408,Sweden,1948.0,37,18,33,88
24409,Sweden,1952.0,23,24,46,93
24410,Sweden,1956.0,16,18,15,49
24411,Sweden,1912.0,103,62,25,190
24412,Sweden,1912.0,103,62,25,190
24413,Sweden,1928.0,9,21,23,53
24414,Sweden,2000.0,4,20,8,32
24415,Sweden,1924.0,8,30,43,81
24416,Sweden,1924.0,8,30,43,81
24417,Sweden,1924.0,8,30,43,81
24418,Sweden,1924.0,8,30,43,81
24419,Sweden,1928.0,9,21,23,53
24420,Sweden,1928.0,9,21,23,53
24421,Sweden,1972.0,5,11,10,26
24422,Sweden,1912.0,103,62,25,190
24423,Sweden,1908.0,48,18,18,84
24424,Sweden,1932.0,14,9,12,35
24425,Sweden,1932.0,14,9,12,35
24426,Sweden,1952.0,23,24,46,93
24427,Slaghoken,1948.0,37,18,33,88
24428,Sweden,1924.0,8,30,43,81
24429,Sweden,1972.0,5,11,10,26
24430,Roddklubben af 1912-1,1912.0,103,62,25,190
24431,Roddklubben af 1912-1,1912.0,103,62,25,190
24432,Sweden,1924.0,8,30,43,81
24433,Sweden,1928.0,9,21,23,53
24434,Sweden,1984.0,10,20,34,64
24435,Sweden,1932.0,14,9,12,35
24436,Sweden,1932.0,14,9,12,35
24437,Sweden,1936.0,9,13,23,45
24438,Sweden,1912.0,103,62,25,190
24439,Sweden,1908.0,48,18,18,84
24440,Sweden,1912.0,103,62,25,190
24441,Sweden,1912.0,103,62,25,190
24442,Sweden,1912.0,103,62,25,190
24443,Sweden,1912.0,103,62,25,190
24444,Sweden,1906.0,2,5,14,21
24445,Sweden,1908.0,48,18,18,84
24446,Sweden,1912.0,103,62,25,190
24447,Sweden,1912.0,103,62,25,190
24448,Sweden,1912.0,103,62,25,190
24449,Sweden,1912.0,103,62,25,190
24450,Sweden,1912.0,103,62,25,190
24451,Sweden,1924.0,8,30,43,81
24452,Sweden,1912.0,103,62,25,190
24453,Sweden,1992.0,2,27,13,42
24454,Sweden,1996.0,3,23,5,31
24455,Sweden,1948.0,37,18,33,88
24456,Sweden,1952.0,23,24,46,93
24457,Sweden,1924.0,8,30,43,81
24458,Sweden,1932.0,14,9,12,35
24459,Sweden,1928.0,9,21,23,53
24460,Sweden,1928.0,9,21,23,53
24461,Sweden,1948.0,37,18,33,88
24462,Sweden,1980.0,6,8,29,43
24463,Sweden,1912.0,103,62,25,190
24464,Sweden,1992.0,2,27,13,42
24465,Sweden,1908.0,48,18,18,84
24466,Sweden,1936.0,9,13,23,45
24467,Sweden,1960.0,7,4,5,16
24468,Sweden,1948.0,37,18,33,88
24469,Sweden,1908.0,48,18,18,84
24470,Sweden,1920.0,52,38,64,154
24471,Sweden,1972.0,5,11,10,26
24472,Sweden,1984.0,10,20,34,64
24473,Erna Signe,1912.0,103,62,25,190
24474,Sweden,1936.0,9,13,23,45
24475,Sweden,1988.0,7,5,34,46
24476,Sweden,1994.0,23,1,0,24
24477,Sweden,1924.0,8,30,43,81
24478,Sweden,1906.0,2,5,14,21
24479,Roddklubben af 1912-1,1912.0,103,62,25,190
24480,Sweden,2006.0,35,21,8,64
24481,Sweden,2012.0,2,17,3,22
24482,Sweden,2016.0,2,23,3,28
24483,Sweden,1920.0,52,38,64,154
24484,Sweden,1912.0,103,62,25,190
24485,Sweden,1912.0,103,62,25,190
24486,Sweden,1908.0,48,18,18,84
24487,Sweden,2012.0,2,17,3,22
24488,Sweden,1936.0,9,13,23,45
24489,Sweden,1994.0,23,1,0,24
24490,Sweden,1920.0,52,38,64,154
24491,Sweden,1924.0,8,30,43,81
24492,Sweden,1936.0,9,13,23,45
24493,Sweden,1988.0,7,5,34,46
24494,Sweden,1988.0,7,5,34,46
24495,Sweden,2014.0,8,32,11,51
24496,Sweden,2014.0,8,32,11,51
24497,Sweden,1976.0,9,1,2,12
24498,Sweden,1912.0,103,62,25,190
24499,Sweden,2000.0,4,20,8,32
24500,Sweden,2002.0,0,2,24,26
24501,Sweden,2006.0,35,21,8,64
24502,Sweden,1956.0,16,18,15,49
24503,Sweden,1956.0,16,18,15,49
24504,Sweden,1960.0,7,4,5,16
24505,Sweden,1952.0,23,24,46,93
24506,Sweden,2012.0,2,17,3,22
24507,Sweden,1924.0,8,30,43,81
24508,May Be,1936.0,9,13,23,45
24509,Sweden,2012.0,2,17,3,22
24510,Sweden,1912.0,103,62,25,190
24511,Sweden,1912.0,103,62,25,190
24512,Sweden,1920.0,52,38,64,154
24513,Sweden,1984.0,10,20,34,64
24514,Sweden,1984.0,10,20,34,64
24515,Sweden,1988.0,7,5,34,46
24516,Sweden,1920.0,52,38,64,154
24517,Sweden,2014.0,8,32,11,51
24518,Sweden,1912.0,103,62,25,190
24519,Sweden,2008.0,0,5,2,7
24520,Sweden,1988.0,7,5,34,46
24521,Sweden,1984.0,10,20,34,64
24522,Sweden,2002.0,0,2,24,26
24523,Sweden,2006.0,35,21,8,64
24524,Sweden,2006.0,35,21,8,64
24525,Sweden,1948.0,37,18,33,88
24526,Sweden,2002.0,0,2,24,26
24527,Sweden,1920.0,52,38,64,154
24528,Sweden,1924.0,8,30,43,81
24529,Sweden,1936.0,9,13,23,45
24530,Kitty-1,1912.0,103,62,25,190
24531,Sweden,1948.0,37,18,33,88
24532,Sweden,1984.0,10,20,34,64
24533,Sweden,1912.0,103,62,25,190
24534,Sweden,1996.0,3,23,5,31
24535,Sweden,2014.0,8,32,11,51
24536,Sweden,2014.0,8,32,11,51
24537,Sweden,1920.0,52,38,64,154
24538,Sweden,1956.0,16,18,15,49
24539,Sweden,1956.0,16,18,15,49
24540,Sweden,1920.0,52,38,64,154
24541,Sweden,1980.0,6,8,29,43
24542,Sweden,1956.0,16,18,15,49
24543,Sweden,1956.0,16,18,15,49
24544,Sweden,1956.0,16,18,15,49
24545,Sweden,1948.0,37,18,33,88
24546,Sweden,1948.0,37,18,33,88
24547,Sweden,1980.0,6,8,29,43
24548,Sweden,1984.0,10,20,34,64
24549,Sweden,1948.0,37,18,33,88
24550,Sweden,1980.0,6,8,29,43
24551,Sweden,1988.0,7,5,34,46
24552,Sweden,2014.0,8,32,11,51
24553,Sweden,2016.0,2,23,3,28
24554,Sweden,1912.0,103,62,25,190
24555,Sweden,1912.0,103,62,25,190
24556,Sweden,1920.0,52,38,64,154
24557,Sweden,1920.0,52,38,64,154
24558,Sweden,1920.0,52,38,64,154
24559,Sweden,1994.0,23,1,0,24
24560,Sweden,1920.0,52,38,64,154
24561,Sweden,1988.0,7,5,34,46
24562,Sweden,2004.0,5,5,2,12
24563,Sweden,1936.0,9,13,23,45
24564,Sweden,1980.0,6,8,29,43
24565,Sweden,1988.0,7,5,34,46
24566,Sweden,1968.0,7,11,7,25
24567,Sweden,2012.0,2,17,3,22
24568,Sweden,1924.0,8,30,43,81
24569,Sweden,1936.0,9,13,23,45
24570,Sweden,1948.0,37,18,33,88
24571,Sweden,1952.0,23,24,46,93
24572,Sweden,1900.0,3,0,1,4
24573,Sweden,1968.0,7,11,7,25
24574,Sweden,2010.0,11,3,4,18
24575,Sweden-1,1912.0,103,62,25,190
24576,Sweden-3,1912.0,103,62,25,190
24577,Sweden,2016.0,2,23,3,28
24578,Sweden,1952.0,23,24,46,93
24579,Sweden,1976.0,9,1,2,12
24580,Sweden,1912.0,103,62,25,190
24581,Sweden,1912.0,103,62,25,190
24582,Sweden,1908.0,48,18,18,84
24583,Sweden,1994.0,23,1,0,24
24584,Sweden,2006.0,35,21,8,64
24585,Sweden,1948.0,37,18,33,88
24586,Sweden,1952.0,23,24,46,93
24587,Sweden,1908.0,48,18,18,84
24588,Sweden,1996.0,3,23,5,31
24589,Sweden,2000.0,4,20,8,32
24590,Sweden,2016.0,2,23,3,28
24591,Sweden,2000.0,4,20,8,32
24592,Sweden,2004.0,5,5,2,12
24593,Sweden,2016.0,2,23,3,28
24594,Sweden,1912.0,103,62,25,190
24595,Sweden,1948.0,37,18,33,88
24596,Sweden,1948.0,37,18,33,88
24597,Sweden,1952.0,23,24,46,93
24598,Sweden,1952.0,23,24,46,93
24599,Sweden,1956.0,16,18,15,49
24600,Sweden,1956.0,16,18,15,49
24601,Sweden,1960.0,7,4,5,16
24602,Sweden,1960.0,7,4,5,16
24603,Sweden,2006.0,35,21,8,64
24604,Sweden,2006.0,35,21,8,64
24605,Sweden,2006.0,35,21,8,64
24606,Sweden,1948.0,37,18,33,88
24607,Sweden,1952.0,23,24,46,93
24608,Sweden,1960.0,7,4,5,16
24609,Sweden,1924.0,8,30,43,81
24610,Sweden,1912.0,103,62,25,190
24611,Sweden,1936.0,9,13,23,45
24612,Sweden,1992.0,2,27,13,42
24613,Sweden,1996.0,3,23,5,31
24614,Sweden,2000.0,4,20,8,32
24615,Sweden,1952.0,23,24,46,93
24616,Sweden,1912.0,103,62,25,190
24617,Sweden,1920.0,52,38,64,154
24618,Sweden,1976.0,9,1,2,12
24619,Sweden,1948.0,37,18,33,88
24620,Tornado,1952.0,23,24,46,93
24621,Sweden,1928.0,9,21,23,53
24622,Sweden,2000.0,4,20,8,32
24623,Sweden,1952.0,23,24,46,93
24624,Sweden,1956.0,16,18,15,49
24625,Sweden,1984.0,10,20,34,64
24626,Sweden,1920.0,52,38,64,154
24627,Sweden,1924.0,8,30,43,81
24628,Sweden,1928.0,9,21,23,53
24629,Sweden,1932.0,14,9,12,35
24630,Sweden,1906.0,2,5,14,21
24631,Sweden,1908.0,48,18,18,84
24632,Sweden,1936.0,9,13,23,45
24633,Sweden,1912.0,103,62,25,190
24634,Sweden,1920.0,52,38,64,154
24635,Sweden,1920.0,52,38,64,154
24636,Sweden,1948.0,37,18,33,88
24637,Sweden,1948.0,37,18,33,88
24638,Sweden,1952.0,23,24,46,93
24639,Sweden,1906.0,2,5,14,21
24640,Sweden,1948.0,37,18,33,88
24641,Sweden,1912.0,103,62,25,190
24642,Sweden,1920.0,52,38,64,154
24643,Sweden,1956.0,16,18,15,49
24644,Sweden,1998.0,0,2,5,7
24645,Sweden,1984.0,10,20,34,64
24646,Sweden,1984.0,10,20,34,64
24647,Sweden,1988.0,7,5,34,46
24648,Sweden,1988.0,7,5,34,46
24649,Sweden,1906.0,2,5,14,21
24650,Sweden,1912.0,103,62,25,190
24651,Sweden,1984.0,10,20,34,64
24652,Sweden,1920.0,52,38,64,154
24653,Sweden,1908.0,48,18,18,84
24654,Sweden,2012.0,2,17,3,22
24655,Sweden,1980.0,6,8,29,43
24656,Sweden,1964.0,9,25,9,43
24657,Sweden,1968.0,7,11,7,25
24658,Sweden,1968.0,7,11,7,25
24659,Sweden,1968.0,7,11,7,25
24660,Sweden,1952.0,23,24,46,93
24661,Sweden,1920.0,52,38,64,154
24662,Sweden,2010.0,11,3,4,18
24663,Sweden,2010.0,11,3,4,18
24664,Sweden,2014.0,8,32,11,51
24665,Sweden,2014.0,8,32,11,51
24666,Sweden,1924.0,8,30,43,81
24667,Sweden,1920.0,52,38,64,154
24668,Sweden,1936.0,9,13,23,45
24669,Sweden,1964.0,9,25,9,43
24670,Sweden,1992.0,2,27,13,42
24671,Sweden,1948.0,37,18,33,88
24672,Sweden,1992.0,2,27,13,42
24673,Sweden,1996.0,3,23,5,31
24674,Sweden,1972.0,5,11,10,26
24675,Sweden,1984.0,10,20,34,64
24676,Sweden,1952.0,23,24,46,93
24677,Sweden,1952.0,23,24,46,93
24678,Sweden,1956.0,16,18,15,49
24679,Sweden,1928.0,9,21,23,53
24680,Sweden,1968.0,7,11,7,25
24681,Sylvia,1928.0,9,21,23,53
24682,Sweden,2016.0,2,23,3,28
24683,Sweden,1964.0,9,25,9,43
24684,Sweden,2006.0,35,21,8,64
24685,Sweden,1928.0,9,21,23,53
24686,Sweden,2000.0,4,20,8,32
24687,Sweden,1908.0,48,18,18,84
24688,Sweden,1908.0,48,18,18,84
24689,Sweden,1912.0,103,62,25,190
24690,Sweden,1920.0,52,38,64,154
24691,Sweden,1952.0,23,24,46,93
24692,Sweden,1976.0,9,1,2,12
24693,Sweden,1994.0,23,1,0,24
24694,Sweden,1908.0,48,18,18,84
24695,Sweden,1980.0,6,8,29,43
24696,Sweden,1912.0,103,62,25,190
24697,Sweden,2006.0,35,21,8,64
24698,Sweden,1956.0,16,18,15,49
24699,Sweden,1952.0,23,24,46,93
24700,Sweden,1992.0,2,27,13,42
24701,Sweden,1996.0,3,23,5,31
24702,Sweden,1948.0,37,18,33,88
24703,Sweden,1928.0,9,21,23,53
24704,Sweden,1920.0,52,38,64,154
24705,Sweden,1920.0,52,38,64,154
24706,Sweden,1912.0,103,62,25,190
24707,Sweden,1920.0,52,38,64,154
24708,Sweden,2010.0,11,3,4,18
24709,Sweden,2010.0,11,3,4,18
24710,Sweden,2014.0,8,32,11,51
24711,Sweden,2014.0,8,32,11,51
24712,Sweden,1924.0,8,30,43,81
24713,Sweden,1908.0,48,18,18,84
24714,Vinga-1,1908.0,48,18,18,84
24715,Kitty-1,1912.0,103,62,25,190
24716,Sweden,1906.0,2,5,14,21
24717,Sweden,1912.0,103,62,25,190
24718,Sweden,1920.0,52,38,64,154
24719,Sweden,1920.0,52,38,64,154
24720,Sweden,1924.0,8,30,43,81
24721,Sans Atout-1,1912.0,103,62,25,190
24722,Sweden,1984.0,10,20,34,64
24723,Sans Atout-1,1912.0,103,62,25,190
24724,Sweden,1924.0,8,30,43,81
24725,Bissbi,1932.0,14,9,12,35
24726,May Be,1936.0,9,13,23,45
24727,Ali-Baba II,1948.0,37,18,33,88
24728,Sweden,1924.0,8,30,43,81
24729,Sweden,1984.0,10,20,34,64
24730,Sweden,1988.0,7,5,34,46
24731,Sweden,2014.0,8,32,11,51
24732,Sweden,1968.0,7,11,7,25
24733,Sweden,1932.0,14,9,12,35
24734,Sweden,1976.0,9,1,2,12
24735,Sweden,1908.0,48,18,18,84
24736,Sweden,2004.0,5,5,2,12
24737,Sif,1920.0,52,38,64,154
24738,Sylvia,1928.0,9,21,23,53
24739,Bissbi,1932.0,14,9,12,35
24740,Ali-Baba II,1948.0,37,18,33,88
24741,Sif,1920.0,52,38,64,154
24742,Sweden,1908.0,48,18,18,84
24743,Sweden,1908.0,48,18,18,84
24744,Sweden,1924.0,8,30,43,81
24745,Sweden,1906.0,2,5,14,21
24746,Sweden,1908.0,48,18,18,84
24747,Sweden,1912.0,103,62,25,190
24748,Sweden,1912.0,103,62,25,190
24749,Sweden,1988.0,7,5,34,46
24750,Sweden,1992.0,2,27,13,42
24751,Sweden,1992.0,2,27,13,42
24752,Sweden,1992.0,2,27,13,42
24753,Sweden,1996.0,3,23,5,31
24754,Sweden,1980.0,6,8,29,43
24755,Sweden,1980.0,6,8,29,43
24756,Sweden,2014.0,8,32,11,51
24757,Sweden,1928.0,9,21,23,53
24758,Sweden,1952.0,23,24,46,93
24759,Sweden,1920.0,52,38,64,154
24760,Sweden,1952.0,23,24,46,93
24761,Sweden,2006.0,35,21,8,64
24762,Sweden,1920.0,52,38,64,154
24763,Sweden,2002.0,0,2,24,26
24764,Sweden,2006.0,35,21,8,64
24765,Sweden,1912.0,103,62,25,190
24766,Sweden,1980.0,6,8,29,43
24767,Sweden,1924.0,8,30,43,81
24768,Sweden,1920.0,52,38,64,154
24769,Sweden,1920.0,52,38,64,154
24770,Sweden,1936.0,9,13,23,45
24771,Sweden,1912.0,103,62,25,190
24772,Sweden,2014.0,8,32,11,51
24773,Sweden,2014.0,8,32,11,51
24774,Kitty-1,1912.0,103,62,25,190
24775,Sweden,1948.0,37,18,33,88
24776,Sweden,1988.0,7,5,34,46
24777,Sweden,1976.0,9,1,2,12
24778,Sweden,1908.0,48,18,18,84
24779,Sweden,2012.0,2,17,3,22
24780,Sweden,2016.0,2,23,3,28
24781,Sweden,1912.0,103,62,25,190
24782,Sweden,1908.0,48,18,18,84
24783,Sweden,1928.0,9,21,23,53
24784,Sweden,1920.0,52,38,64,154
24785,Sweden,1952.0,23,24,46,93
24786,Sweden,1912.0,103,62,25,190
24787,Sweden,1920.0,52,38,64,154
24788,Sweden,1924.0,8,30,43,81
24789,Sweden,2002.0,0,2,24,26
24790,Sweden,2006.0,35,21,8,64
24791,Sweden,1956.0,16,18,15,49
24792,Sweden,1988.0,7,5,34,46
24793,Sweden,1908.0,48,18,18,84
24794,Sweden,1988.0,7,5,34,46
24795,Sweden,1956.0,16,18,15,49
24796,Sweden,1956.0,16,18,15,49
24797,Sweden,1956.0,16,18,15,49
24798,Sweden,1956.0,16,18,15,49
24799,Sweden,1960.0,7,4,5,16
24800,Sweden,1960.0,7,4,5,16
24801,Sweden,1964.0,9,25,9,43
24802,Sweden,1964.0,9,25,9,43
24803,Sweden,1964.0,9,25,9,43
24804,Sweden,2012.0,2,17,3,22
24805,Sweden,1912.0,103,62,25,190
24806,Sweden,1972.0,5,11,10,26
24807,Sweden,1912.0,103,62,25,190
24808,Sweden,1920.0,52,38,64,154
24809,Sweden,1976.0,9,1,2,12
24810,Sweden,1988.0,7,5,34,46
24811,Sweden,2008.0,0,5,2,7
24812,Sweden,2016.0,2,23,3,28
24813,Sweden,1952.0,23,24,46,93
24814,Sweden,1952.0,23,24,46,93
24815,Sweden,1912.0,103,62,25,190
24816,Sweden,1928.0,9,21,23,53
24817,Sweden,1928.0,9,21,23,53
24818,Sweden,1908.0,48,18,18,84
24819,Sweden,1912.0,103,62,25,190
24820,Sweden,1912.0,103,62,25,190
24821,Sweden,1912.0,103,62,25,190
24822,Sweden,1920.0,52,38,64,154
24823,Sweden,1920.0,52,38,64,154
24824,Sweden,1920.0,52,38,64,154
24825,Sweden,1952.0,23,24,46,93
24826,Sweden,1948.0,37,18,33,88
24827,Sweden,1956.0,16,18,15,49
24828,Sweden,1960.0,7,4,5,16
24829,Sweden,1932.0,14,9,12,35
24830,Sweden,1932.0,14,9,12,35
24831,Sweden,1936.0,9,13,23,45
24832,Sweden,1984.0,10,20,34,64
24833,Sweden,1964.0,9,25,9,43
24834,Sweden,2014.0,8,32,11,51
24835,Sweden,1924.0,8,30,43,81
24836,Sweden,1924.0,8,30,43,81
24837,Sweden,1988.0,7,5,34,46
24838,Sweden,1928.0,9,21,23,53
24839,Sweden,1964.0,9,25,9,43
24840,Sweden,1980.0,6,8,29,43
24841,Sweden,1984.0,10,20,34,64
24842,Sweden,1984.0,10,20,34,64
24843,Sweden,1908.0,48,18,18,84
24844,Sweden,1994.0,23,1,0,24
24845,Sweden,1952.0,23,24,46,93
24846,Sweden,1980.0,6,8,29,43
24847,Sweden,1936.0,9,13,23,45
24848,Sweden,1952.0,23,24,46,93
24849,Sweden,1964.0,9,25,9,43
24850,Sweden-2,2008.0,0,5,2,7
24851,Sweden,1948.0,37,18,33,88
24852,Sweden,1988.0,7,5,34,46
24853,Sweden,1992.0,2,27,13,42
24854,Sweden,1992.0,2,27,13,42
24855,Sweden,2000.0,4,20,8,32
24856,Erna Signe,1912.0,103,62,25,190
24857,Slaghoken,1948.0,37,18,33,88
24858,Sweden,1920.0,52,38,64,154
24859,Sweden,1920.0,52,38,64,154
24860,Sweden,1928.0,9,21,23,53
24861,Sweden,1908.0,48,18,18,84
24862,Sweden,1908.0,48,18,18,84
24863,Sweden,1980.0,6,8,29,43
24864,Sweden,1912.0,103,62,25,190
24865,Sweden,2014.0,8,32,11,51
24866,Sweden,2014.0,8,32,11,51
24867,Sweden,1928.0,9,21,23,53
24868,Sweden,1908.0,48,18,18,84
24869,Sweden,1912.0,103,62,25,190
24870,Sweden,1920.0,52,38,64,154
24871,Sweden,1936.0,9,13,23,45
24872,Sweden,1972.0,5,11,10,26
24873,Sweden,1948.0,37,18,33,88
24874,Sweden,1994.0,23,1,0,24
24875,Sweden,2006.0,35,21,8,64
24876,Sweden,1994.0,23,1,0,24
24877,Sweden,2006.0,35,21,8,64
24878,Sweden,1998.0,0,2,5,7
24879,Sweden,1920.0,52,38,64,154
24880,Sweden,1980.0,6,8,29,43
24881,Sweden,1994.0,23,1,0,24
24882,Sweden,1936.0,9,13,23,45
24883,Sweden,1948.0,37,18,33,88
24884,Sweden,1952.0,23,24,46,93
24885,Sweden,1994.0,23,1,0,24
24886,Sweden,1908.0,48,18,18,84
24887,Sweden,1908.0,48,18,18,84
24888,Sweden,1912.0,103,62,25,190
24889,Sweden,1920.0,52,38,64,154
24890,Sweden,1920.0,52,38,64,154
24891,Sweden,2010.0,11,3,4,18
24892,Sweden,2010.0,11,3,4,18
24893,Sweden,2014.0,8,32,11,51
24894,Sweden,2014.0,8,32,11,51
24895,Sweden,2014.0,8,32,11,51
24896,Sweden,2012.0,2,17,3,22
24897,Sweden,2000.0,4,20,8,32
24898,Erna Signe,1912.0,103,62,25,190
24899,Sweden,1928.0,9,21,23,53
24900,Sweden,1956.0,16,18,15,49
24901,Sweden,1984.0,10,20,34,64
24902,Rush VII,1964.0,9,25,9,43
24903,Sweden,1932.0,14,9,12,35
24904,Sweden,1936.0,9,13,23,45
24905,Sweden,2014.0,8,32,11,51
24906,Sweden,1984.0,10,20,34,64
24907,Rush V,1956.0,16,18,15,49
24908,Sweden,1988.0,7,5,34,46
24909,Sweden,1972.0,5,11,10,26
24910,Sweden,1972.0,5,11,10,26
24911,Sweden,1988.0,7,5,34,46
24912,Sweden,1948.0,37,18,33,88
24913,Sweden,2012.0,2,17,3,22
24914,Sweden,1912.0,103,62,25,190
24915,Sweden,1956.0,16,18,15,49
24916,Sweden,1924.0,8,30,43,81
24917,Sweden,1924.0,8,30,43,81
24918,Sweden-2,1912.0,103,62,25,190
24919,Sweden,1988.0,7,5,34,46
24920,Sweden,1912.0,103,62,25,190
24921,Sweden,1920.0,52,38,64,154
24922,Sweden,2014.0,8,32,11,51
24923,Sweden,1994.0,23,1,0,24
24924,Sweden,1932.0,14,9,12,35
24925,Sweden,1948.0,37,18,33,88
24926,Sweden,1912.0,103,62,25,190
24927,Sweden,2004.0,5,5,2,12
24928,Sweden,1972.0,5,11,10,26
24929,Sweden,1972.0,5,11,10,26
24930,Sweden,1972.0,5,11,10,26
24931,Sweden,1976.0,9,1,2,12
24932,Sweden,1908.0,48,18,18,84
24933,Sweden,1924.0,8,30,43,81
24934,Sweden,1984.0,10,20,34,64
24935,Sweden,1920.0,52,38,64,154
24936,Sweden,1924.0,8,30,43,81
24937,Sweden,1992.0,2,27,13,42
24938,Sweden,2014.0,8,32,11,51
24939,Sweden,1924.0,8,30,43,81
24940,Sweden,2006.0,35,21,8,64
24941,Sweden,2014.0,8,32,11,51
24942,Sweden,1972.0,5,11,10,26
24943,Sweden,2014.0,8,32,11,51
24944,Sweden,1912.0,103,62,25,190
24945,Sweden,1908.0,48,18,18,84
24946,Sweden,1912.0,103,62,25,190
24947,Sweden,1920.0,52,38,64,154
24948,Sweden,1988.0,7,5,34,46
24949,Sweden,1920.0,52,38,64,154
24950,Sweden,1920.0,52,38,64,154
24951,Sweden,1920.0,52,38,64,154
24952,Erna Signe,1912.0,103,62,25,190
24953,Sweden,1908.0,48,18,18,84
24954,Sweden,1912.0,103,62,25,190
24955,Sweden,1920.0,52,38,64,154
24956,Sweden,1920.0,52,38,64,154
24957,Sweden,1920.0,52,38,64,154
24958,Sweden,1924.0,8,30,43,81
24959,Sweden,1924.0,8,30,43,81
24960,Sweden,2014.0,8,32,11,51
24961,Sweden,1912.0,103,62,25,190
24962,Sweden,1908.0,48,18,18,84
24963,Sweden,2012.0,2,17,3,22
24964,Sweden,1920.0,52,38,64,154
24965,Sweden,1996.0,3,23,5,31
24966,Sweden,2000.0,4,20,8,32
24967,Sweden,1912.0,103,62,25,190
24968,Sweden,1912.0,103,62,25,190
24969,Sweden,1912.0,103,62,25,190
24970,Sweden,1928.0,9,21,23,53
24971,Sweden,1936.0,9,13,23,45
24972,Sweden,1936.0,9,13,23,45
24973,Sweden,1912.0,103,62,25,190
24974,Sweden,1952.0,23,24,46,93
24975,Sweden,1972.0,5,11,10,26
24976,Sweden,1972.0,5,11,10,26
24977,Sweden,1968.0,7,11,7,25
24978,Sweden,1968.0,7,11,7,25
24979,Sweden,2008.0,0,5,2,7
24980,Sweden,1936.0,9,13,23,45
24981,Sweden,1956.0,16,18,15,49
24982,Sweden,2002.0,0,2,24,26
24983,Sweden,2006.0,35,21,8,64
24984,Sweden,1956.0,16,18,15,49
24985,Sweden,1956.0,16,18,15,49
24986,Sweden,1948.0,37,18,33,88
24987,Sweden,1948.0,37,18,33,88
24988,Sweden,1952.0,23,24,46,93
24989,Sunshine,1936.0,9,13,23,45
24990,Sweden,1948.0,37,18,33,88
24991,Sweden,1984.0,10,20,34,64
24992,Sweden,1906.0,2,5,14,21
24993,Sweden,1906.0,2,5,14,21
24994,Sweden,1906.0,2,5,14,21
24995,Sweden,1906.0,2,5,14,21
24996,Sweden,1908.0,48,18,18,84
24997,Sweden,1908.0,48,18,18,84
24998,Sweden,1912.0,103,62,25,190
24999,Sweden,1960.0,7,4,5,16
25000,Sweden,1912.0,103,62,25,190
25001,Sweden,1920.0,52,38,64,154
25002,Sweden,1924.0,8,30,43,81
25003,Sweden,1912.0,103,62,25,190
25004,Sweden,1948.0,37,18,33,88
25005,Sweden,2012.0,2,17,3,22
25006,Sweden,2006.0,35,21,8,64
25007,Sweden,1948.0,37,18,33,88
25008,Sweden,1952.0,23,24,46,93
25009,Sweden,1992.0,2,27,13,42
25010,Sweden,2000.0,4,20,8,32
25011,Sweden,1912.0,103,62,25,190
25012,Sweden,2006.0,35,21,8,64
25013,Sweden,2006.0,35,21,8,64
25014,Sweden,1920.0,52,38,64,154
25015,Sweden,1920.0,52,38,64,154
25016,Sweden,1912.0,103,62,25,190
25017,Sweden,2006.0,35,21,8,64
25018,Sweden,2010.0,11,3,4,18
25019,Sweden,2016.0,2,23,3,28
25020,Sweden,1920.0,52,38,64,154
25021,Sweden,1998.0,0,2,5,7
25022,Sweden,2014.0,8,32,11,51
25023,Sweden,1952.0,23,24,46,93
25024,Sweden,1956.0,16,18,15,49
25025,Sweden,1906.0,2,5,14,21
25026,Sweden,1912.0,103,62,25,190
25027,Sweden,1924.0,8,30,43,81
25028,Sweden,1948.0,37,18,33,88
25029,Sweden,2002.0,0,2,24,26
25030,Sweden,2006.0,35,21,8,64
25031,Sweden,1980.0,6,8,29,43
25032,Sweden,1984.0,10,20,34,64
25033,Sweden,1912.0,103,62,25,190
25034,Sweden,1928.0,9,21,23,53
25035,Sweden,1948.0,37,18,33,88
25036,Sweden,1924.0,8,30,43,81
25037,Sweden,1994.0,23,1,0,24
25038,Sweden,1992.0,2,27,13,42
25039,Sweden,1996.0,3,23,5,31
25040,Sweden,2000.0,4,20,8,32
25041,Sweden,1988.0,7,5,34,46
25042,Sweden,1952.0,23,24,46,93
25043,Sweden,1924.0,8,30,43,81
25044,Sweden,1928.0,9,21,23,53
25045,Sweden,1932.0,14,9,12,35
25046,Sweden,1920.0,52,38,64,154
25047,Sweden,1988.0,7,5,34,46
25048,Erna Signe,1912.0,103,62,25,190
25049,Sweden,2006.0,35,21,8,64
25050,Sweden,1924.0,8,30,43,81
25051,Sweden,1952.0,23,24,46,93
25052,Sweden,1924.0,8,30,43,81
25053,Sweden,1912.0,103,62,25,190
25054,Sweden,2002.0,0,2,24,26
25055,Sweden,2006.0,35,21,8,64
25056,Sweden,1908.0,48,18,18,84
25057,Sweden,1980.0,6,8,29,43
25058,Sweden,1996.0,3,23,5,31
25059,Sweden,2000.0,4,20,8,32
25060,Sweden,1980.0,6,8,29,43
25061,Sweden,1948.0,37,18,33,88
25062,Sweden,1956.0,16,18,15,49
25063,Sweden,1960.0,7,4,5,16
25064,Sweden,1948.0,37,18,33,88
25065,Sweden,1952.0,23,24,46,93
25066,Sweden,1952.0,23,24,46,93
25067,Sweden,1992.0,2,27,13,42
25068,Sweden,1992.0,2,27,13,42
25069,Sweden,1980.0,6,8,29,43
25070,Sweden,1996.0,3,23,5,31
25071,Sweden,1912.0,103,62,25,190
25072,Sweden,1912.0,103,62,25,190
25073,Sweden,1994.0,23,1,0,24
25074,Sweden,2000.0,4,20,8,32
25075,Sweden,2008.0,0,5,2,7
25076,Sweden,2012.0,2,17,3,22
25077,May Be,1936.0,9,13,23,45
25078,Ali-Baba II,1948.0,37,18,33,88
25079,Sweden,1996.0,3,23,5,31
25080,Sweden,2000.0,4,20,8,32
25081,Sweden,1980.0,6,8,29,43
25082,Sweden,2006.0,35,21,8,64
25083,Sweden,2010.0,11,3,4,18
25084,Sweden,1972.0,5,11,10,26
25085,Sweden,2006.0,35,21,8,64
25086,Sweden,1952.0,23,24,46,93
25087,Sweden,1920.0,52,38,64,154
25088,Sweden,1920.0,52,38,64,154
25089,Sweden,1928.0,9,21,23,53
25090,Sweden,1912.0,103,62,25,190
25091,Sweden,1912.0,103,62,25,190
25092,Sweden,1912.0,103,62,25,190
25093,Kitty-1,1912.0,103,62,25,190
25094,Sweden,1920.0,52,38,64,154
25095,Sweden,1980.0,6,8,29,43
25096,Sweden,1912.0,103,62,25,190
25097,Sweden,1920.0,52,38,64,154
25098,Sweden,1924.0,8,30,43,81
25099,Kullan,1920.0,52,38,64,154
25100,Sweden,1948.0,37,18,33,88
25101,Sweden,1948.0,37,18,33,88
25102,Sweden,1928.0,9,21,23,53
25103,Sweden,2006.0,35,21,8,64
25104,Sweden,2014.0,8,32,11,51
25105,Sweden,1980.0,6,8,29,43
25106,Sweden,1920.0,52,38,64,154
25107,Sweden,1920.0,52,38,64,154
25108,Sweden,1924.0,8,30,43,81
25109,Sweden,1912.0,103,62,25,190
25110,Sweden,1948.0,37,18,33,88
25111,Sweden,1948.0,37,18,33,88
25112,Sweden,1952.0,23,24,46,93
25113,Sweden,1964.0,9,25,9,43
25114,Sweden,1912.0,103,62,25,190
25115,Sweden,1996.0,3,23,5,31
25116,Sweden,1964.0,9,25,9,43
25117,Sweden,1920.0,52,38,64,154
25118,Sweden,1912.0,103,62,25,190
25119,Sweden,1948.0,37,18,33,88
25120,Sweden,1952.0,23,24,46,93
25121,Sweden,1920.0,52,38,64,154
25122,Sweden,1992.0,2,27,13,42
25123,Sweden,1912.0,103,62,25,190
25124,Sweden,1920.0,52,38,64,154
25125,Sweden,1924.0,8,30,43,81
25126,Sweden,1920.0,52,38,64,154
25127,Sweden,1924.0,8,30,43,81
25128,Sweden,1928.0,9,21,23,53
25129,Sweden,1932.0,14,9,12,35
25130,Sweden,1920.0,52,38,64,154
25131,Sweden,1920.0,52,38,64,154
25132,Sweden,1912.0,103,62,25,190
25133,Sweden,1908.0,48,18,18,84
25134,Sweden,1998.0,0,2,5,7
25135,Sweden,1980.0,6,8,29,43
25136,Sweden,1980.0,6,8,29,43
25137,Sweden,1920.0,52,38,64,154
25138,Sweden,1908.0,48,18,18,84
25139,Sweden,1920.0,52,38,64,154
25140,Sweden,2002.0,0,2,24,26
25141,Sweden,2006.0,35,21,8,64
25142,Sweden,1964.0,9,25,9,43
25143,Sweden,1968.0,7,11,7,25
25144,Sweden,1912.0,103,62,25,190
25145,Sweden,1936.0,9,13,23,45
25146,Sweden,1920.0,52,38,64,154
25147,Sweden,2016.0,2,23,3,28
25148,Sweden,1906.0,2,5,14,21
25149,Elsie,1920.0,52,38,64,154
25150,Sweden,1924.0,8,30,43,81
25151,Sweden,1948.0,37,18,33,88
25152,Sweden,1952.0,23,24,46,93
25153,Sweden,1964.0,9,25,9,43
25154,Sweden,1984.0,10,20,34,64
25155,Sweden,1984.0,10,20,34,64
25156,Sweden,1984.0,10,20,34,64
25157,Sweden,1984.0,10,20,34,64
25158,Sweden,1908.0,48,18,18,84
25159,Sweden,2006.0,35,21,8,64
25160,Sweden,1988.0,7,5,34,46
25161,Sweden,1980.0,6,8,29,43
25162,Sweden,1988.0,7,5,34,46
25163,Sweden,1912.0,103,62,25,190
25164,Sweden,1920.0,52,38,64,154
25165,Sweden,1912.0,103,62,25,190
25166,Sweden,1920.0,52,38,64,154
25167,Sweden,1920.0,52,38,64,154
25168,Sweden,1984.0,10,20,34,64
25169,Sweden,2010.0,11,3,4,18
25170,Sweden,1988.0,7,5,34,46
25171,Sweden,2012.0,2,17,3,22
25172,Sweden,1996.0,3,23,5,31
25173,Sweden,1980.0,6,8,29,43
25174,Sweden,1994.0,23,1,0,24
25175,Sweden,1984.0,10,20,34,64
25176,Sweden,1920.0,52,38,64,154
25177,Sweden,2014.0,8,32,11,51
25178,Sweden,2006.0,35,21,8,64
25179,Sweden,2012.0,2,17,3,22
25180,Denmark/Sweden,1900.0,3,0,1,4
25181,Sweden,1920.0,52,38,64,154
25182,Sweden,1948.0,37,18,33,88
25183,Sweden,1952.0,23,24,46,93
25184,Sweden,1920.0,52,38,64,154
25185,Sweden,1948.0,37,18,33,88
25186,Sweden,2000.0,4,20,8,32
25187,Sweden,2004.0,5,5,2,12
25188,Sweden,1964.0,9,25,9,43
25189,Sweden,1948.0,37,18,33,88
25190,Sweden,1952.0,23,24,46,93
25191,Sweden,1956.0,16,18,15,49
25192,Sweden,1964.0,9,25,9,43
25193,Sweden,1920.0,52,38,64,154
25194,Sweden,1908.0,48,18,18,84
25195,Sweden,1912.0,103,62,25,190
25196,Sweden,2014.0,8,32,11,51
25197,Sweden,1948.0,37,18,33,88
25198,Sweden,2006.0,35,21,8,64
25199,Sweden,2010.0,11,3,4,18
25200,Sweden,1908.0,48,18,18,84
25201,Sweden,1908.0,48,18,18,84
25202,Sweden,1980.0,6,8,29,43
25203,Sweden,1908.0,48,18,18,84
25204,Sweden,1948.0,37,18,33,88
25205,Sweden,1948.0,37,18,33,88
25206,Sweden,1948.0,37,18,33,88
25207,Sweden,1948.0,37,18,33,88
25208,Sweden,2012.0,2,17,3,22
25209,Sweden,1912.0,103,62,25,190
25210,Sweden,1984.0,10,20,34,64
25211,Sweden,1952.0,23,24,46,93
25212,Sweden,1912.0,103,62,25,190
25213,Sweden,1912.0,103,62,25,190
25214,Sweden,1964.0,9,25,9,43
25215,Sweden,1912.0,103,62,25,190
25216,Sweden,1912.0,103,62,25,190
25217,Sweden,1920.0,52,38,64,154
25218,Sweden,1906.0,2,5,14,21
25219,Sweden,1908.0,48,18,18,84
25220,Sweden,1912.0,103,62,25,190
25221,Sweden,1908.0,48,18,18,84
25222,Sweden,1912.0,103,62,25,190
25223,Sweden,1920.0,52,38,64,154
25224,Sweden,1952.0,23,24,46,93
25225,Kitty-1,1912.0,103,62,25,190
25226,Sweden,1998.0,0,2,5,7
25227,Sweden,1936.0,9,13,23,45
25228,Sweden,2014.0,8,32,11,51
25229,Sweden,1964.0,9,25,9,43
25230,Sweden,1964.0,9,25,9,43
25231,Sweden,1952.0,23,24,46,93
25232,Sweden,1928.0,9,21,23,53
25233,Sweden,1924.0,8,30,43,81
25234,Sweden,2014.0,8,32,11,51
25235,Sweden,1984.0,10,20,34,64
25236,Sweden,1988.0,7,5,34,46
25237,Sweden,1920.0,52,38,64,154
25238,Hojwa,1952.0,23,24,46,93
25239,Sweden,1920.0,52,38,64,154
25240,Sweden,1920.0,52,38,64,154
25241,Sweden,1984.0,10,20,34,64
25242,Sweden,2006.0,35,21,8,64
25243,Sweden,1964.0,9,25,9,43
25244,Sweden,2006.0,35,21,8,64
25245,Sweden,1920.0,52,38,64,154
25246,Sweden,2006.0,35,21,8,64
25247,Sweden,2006.0,35,21,8,64
25248,Sweden,1908.0,48,18,18,84
25249,Sweden,1928.0,9,21,23,53
25250,Sweden,1928.0,9,21,23,53
25251,Sweden,1984.0,10,20,34,64
25252,Sweden,1984.0,10,20,34,64
25253,Sweden,1992.0,2,27,13,42
25254,Sweden,1996.0,3,23,5,31
25255,Sweden,2004.0,5,5,2,12
25256,Sweden,1992.0,2,27,13,42
25257,Sweden,1968.0,7,11,7,25
25258,Sweden,2006.0,35,21,8,64
25259,Sweden,2010.0,11,3,4,18
25260,Sweden,2010.0,11,3,4,18
25261,Sweden,2010.0,11,3,4,18
25262,Sweden,2014.0,8,32,11,51
25263,Sweden,2014.0,8,32,11,51
25264,Sweden,1992.0,2,27,13,42
25265,Sweden,1996.0,3,23,5,31
25266,Sweden,1948.0,37,18,33,88
25267,Sweden,1992.0,2,27,13,42
25268,Sweden,1996.0,3,23,5,31
25269,Sweden,2000.0,4,20,8,32
25270,Sweden,1912.0,103,62,25,190
25271,Sweden,1984.0,10,20,34,64
25272,Sweden,1994.0,23,1,0,24
25273,Sweden,1912.0,103,62,25,190
25274,Sweden,2000.0,4,20,8,32
25275,Sweden,2004.0,5,5,2,12
25276,Sweden,1948.0,37,18,33,88
25277,Sweden,1948.0,37,18,33,88
25278,Sweden,1952.0,23,24,46,93
25279,Sweden,2006.0,35,21,8,64
25280,Sweden,1984.0,10,20,34,64
25281,Sweden,1988.0,7,5,34,46
25282,Sweden,1932.0,14,9,12,35
25283,Sweden,2006.0,35,21,8,64
25284,Sweden,1912.0,103,62,25,190
25285,Sweden,1912.0,103,62,25,190
25286,Sweden,1952.0,23,24,46,93
25287,Slaghoken II,1956.0,16,18,15,49
25288,Sweden,2002.0,0,2,24,26
25289,Sweden,2002.0,0,2,24,26
25290,Sweden,2006.0,35,21,8,64
25291,Sweden,2006.0,35,21,8,64
25292,Sweden,2006.0,35,21,8,64
25293,Sweden,2010.0,11,3,4,18
25294,Sweden,1912.0,103,62,25,190
25295,Sweden,1912.0,103,62,25,190
25296,Sweden,1920.0,52,38,64,154
25297,Sweden,1998.0,0,2,5,7
25298,Sweden,1920.0,52,38,64,154
25299,Sweden,1952.0,23,24,46,93
25300,Sweden,1956.0,16,18,15,49
25301,Sweden,1924.0,8,30,43,81
25302,Erna Signe,1912.0,103,62,25,190
25303,Sweden,1924.0,8,30,43,81
25304,Sweden,2012.0,2,17,3,22
25305,Sweden,1928.0,9,21,23,53
25306,Sweden,1980.0,6,8,29,43
25307,Sweden,1908.0,48,18,18,84
25308,Sweden,1964.0,9,25,9,43
25309,Sweden,1972.0,5,11,10,26
25310,Sweden,2014.0,8,32,11,51
25311,Sweden,2014.0,8,32,11,51
25312,Sweden,1996.0,3,23,5,31
25313,Sweden,1920.0,52,38,64,154
25314,Sweden,1920.0,52,38,64,154
25315,Sweden,1968.0,7,11,7,25
25316,Sweden,1948.0,37,18,33,88
25317,Humbug V,1964.0,9,25,9,43
25318,Sweden,1972.0,5,11,10,26
25319,Sweden,1920.0,52,38,64,154
25320,Sweden,1912.0,103,62,25,190
25321,Sweden,1924.0,8,30,43,81
25322,Sweden,1920.0,52,38,64,154
25323,Sweden,1964.0,9,25,9,43
25324,Sweden,1968.0,7,11,7,25
25325,Sweden,1964.0,9,25,9,43
25326,Sweden,1968.0,7,11,7,25
25327,Sweden,1968.0,7,11,7,25
25328,Sweden,1952.0,23,24,46,93
25329,Sweden,1928.0,9,21,23,53
25330,Sweden,1964.0,9,25,9,43
25331,Sweden,1996.0,3,23,5,31
25332,Sweden,2000.0,4,20,8,32
25333,Sweden,2002.0,0,2,24,26
25334,Sweden,1952.0,23,24,46,93
25335,Sweden,1988.0,7,5,34,46
25336,Sweden,1980.0,6,8,29,43
25337,Sweden,1964.0,9,25,9,43
25338,Sweden,1924.0,8,30,43,81
25339,Sweden,1964.0,9,25,9,43
25340,Sweden,1968.0,7,11,7,25
25341,Sweden,1968.0,7,11,7,25
25342,Sweden,1924.0,8,30,43,81
25343,Sweden,1952.0,23,24,46,93
25344,Sweden,1956.0,16,18,15,49
25345,Sweden,1956.0,16,18,15,49
25346,Sweden,2014.0,8,32,11,51
25347,Sweden,1980.0,6,8,29,43
25348,Sweden,1960.0,7,4,5,16
25349,Sweden,1960.0,7,4,5,16
25350,Sweden,1928.0,9,21,23,53
25351,Sweden,1980.0,6,8,29,43
25352,Sweden,1984.0,10,20,34,64
25353,Sweden,1912.0,103,62,25,190
25354,Sweden,1952.0,23,24,46,93
25355,Sweden,1920.0,52,38,64,154
25356,Sweden,2010.0,11,3,4,18
25357,Sweden,2014.0,8,32,11,51
25358,Sweden,2014.0,8,32,11,51
25359,Sweden,2002.0,0,2,24,26
25360,Sweden,1920.0,52,38,64,154
25361,Sweden,1928.0,9,21,23,53
25362,Sweden,1932.0,14,9,12,35
25363,Sweden,1984.0,10,20,34,64
25364,Sweden,2016.0,2,23,3,28
25365,Sweden,1994.0,23,1,0,24
25366,Sweden,2016.0,2,23,3,28
25367,Sweden,1964.0,9,25,9,43
25368,Sweden,1964.0,9,25,9,43
25369,Sweden,1968.0,7,11,7,25
25370,Sweden,1932.0,14,9,12,35
25371,Sweden,1956.0,16,18,15,49
25372,Sweden,2002.0,0,2,24,26
25373,Sweden,2006.0,35,21,8,64
25374,Sweden,1952.0,23,24,46,93
25375,Sweden,1908.0,48,18,18,84
25376,Sweden,1948.0,37,18,33,88
25377,Sweden,1908.0,48,18,18,84
25378,Sweden,1912.0,103,62,25,190
25379,Sweden,1912.0,103,62,25,190
25380,Sweden,1948.0,37,18,33,88
25381,Sweden,1908.0,48,18,18,84
25382,Sweden,1992.0,2,27,13,42
25383,Sweden,1996.0,3,23,5,31
25384,Kitty-1,1912.0,103,62,25,190
25385,Sweden,1972.0,5,11,10,26
25386,Roddklubben af 1912-1,1912.0,103,62,25,190
25387,Sweden,2016.0,2,23,3,28
25388,Sweden,1908.0,48,18,18,84
25389,Sweden,2002.0,0,2,24,26
25390,Sweden,2006.0,35,21,8,64
25391,Sweden,1984.0,10,20,34,64
25392,Sweden,1988.0,7,5,34,46
25393,Sweden,1920.0,52,38,64,154
25394,Sweden,1908.0,48,18,18,84
25395,Sweden,1952.0,23,24,46,93
25396,Sweden,1924.0,8,30,43,81
25397,Sif,1920.0,52,38,64,154
25398,Sweden,1994.0,23,1,0,24
25399,Sweden,1952.0,23,24,46,93
25400,Sweden,1952.0,23,24,46,93
25401,Sweden,1956.0,16,18,15,49
25402,Sweden,1956.0,16,18,15,49
25403,Sweden,1908.0,48,18,18,84
25404,May Be,1936.0,9,13,23,45
25405,Ali-Baba II,1948.0,37,18,33,88
25406,May Be,1936.0,9,13,23,45
25407,Erna Signe,1912.0,103,62,25,190
25408,Sweden,2012.0,2,17,3,22
25409,Sweden,1994.0,23,1,0,24
25410,Sweden,2002.0,0,2,24,26
25411,Sweden,1956.0,16,18,15,49
25412,Sweden,2016.0,2,23,3,28
25413,Sweden,1952.0,23,24,46,93
25414,Sweden,2006.0,35,21,8,64
25415,Sweden,1980.0,6,8,29,43
25416,Sweden,1988.0,7,5,34,46
25417,Sweden,1952.0,23,24,46,93
25418,Vinga-1,1908.0,48,18,18,84
25419,Kerstin-1,1912.0,103,62,25,190
25420,Sweden,1952.0,23,24,46,93
25421,Kerstin-1,1912.0,103,62,25,190
25422,Sylvia,1928.0,9,21,23,53
25423,Sylvia,1928.0,9,21,23,53
25424,Sylvia,1928.0,9,21,23,53
25425,Sweden,1968.0,7,11,7,25
25426,Sweden,1920.0,52,38,64,154
25427,Sweden,1924.0,8,30,43,81
25428,Sweden,1932.0,14,9,12,35
25429,Sweden,1936.0,9,13,23,45
25430,Sweden,1920.0,52,38,64,154
25431,Sweden,1984.0,10,20,34,64
25432,Sweden,1988.0,7,5,34,46
25433,Sweden,1952.0,23,24,46,93
25434,Sweden,1920.0,52,38,64,154
25435,Sweden,1908.0,48,18,18,84
25436,Sweden,2016.0,2,23,3,28
25437,Sweden,2016.0,2,23,3,28
25438,Sweden,2006.0,35,21,8,64
25439,Sweden,2014.0,8,32,11,51
25440,Sweden,2006.0,35,21,8,64
25441,Sweden,2016.0,2,23,3,28
25442,Sweden,1948.0,37,18,33,88
25443,Sweden,1948.0,37,18,33,88
25444,Sweden,2016.0,2,23,3,28
25445,Sweden,1908.0,48,18,18,84
25446,Sweden-1,1912.0,103,62,25,190
25447,Sweden-3,1912.0,103,62,25,190
25448,Sweden-2,1912.0,103,62,25,190
25449,Sweden,1924.0,8,30,43,81
25450,Sweden,1948.0,37,18,33,88
25451,Sweden,1948.0,37,18,33,88
25452,Sweden,2014.0,8,32,11,51
25453,Sweden,2014.0,8,32,11,51
25454,Sweden,1912.0,103,62,25,190
25455,Sweden,1912.0,103,62,25,190
25456,Sweden,1996.0,3,23,5,31
25457,Sweden,2000.0,4,20,8,32
25458,Sweden,1920.0,52,38,64,154
25459,Sweden,1908.0,48,18,18,84
25460,Sweden,2000.0,4,20,8,32
25461,Sweden,1984.0,10,20,34,64
25462,Sweden,1988.0,7,5,34,46
25463,Sweden,1992.0,2,27,13,42
25464,Sweden,1992.0,2,27,13,42
25465,Sweden,1908.0,48,18,18,84
25466,Sweden,1960.0,7,4,5,16
25467,Sweden,1964.0,9,25,9,43
25468,Sweden,2002.0,0,2,24,26
25469,Sweden,2006.0,35,21,8,64
25470,Sweden,1948.0,37,18,33,88
25471,Sweden,1952.0,23,24,46,93
25472,Sweden,1928.0,9,21,23,53
25473,Sweden,1928.0,9,21,23,53
25474,Sweden,1932.0,14,9,12,35
25475,Sweden,2012.0,2,17,3,22
25476,Sweden,1948.0,37,18,33,88
25477,Sweden,2016.0,2,23,3,28
25478,Sweden,2016.0,2,23,3,28
25479,Sweden,2016.0,2,23,3,28
25480,Sweden,1972.0,5,11,10,26
25481,Sweden,1984.0,10,20,34,64
25482,Sweden,1988.0,7,5,34,46
25483,Sweden,1992.0,2,27,13,42
25484,Sweden,1980.0,6,8,29,43
25485,Sweden,1928.0,9,21,23,53
25486,Sweden,1920.0,52,38,64,154
25487,Sweden,1924.0,8,30,43,81
25488,Sweden,1952.0,23,24,46,93
25489,Sweden,1956.0,16,18,15,49
25490,Sweden,2006.0,35,21,8,64
25491,Sweden,2010.0,11,3,4,18
25492,Sweden,1976.0,9,1,2,12
25493,Sweden,1984.0,10,20,34,64
25494,Sweden,1988.0,7,5,34,46
25495,Sweden,1920.0,52,38,64,154
25496,Sweden,1984.0,10,20,34,64
25497,Sweden,1906.0,2,5,14,21
25498,Sweden,1906.0,2,5,14,21
25499,Sweden,1908.0,48,18,18,84
25500,Sweden,1980.0,6,8,29,43
25501,Denmark/Sweden,1900.0,3,0,1,4
25502,Sweden,1988.0,7,5,34,46
25503,Sweden,1920.0,52,38,64,154
25504,Sweden,1956.0,16,18,15,49
25505,Sweden,1912.0,103,62,25,190
25506,Sweden,1920.0,52,38,64,154
25507,Sweden,1908.0,48,18,18,84
25508,Sweden,1908.0,48,18,18,84
25509,Sweden,1908.0,48,18,18,84
25510,Denmark/Sweden,1900.0,3,0,1,4
25511,Sweden,1924.0,8,30,43,81
25512,Sweden,1948.0,37,18,33,88
25513,Sweden,1952.0,23,24,46,93
25514,Sweden,1920.0,52,38,64,154
25515,Sweden,2014.0,8,32,11,51
25516,Sweden,1964.0,9,25,9,43
25517,Kullan,1920.0,52,38,64,154
25518,Sweden,1976.0,9,1,2,12
25519,Sweden,1980.0,6,8,29,43
25520,Sweden,1980.0,6,8,29,43
25521,Sweden,1920.0,52,38,64,154
25522,Sweden,1920.0,52,38,64,154
25523,Sweden,2016.0,2,23,3,28
25524,Sweden,1964.0,9,25,9,43
25525,Sweden,1912.0,103,62,25,190
25526,Sweden,1994.0,23,1,0,24
25527,Sweden,1964.0,9,25,9,43
25528,Rush V,1956.0,16,18,15,49
25529,Rush VII,1964.0,9,25,9,43
25530,Sweden,1948.0,37,18,33,88
25531,Sweden,1960.0,7,4,5,16
25532,Sweden,1964.0,9,25,9,43
25533,Sweden,1968.0,7,11,7,25
25534,Sweden,1928.0,9,21,23,53
25535,Sweden,1924.0,8,30,43,81
25536,Sweden,1956.0,16,18,15,49
25537,Sweden,1968.0,7,11,7,25
25538,Sweden,1968.0,7,11,7,25
25539,Sweden,1968.0,7,11,7,25
25540,Swedish Star,1932.0,14,9,12,35
25541,Sweden,2006.0,35,21,8,64
25542,Sweden,2006.0,35,21,8,64
25543,Sweden,1912.0,103,62,25,190
25544,Sweden,1992.0,2,27,13,42
25545,Humbug V,1964.0,9,25,9,43
25546,Sweden,1992.0,2,27,13,42
25547,Sweden,2000.0,4,20,8,32
25548,Sweden,1984.0,10,20,34,64
25549,Sweden,1984.0,10,20,34,64
25550,Sweden,1984.0,10,20,34,64
25551,Sweden,1984.0,10,20,34,64
25552,Sweden,1988.0,7,5,34,46
25553,Sweden,1988.0,7,5,34,46
25554,Sweden,1906.0,2,5,14,21
25555,Sweden,1906.0,2,5,14,21
25556,Sweden,1908.0,48,18,18,84
25557,Sweden,2006.0,35,21,8,64
25558,Sweden,2010.0,11,3,4,18
25559,Sweden,1936.0,9,13,23,45
25560,Sweden,1928.0,9,21,23,53
25561,Sweden,1920.0,52,38,64,154
25562,Sweden,1924.0,8,30,43,81
25563,Sweden,1906.0,2,5,14,21
25564,Sweden,1936.0,9,13,23,45
25565,Sweden,1932.0,14,9,12,35
25566,Sweden,1920.0,52,38,64,154
25567,Sweden,1920.0,52,38,64,154
25568,Elsie,1920.0,52,38,64,154
25569,Sweden,1952.0,23,24,46,93
25570,Sweden,1912.0,103,62,25,190
25571,Sweden,1908.0,48,18,18,84
25572,Sweden,1912.0,103,62,25,190
25573,Sweden,1964.0,9,25,9,43
25574,Sweden,1952.0,23,24,46,93
25575,Sweden,1994.0,23,1,0,24
25576,Sweden,2016.0,2,23,3,28
25577,Sweden,1964.0,9,25,9,43
25578,Elsie,1920.0,52,38,64,154
25579,Sweden,1924.0,8,30,43,81
25580,Sweden,1924.0,8,30,43,81
25581,Sweden,1928.0,9,21,23,53
25582,Sweden,1932.0,14,9,12,35
25583,Sweden,1948.0,37,18,33,88
25584,Sweden,1924.0,8,30,43,81
25585,Sweden,1992.0,2,27,13,42
25586,Sweden,1996.0,3,23,5,31
25587,Sweden,2000.0,4,20,8,32
25588,Sweden,1972.0,5,11,10,26
25589,Sweden,1908.0,48,18,18,84
25590,Sweden,1912.0,103,62,25,190
25591,Sweden,1912.0,103,62,25,190
25592,Sweden,1920.0,52,38,64,154
25593,Sweden,1920.0,52,38,64,154
25594,Sweden,1920.0,52,38,64,154
25595,Sweden,1924.0,8,30,43,81
25596,Sweden,1924.0,8,30,43,81
25597,Sweden,1924.0,8,30,43,81
25598,Sweden,1908.0,48,18,18,84
25599,Sweden,1908.0,48,18,18,84
25600,Sweden,1908.0,48,18,18,84
25601,Sweden,1912.0,103,62,25,190
25602,Sweden,1912.0,103,62,25,190
25603,Sweden,1920.0,52,38,64,154
25604,Sweden,1924.0,8,30,43,81
25605,Sweden,2014.0,8,32,11,51
25606,Sweden,1984.0,10,20,34,64
25607,Sweden,1948.0,37,18,33,88
25608,Sweden,1952.0,23,24,46,93
25609,Sweden,2006.0,35,21,8,64
25610,Sif,1920.0,52,38,64,154
25611,Sweden,1912.0,103,62,25,190
25612,Sweden,1984.0,10,20,34,64
25613,Sweden,1924.0,8,30,43,81
25614,Sweden,1984.0,10,20,34,64
25615,Sans Atout-1,1912.0,103,62,25,190
25616,Sweden,1928.0,9,21,23,53
25617,Sweden,1936.0,9,13,23,45
25618,Sweden,1948.0,37,18,33,88
25619,Sweden,1972.0,5,11,10,26
25620,Sweden,1928.0,9,21,23,53
25621,Sweden,1908.0,48,18,18,84
25622,Sweden,1952.0,23,24,46,93
25623,Sweden,1956.0,16,18,15,49
25624,Vinga-1,1908.0,48,18,18,84
25625,Rush V,1956.0,16,18,15,49
25626,Rush VII,1964.0,9,25,9,43
25627,Sweden,1992.0,2,27,13,42
25628,Sweden,1996.0,3,23,5,31
25629,Sweden,2000.0,4,20,8,32
25630,Sweden,1952.0,23,24,46,93
25631,Sweden,2006.0,35,21,8,64
25632,Sweden,2006.0,35,21,8,64
25633,Sweden,1948.0,37,18,33,88
25634,Sweden,1924.0,8,30,43,81
25635,Sweden,1924.0,8,30,43,81
25636,Sweden,1912.0,103,62,25,190
25637,Sweden,2004.0,5,5,2,12
25638,Sweden,1920.0,52,38,64,154
25639,Sylvia,1928.0,9,21,23,53
25640,Sweden,1924.0,8,30,43,81
25641,Sweden,1912.0,103,62,25,190
25642,Sweden,1924.0,8,30,43,81
25643,Sweden,1936.0,9,13,23,45
25644,Sweden,1936.0,9,13,23,45
25645,Sweden,1948.0,37,18,33,88
25646,Sweden,1964.0,9,25,9,43
25647,Sweden,1932.0,14,9,12,35
25648,Sweden,1984.0,10,20,34,64
25649,Sweden,1956.0,16,18,15,49
25650,Sweden,2002.0,0,2,24,26
25651,Sweden,2006.0,35,21,8,64
25652,Sweden,1908.0,48,18,18,84
25653,Sweden,1952.0,23,24,46,93
25654,Sweden,1952.0,23,24,46,93
25655,Sweden,1912.0,103,62,25,190
25656,Sweden,1920.0,52,38,64,154
25657,Sweden,1924.0,8,30,43,81
25658,Sweden,1976.0,9,1,2,12
25659,Sweden,1906.0,2,5,14,21
25660,Sweden,1908.0,48,18,18,84
25661,Sweden,1912.0,103,62,25,190
25662,Sweden,1912.0,103,62,25,190
25663,Sweden,1912.0,103,62,25,190
25664,Sweden,1912.0,103,62,25,190
25665,Sweden,1908.0,48,18,18,84
25666,Sweden,1912.0,103,62,25,190
25667,Sweden,1920.0,52,38,64,154
25668,Sweden,1920.0,52,38,64,154
25669,Sweden,1972.0,5,11,10,26
25670,Sweden,1932.0,14,9,12,35
25671,Sweden,1932.0,14,9,12,35
25672,Sweden,2000.0,4,20,8,32
25673,Sweden,1924.0,8,30,43,81
25674,Sweden,1992.0,2,27,13,42
25675,Sweden,2000.0,4,20,8,32
25676,Sweden,1984.0,10,20,34,64
25677,Sweden,1996.0,3,23,5,31
25678,Sunshine,1936.0,9,13,23,45
25679,Vinga-1,1908.0,48,18,18,84
25680,Kitty-1,1912.0,103,62,25,190
25681,Sweden,1992.0,2,27,13,42
25682,Sweden,1996.0,3,23,5,31
25683,Sweden,1932.0,14,9,12,35
25684,Vinga-1,1908.0,48,18,18,84
25685,Kitty-1,1912.0,103,62,25,190
25686,Sweden,2002.0,0,2,24,26
25687,Sweden,2002.0,0,2,24,26
25688,Sweden,1920.0,52,38,64,154
25689,Sweden,1980.0,6,8,29,43
25690,Sweden,1984.0,10,20,34,64
25691,Sweden,1936.0,9,13,23,45
25692,Sweden,1980.0,6,8,29,43
25693,Sweden,1984.0,10,20,34,64
25694,Sweden,1984.0,10,20,34,64
25695,Sweden,1988.0,7,5,34,46
25696,Hojwa,1952.0,23,24,46,93
25697,Hojwa,1952.0,23,24,46,93
25698,Sweden,1980.0,6,8,29,43
25699,Sweden,1924.0,8,30,43,81
25700,Sweden,1912.0,103,62,25,190
25701,Sweden,1908.0,48,18,18,84
25702,Sweden,2014.0,8,32,11,51
25703,Sweden,1972.0,5,11,10,26
25704,Sweden,1924.0,8,30,43,81
25705,Sweden,1992.0,2,27,13,42
25706,Sweden,1912.0,103,62,25,190
25707,Sweden,1906.0,2,5,14,21
25708,Sweden,1972.0,5,11,10,26
25709,Sweden,1920.0,52,38,64,154
25710,Sweden,1924.0,8,30,43,81
25711,Sweden,1932.0,14,9,12,35
25712,Sans Atout-1,1912.0,103,62,25,190
25713,Sans Atout-1,1912.0,103,62,25,190
25714,Sweden,1948.0,37,18,33,88
25715,Sweden,1952.0,23,24,46,93
25716,Sweden,1924.0,8,30,43,81
25717,Sweden,1992.0,2,27,13,42
25718,Sweden,1994.0,23,1,0,24
25719,Sweden,1998.0,0,2,5,7
25720,Sweden,1984.0,10,20,34,64
25721,Sweden,1992.0,2,27,13,42
25722,Sweden,1996.0,3,23,5,31
25723,Sweden,1920.0,52,38,64,154
25724,Sweden,1924.0,8,30,43,81
25725,Sweden,1924.0,8,30,43,81
25726,Sweden,1928.0,9,21,23,53
25727,Sweden,1928.0,9,21,23,53
25728,Sweden,1912.0,103,62,25,190
25729,Sweden,1908.0,48,18,18,84
25730,Sweden,1912.0,103,62,25,190
25731,Sweden,2014.0,8,32,11,51
25732,Sweden,1936.0,9,13,23,45
25733,Sweden,1992.0,2,27,13,42
25734,Sweden,1932.0,14,9,12,35
25735,Sweden,1936.0,9,13,23,45
25736,Slaghoken II,1956.0,16,18,15,49
25737,Roddklubben af 1912-1,1912.0,103,62,25,190
25738,Sweden,1912.0,103,62,25,190
25739,Sweden,2006.0,35,21,8,64
25740,Sweden,1992.0,2,27,13,42
25741,Sweden,1996.0,3,23,5,31
25742,Sweden,2000.0,4,20,8,32
25743,Sweden,1948.0,37,18,33,88
25744,Sweden,2004.0,5,5,2,12
25745,Sweden,1912.0,103,62,25,190
25746,Sweden,1920.0,52,38,64,154
25747,Sweden,2006.0,35,21,8,64
25748,Sweden,2014.0,8,32,11,51
25749,South Africa,1956.0,0,0,7,7
25750,South Africa,2016.0,2,7,14,23
25751,South Africa,2016.0,2,7,14,23
25752,South Africa,1948.0,2,2,2,6
25753,South Africa,1924.0,1,1,1,3
25754,South Africa,1928.0,1,0,5,6
25755,South Africa,1948.0,2,2,2,6
25756,South Africa,1928.0,1,0,5,6
25757,South Africa,1956.0,0,0,7,7
25758,South Africa,1960.0,0,1,2,3
25759,South Africa,1920.0,3,12,6,21
25760,South Africa,1952.0,2,8,4,14
25761,South Africa,2016.0,2,7,14,23
25762,South Africa,2012.0,6,2,1,9
25763,South Africa,2016.0,2,7,14,23
25764,South Africa,1920.0,3,12,6,21
25765,South Africa,1932.0,2,0,3,5
25766,South Africa,1936.0,0,1,0,1
25767,South Africa,2004.0,4,3,3,10
25768,South Africa,1932.0,2,0,3,5
25769,South Africa,1920.0,3,12,6,21
25770,South Africa,2016.0,2,7,14,23
25771,South Africa,2004.0,4,3,3,10
25772,South Africa,1948.0,2,2,2,6
25773,South Africa,1952.0,2,8,4,14
25774,South Africa,2004.0,4,3,3,10
25775,South Africa,1992.0,0,3,0,3
25776,South Africa,1952.0,2,8,4,14
25777,South Africa,2016.0,2,7,14,23
25778,South Africa,1912.0,5,2,0,7
25779,South Africa,1920.0,3,12,6,21
25780,South Africa,1952.0,2,8,4,14
25781,South Africa,2012.0,6,2,1,9
25782,South Africa,1920.0,3,12,6,21
25783,South Africa,1908.0,1,1,0,2
25784,South Africa,2000.0,0,2,3,5
25785,South Africa,1996.0,3,1,1,5
25786,South Africa,1996.0,3,1,1,5
25787,South Africa,2000.0,0,2,3,5
25788,South Africa,2016.0,2,7,14,23
25789,South Africa,1948.0,2,2,2,6
25790,South Africa,1928.0,1,0,5,6
25791,South Africa,1920.0,3,12,6,21
25792,South Africa,1920.0,3,12,6,21
25793,South Africa,2016.0,2,7,14,23
25794,South Africa,1912.0,5,2,0,7
25795,South Africa,1912.0,5,2,0,7
25796,South Africa,2016.0,2,7,14,23
25797,South Africa,2016.0,2,7,14,23
25798,South Africa,1996.0,3,1,1,5
25799,South Africa,2000.0,0,2,3,5
25800,South Africa,2012.0,6,2,1,9
25801,South Africa,2012.0,6,2,1,9
25802,South Africa,2016.0,2,7,14,23
25803,South Africa,2016.0,2,7,14,23
25804,South Africa,1952.0,2,8,4,14
25805,South Africa,1912.0,5,2,0,7
25806,South Africa,1956.0,0,0,7,7
25807,South Africa,1932.0,2,0,3,5
25808,South Africa,2016.0,2,7,14,23
25809,South Africa,1912.0,5,2,0,7
25810,South Africa,1924.0,1,1,1,3
25811,South Africa,1992.0,0,3,0,3
25812,South Africa,1960.0,0,1,2,3
25813,South Africa,2008.0,0,1,0,1
25814,South Africa,1920.0,3,12,6,21
25815,South Africa,2004.0,4,3,3,10
25816,South Africa,1956.0,0,0,7,7
25817,South Africa,1956.0,0,0,7,7
25818,South Africa,2012.0,6,2,1,9
25819,South Africa,2004.0,4,3,3,10
25820,South Africa,1952.0,2,8,4,14
25821,South Africa,1992.0,0,3,0,3
25822,South Africa,1920.0,3,12,6,21
25823,South Africa,1920.0,3,12,6,21
25824,South Africa,2000.0,0,2,3,5
25825,South Africa,1932.0,2,0,3,5
25826,South Africa,1920.0,3,12,6,21
25827,South Africa,1928.0,1,0,5,6
25828,South Africa,1952.0,2,8,4,14
25829,South Africa,1956.0,0,0,7,7
25830,South Africa,1952.0,2,8,4,14
25831,South Africa,1952.0,2,8,4,14
25832,South Africa,1920.0,3,12,6,21
25833,South Africa,1920.0,3,12,6,21
25834,South Africa,1920.0,3,12,6,21
25835,South Africa,1928.0,1,0,5,6
25836,South Africa,2016.0,2,7,14,23
25837,South Africa,2016.0,2,7,14,23
25838,South Africa,2004.0,4,3,3,10
25839,South Africa,2004.0,4,3,3,10
25840,South Africa,2004.0,4,3,3,10
25841,South Africa,2012.0,6,2,1,9
25842,South Africa,2016.0,2,7,14,23
25843,South Africa,2016.0,2,7,14,23
25844,South Africa,1996.0,3,1,1,5
25845,South Africa,1952.0,2,8,4,14
25846,South Africa,1952.0,2,8,4,14
25847,South Africa,1948.0,2,2,2,6
25848,South Africa,1920.0,3,12,6,21
25849,South Africa,1920.0,3,12,6,21
25850,South Africa,1920.0,3,12,6,21
25851,South Africa,2012.0,6,2,1,9
25852,South Africa,2016.0,2,7,14,23
25853,South Africa,1924.0,1,1,1,3
25854,South Africa,2016.0,2,7,14,23
25855,South Africa,2016.0,2,7,14,23
25856,South Africa,1960.0,0,1,2,3
25857,South Africa,1932.0,2,0,3,5
25858,South Africa,2000.0,0,2,3,5
25859,South Africa,2004.0,4,3,3,10
25860,South Africa,1952.0,2,8,4,14
25861,South Africa,1956.0,0,0,7,7
25862,South Africa,2012.0,6,2,1,9
25863,South Africa,1996.0,3,1,1,5
25864,South Africa,1952.0,2,8,4,14
25865,South Africa,2004.0,4,3,3,10
25866,South Africa,2012.0,6,2,1,9
25867,South Africa,2016.0,2,7,14,23
25868,South Africa,1928.0,1,0,5,6
25869,South Africa,1948.0,2,2,2,6
25870,South Africa,2016.0,2,7,14,23
25871,South Africa,1952.0,2,8,4,14
25872,South Africa,2016.0,2,7,14,23
25873,South Africa,1920.0,3,12,6,21
25874,South Africa,1920.0,3,12,6,21
25875,South Africa,1908.0,1,1,0,2
25876,South Africa,1920.0,3,12,6,21
25877,South Africa,1912.0,5,2,0,7
25878,South Africa,1912.0,5,2,0,7
25879,South Africa,1920.0,3,12,6,21
25880,Turkey,2008.0,1,3,3,7
25881,Turkey,1948.0,6,4,2,12
25882,Turkey,1956.0,3,2,2,7
25883,Turkey,1964.0,2,3,1,6
25884,Turkey,1972.0,0,1,0,1
25885,Turkey,2016.0,1,3,4,8
25886,Turkey,2004.0,3,3,5,11
25887,Turkey,2004.0,3,3,5,11
25888,Turkey,2004.0,3,3,5,11
25889,Turkey,1968.0,2,0,0,2
25890,Turkey,1952.0,2,0,1,3
25891,Turkey,1948.0,6,4,2,12
25892,Turkey,1960.0,7,2,0,9
25893,Turkey,2008.0,1,3,3,7
25894,Turkey,1964.0,2,3,1,6
25895,Turkey,1968.0,2,0,0,2
25896,Turkey,1984.0,0,0,3,3
25897,Turkey,1964.0,2,3,1,6
25898,Turkey,1948.0,6,4,2,12
25899,Turkey,1992.0,2,2,2,6
25900,Turkey,1956.0,3,2,2,7
25901,Turkey,1960.0,7,2,0,9
25902,Turkey,2000.0,3,0,2,5
25903,Turkey,1996.0,4,1,1,6
25904,Turkey,2000.0,3,0,2,5
25905,Turkey,1960.0,7,2,0,9
25906,Turkey,1948.0,6,4,2,12
25907,Turkey,2012.0,2,2,1,5
25908,Turkey,2012.0,2,2,1,5
25909,Turkey,1984.0,0,0,3,3
25910,Turkey,1948.0,6,4,2,12
25911,Turkey,2016.0,1,3,4,8
25912,Turkey,1956.0,3,2,2,7
25913,Turkey,1960.0,7,2,0,9
25914,Turkey,1996.0,4,1,1,6
25915,Turkey,2016.0,1,3,4,8
25916,Turkey,1956.0,3,2,2,7
25917,Turkey,1948.0,6,4,2,12
25918,Turkey,1956.0,3,2,2,7
25919,Turkey,1936.0,1,0,1,2
25920,Turkey,2004.0,3,3,5,11
25921,Turkey,1952.0,2,0,1,3
25922,Turkey,1988.0,1,1,0,2
25923,Turkey,1960.0,7,2,0,9
25924,Turkey,1964.0,2,3,1,6
25925,Turkey,2016.0,1,3,4,8
25926,Turkey,2016.0,1,3,4,8
25927,Turkey,1956.0,3,2,2,7
25928,Turkey,1960.0,7,2,0,9
25929,Turkey,1964.0,2,3,1,6
25930,Turkey,1948.0,6,4,2,12
25931,Turkey,2012.0,2,2,1,5
25932,Turkey,2016.0,1,3,4,8
25933,Turkey,1992.0,2,2,2,6
25934,Turkey,2008.0,1,3,3,7
25935,Turkey,1936.0,1,0,1,2
25936,Turkey,1948.0,6,4,2,12
25937,Turkey,1960.0,7,2,0,9
25938,Turkey,1996.0,4,1,1,6
25939,Turkey,2000.0,3,0,2,5
25940,Turkey,2004.0,3,3,5,11
25941,Turkey,1960.0,7,2,0,9
25942,Turkey,1964.0,2,3,1,6
25943,Turkey,1948.0,6,4,2,12
25944,Turkey,1948.0,6,4,2,12
25945,Turkey,2004.0,3,3,5,11
25946,Turkey,2000.0,3,0,2,5
25947,Turkey,2008.0,1,3,3,7
25948,Turkey,1992.0,2,2,2,6
25949,Turkey,1996.0,4,1,1,6
25950,Turkey,2004.0,3,3,5,11
25951,Turkey,2004.0,3,3,5,11
25952,Turkey,2008.0,1,3,3,7
25953,Turkey,1948.0,6,4,2,12
25954,Turkey,1992.0,2,2,2,6
25955,Turkey,1960.0,7,2,0,9
25956,Turkey,1992.0,2,2,2,6
25957,Turkey,1952.0,2,0,1,3
25958,Turkey,1988.0,1,1,0,2
25959,Turkey,1992.0,2,2,2,6
25960,Turkey,1996.0,4,1,1,6
25961,Turkey,2008.0,1,3,3,7
25962,Turkey,2004.0,3,3,5,11
25963,Turkey,1984.0,0,0,3,3
25964,Turkey,2012.0,2,2,1,5
25965,Turkey,2016.0,1,3,4,8
25966,Turkey,1948.0,6,4,2,12
25967,Turkey,2004.0,3,3,5,11
25968,Turkey,2008.0,1,3,3,7
25969,Turkey,2012.0,2,2,1,5
25970,Turkey,2004.0,3,3,5,11
25971,Turkey,2016.0,1,3,4,8
25972,Turkey,1996.0,4,1,1,6
25973,Turkey,2000.0,3,0,2,5
25974,Turkey,1956.0,3,2,2,7
25975,Bulgaria,1980.0,8,44,39,91
25976,Bulgaria,1964.0,3,5,2,10
25977,Bulgaria,1980.0,8,44,39,91
25978,Bulgaria,1980.0,8,44,39,91
25979,Bulgaria,1972.0,6,10,6,22
25980,Bulgaria,1972.0,6,10,6,22
25981,Bulgaria,1976.0,8,13,18,39
25982,Bulgaria,1980.0,8,44,39,91
25983,Bulgaria,1972.0,6,10,6,22
25984,Bulgaria,1980.0,8,44,39,91
25985,Bulgaria,1988.0,10,14,17,41
25986,Bulgaria,2000.0,5,6,2,13
25987,Bulgaria,1988.0,10,14,17,41
25988,Bulgaria,1972.0,6,10,6,22
25989,Bulgaria,1960.0,1,3,3,7
25990,Bulgaria,1980.0,8,44,39,91
25991,Bulgaria,1972.0,6,10,6,22
25992,Bulgaria,1976.0,8,13,18,39
25993,Bulgaria,2000.0,5,6,2,13
25994,Bulgaria,1976.0,8,13,18,39
25995,Bulgaria,1980.0,8,44,39,91
25996,Bulgaria,1988.0,10,14,17,41
25997,Bulgaria,1980.0,8,44,39,91
25998,Bulgaria,1980.0,8,44,39,91
25999,Bulgaria,1980.0,8,44,39,91
26000,Bulgaria,1992.0,3,7,7,17
26001,Bulgaria,1996.0,3,12,6,21
26002,Bulgaria,1956.0,1,3,14,18
26003,Bulgaria,1980.0,8,44,39,91
26004,Bulgaria,1988.0,10,14,17,41
26005,Bulgaria,1992.0,3,7,7,17
26006,Bulgaria,1992.0,3,7,7,17
26007,Bulgaria,1972.0,6,10,6,22
26008,Bulgaria,1980.0,8,44,39,91
26009,Bulgaria,2004.0,2,1,14,17
26010,Bulgaria,1998.0,1,0,0,1
26011,Bulgaria,1972.0,6,10,6,22
26012,Bulgaria,1980.0,8,44,39,91
26013,Bulgaria,1980.0,8,44,39,91
26014,Bulgaria,1996.0,3,12,6,21
26015,Bulgaria,2016.0,0,1,6,7
26016,Bulgaria,1980.0,8,44,39,91
26017,Bulgaria,1956.0,1,3,14,18
26018,Bulgaria,1976.0,8,13,18,39
26019,Bulgaria,1980.0,8,44,39,91
26020,Bulgaria,1980.0,8,44,39,91
26021,Bulgaria,1956.0,1,3,14,18
26022,Bulgaria,1980.0,8,44,39,91
26023,Bulgaria,1980.0,8,44,39,91
26024,Bulgaria,1968.0,2,21,3,26
26025,Bulgaria,1968.0,2,21,3,26
26026,Bulgaria,1980.0,8,44,39,91
26027,Bulgaria,1980.0,8,44,39,91
26028,Bulgaria,1980.0,8,44,39,91
26029,Bulgaria,1956.0,1,3,14,18
26030,Bulgaria,1960.0,1,3,3,7
26031,Bulgaria,2004.0,2,1,14,17
26032,Bulgaria,1968.0,2,21,3,26
26033,Bulgaria,1988.0,10,14,17,41
26034,Bulgaria,1992.0,3,7,7,17
26035,Bulgaria,1988.0,10,14,17,41
26036,Bulgaria,1980.0,8,44,39,91
26037,Bulgaria,1988.0,10,14,17,41
26038,Bulgaria,1996.0,3,12,6,21
26039,Bulgaria,1968.0,2,21,3,26
26040,Bulgaria,1972.0,6,10,6,22
26041,Bulgaria,1996.0,3,12,6,21
26042,Bulgaria,1980.0,8,44,39,91
26043,Bulgaria,2000.0,5,6,2,13
26044,Bulgaria,2004.0,2,1,14,17
26045,Bulgaria,2008.0,1,1,3,5
26046,Bulgaria,1980.0,8,44,39,91
26047,Bulgaria,1988.0,10,14,17,41
26048,Bulgaria,1988.0,10,14,17,41
26049,Bulgaria,1980.0,8,44,39,91
26050,Bulgaria,1964.0,3,5,2,10
26051,Bulgaria,1968.0,2,21,3,26
26052,Bulgaria,1968.0,2,21,3,26
26053,Bulgaria,2004.0,2,1,14,17
26054,Bulgaria,2004.0,2,1,14,17
26055,Bulgaria,1968.0,2,21,3,26
26056,Bulgaria,1980.0,8,44,39,91
26057,Bulgaria,1976.0,8,13,18,39
26058,Bulgaria,1988.0,10,14,17,41
26059,Bulgaria,1980.0,8,44,39,91
26060,Bulgaria,1988.0,10,14,17,41
26061,Bulgaria,1980.0,8,44,39,91
26062,Bulgaria,1968.0,2,21,3,26
26063,Bulgaria,1988.0,10,14,17,41
26064,Bulgaria,1980.0,8,44,39,91
26065,Bulgaria,1988.0,10,14,17,41
26066,Bulgaria,1988.0,10,14,17,41
26067,Bulgaria,1988.0,10,14,17,41
26068,Bulgaria,1992.0,3,7,7,17
26069,Bulgaria,1988.0,10,14,17,41
26070,Bulgaria,1980.0,8,44,39,91
26071,Bulgaria,1976.0,8,13,18,39
26072,Bulgaria,1980.0,8,44,39,91
26073,Bulgaria,1976.0,8,13,18,39
26074,Bulgaria,1956.0,1,3,14,18
26075,Bulgaria,1992.0,3,7,7,17
26076,Bulgaria,1996.0,3,12,6,21
26077,Bulgaria,2000.0,5,6,2,13
26078,Bulgaria,2004.0,2,1,14,17
26079,Bulgaria,2004.0,2,1,14,17
26080,Bulgaria,1976.0,8,13,18,39
26081,Bulgaria,1980.0,8,44,39,91
26082,Bulgaria,1980.0,8,44,39,91
26083,Bulgaria,1968.0,2,21,3,26
26084,Bulgaria,1976.0,8,13,18,39
26085,Bulgaria,1980.0,8,44,39,91
26086,Bulgaria,1976.0,8,13,18,39
26087,Bulgaria,1980.0,8,44,39,91
26088,Bulgaria,1980.0,8,44,39,91
26089,Bulgaria,2004.0,2,1,14,17
26090,Bulgaria,1980.0,8,44,39,91
26091,Bulgaria,1976.0,8,13,18,39
26092,Bulgaria,1968.0,2,21,3,26
26093,Bulgaria,1992.0,3,7,7,17
26094,Bulgaria,1960.0,1,3,3,7
26095,Bulgaria,1964.0,3,5,2,10
26096,Bulgaria,1980.0,8,44,39,91
26097,Bulgaria,1988.0,10,14,17,41
26098,Bulgaria,1968.0,2,21,3,26
26099,Bulgaria,1980.0,8,44,39,91
26100,Bulgaria,2016.0,0,1,6,7
26101,Bulgaria,1960.0,1,3,3,7
26102,Bulgaria,1996.0,3,12,6,21
26103,Bulgaria,2016.0,0,1,6,7
26104,Bulgaria,1976.0,8,13,18,39
26105,Bulgaria,1980.0,8,44,39,91
26106,Bulgaria,1964.0,3,5,2,10
26107,Bulgaria,1996.0,3,12,6,21
26108,Bulgaria,2004.0,2,1,14,17
26109,Bulgaria,1968.0,2,21,3,26
26110,Bulgaria,1980.0,8,44,39,91
26111,Bulgaria,1988.0,10,14,17,41
26112,Bulgaria,1968.0,2,21,3,26
26113,Bulgaria,1980.0,8,44,39,91
26114,Bulgaria,1992.0,3,7,7,17
26115,Bulgaria,1980.0,8,44,39,91
26116,Bulgaria,1972.0,6,10,6,22
26117,Bulgaria,1976.0,8,13,18,39
26118,Bulgaria,1988.0,10,14,17,41
26119,Bulgaria,1992.0,3,7,7,17
26120,Bulgaria,1968.0,2,21,3,26
26121,Bulgaria,1972.0,6,10,6,22
26122,Bulgaria,1988.0,10,14,17,41
26123,Bulgaria,1996.0,3,12,6,21
26124,Bulgaria,2000.0,5,6,2,13
26125,Bulgaria,1956.0,1,3,14,18
26126,Bulgaria,1976.0,8,13,18,39
26127,Bulgaria,1980.0,8,44,39,91
26128,Bulgaria,1976.0,8,13,18,39
26129,Bulgaria,1996.0,3,12,6,21
26130,Bulgaria,1988.0,10,14,17,41
26131,Bulgaria,1972.0,6,10,6,22
26132,Bulgaria,1988.0,10,14,17,41
26133,Bulgaria,1996.0,3,12,6,21
26134,Bulgaria,1976.0,8,13,18,39
26135,Bulgaria,1956.0,1,3,14,18
26136,Bulgaria,1972.0,6,10,6,22
26137,Bulgaria,1972.0,6,10,6,22
26138,Bulgaria,1972.0,6,10,6,22
26139,Bulgaria,1980.0,8,44,39,91
26140,Bulgaria,1988.0,10,14,17,41
26141,Bulgaria,1992.0,3,7,7,17
26142,Bulgaria,1980.0,8,44,39,91
26143,Bulgaria,1980.0,8,44,39,91
26144,Bulgaria,1980.0,8,44,39,91
26145,Bulgaria,1988.0,10,14,17,41
26146,Bulgaria,2016.0,0,1,6,7
26147,Bulgaria,1976.0,8,13,18,39
26148,Bulgaria,1980.0,8,44,39,91
26149,Bulgaria,1988.0,10,14,17,41
26150,Bulgaria,1980.0,8,44,39,91
26151,Bulgaria,1980.0,8,44,39,91
26152,Bulgaria,1956.0,1,3,14,18
26153,Bulgaria,1988.0,10,14,17,41
26154,Bulgaria,1992.0,3,7,7,17
26155,Bulgaria,1988.0,10,14,17,41
26156,Bulgaria,2000.0,5,6,2,13
26157,Bulgaria,2004.0,2,1,14,17
26158,Bulgaria,2000.0,5,6,2,13
26159,Bulgaria,1972.0,6,10,6,22
26160,Bulgaria,1988.0,10,14,17,41
26161,Bulgaria,1992.0,3,7,7,17
26162,Bulgaria,1956.0,1,3,14,18
26163,Bulgaria,2000.0,5,6,2,13
26164,Bulgaria,2000.0,5,6,2,13
26165,Bulgaria,1976.0,8,13,18,39
26166,Bulgaria,1980.0,8,44,39,91
26167,Bulgaria,1968.0,2,21,3,26
26168,Bulgaria,1968.0,2,21,3,26
26169,Bulgaria,1980.0,8,44,39,91
26170,Bulgaria,1976.0,8,13,18,39
26171,Bulgaria,1980.0,8,44,39,91
26172,Bulgaria,1956.0,1,3,14,18
26173,Bulgaria,1980.0,8,44,39,91
26174,Bulgaria,1996.0,3,12,6,21
26175,Bulgaria,1996.0,3,12,6,21
26176,Bulgaria,1976.0,8,13,18,39
26177,Bulgaria,1980.0,8,44,39,91
26178,Bulgaria,1976.0,8,13,18,39
26179,Bulgaria,1980.0,8,44,39,91
26180,Bulgaria,1980.0,8,44,39,91
26181,Bulgaria,1988.0,10,14,17,41
26182,Bulgaria,1964.0,3,5,2,10
26183,Bulgaria,1980.0,8,44,39,91
26184,Bulgaria,1956.0,1,3,14,18
26185,Bulgaria,2016.0,0,1,6,7
26186,Bulgaria,2000.0,5,6,2,13
26187,Bulgaria,2004.0,2,1,14,17
26188,Bulgaria,1980.0,8,44,39,91
26189,Bulgaria,1964.0,3,5,2,10
26190,Bulgaria,1972.0,6,10,6,22
26191,Bulgaria,1952.0,0,0,1,1
26192,Bulgaria,1980.0,8,44,39,91
26193,Bulgaria,1972.0,6,10,6,22
26194,Bulgaria,1976.0,8,13,18,39
26195,Bulgaria,1968.0,2,21,3,26
26196,Bulgaria,2002.0,0,1,2,3
26197,Bulgaria,1988.0,10,14,17,41
26198,Bulgaria,1972.0,6,10,6,22
26199,Bulgaria,1976.0,8,13,18,39
26200,Bulgaria,1976.0,8,13,18,39
26201,Bulgaria,1988.0,10,14,17,41
26202,Bulgaria,1988.0,10,14,17,41
26203,Bulgaria,1956.0,1,3,14,18
26204,Bulgaria,1980.0,8,44,39,91
26205,Bulgaria,1980.0,8,44,39,91
26206,Bulgaria,1992.0,3,7,7,17
26207,Bulgaria,1996.0,3,12,6,21
26208,Bulgaria,1964.0,3,5,2,10
26209,Bulgaria,1980.0,8,44,39,91
26210,Bulgaria,1960.0,1,3,3,7
26211,Bulgaria,1980.0,8,44,39,91
26212,Bulgaria,1980.0,8,44,39,91
26213,Bulgaria,1988.0,10,14,17,41
26214,Bulgaria,1980.0,8,44,39,91
26215,Bulgaria,2012.0,0,1,1,2
26216,Bulgaria,2002.0,0,1,2,3
26217,Bulgaria,2002.0,0,1,2,3
26218,Bulgaria,2006.0,0,1,0,1
26219,Bulgaria,1964.0,3,5,2,10
26220,Bulgaria,1968.0,2,21,3,26
26221,Bulgaria,1980.0,8,44,39,91
26222,Bulgaria,1956.0,1,3,14,18
26223,Bulgaria,2004.0,2,1,14,17
26224,Bulgaria,1980.0,8,44,39,91
26225,Bulgaria,1980.0,8,44,39,91
26226,Bulgaria,1980.0,8,44,39,91
26227,Bulgaria,1980.0,8,44,39,91
26228,Bulgaria,1992.0,3,7,7,17
26229,Bulgaria,1980.0,8,44,39,91
26230,Bulgaria,1976.0,8,13,18,39
26231,Bulgaria,1980.0,8,44,39,91
26232,Bulgaria,1972.0,6,10,6,22
26233,Bulgaria,1976.0,8,13,18,39
26234,Bulgaria,1976.0,8,13,18,39
26235,Bulgaria,1988.0,10,14,17,41
26236,Bulgaria,1976.0,8,13,18,39
26237,Bulgaria,1980.0,8,44,39,91
26238,Bulgaria,1956.0,1,3,14,18
26239,Bulgaria,1976.0,8,13,18,39
26240,Bulgaria,1980.0,8,44,39,91
26241,Bulgaria,1988.0,10,14,17,41
26242,Bulgaria,1956.0,1,3,14,18
26243,Bulgaria,1968.0,2,21,3,26
26244,Bulgaria,1972.0,6,10,6,22
26245,Bulgaria,1992.0,3,7,7,17
26246,Bulgaria,1956.0,1,3,14,18
26247,Bulgaria,1980.0,8,44,39,91
26248,Bulgaria,1976.0,8,13,18,39
26249,Bulgaria,1976.0,8,13,18,39
26250,Bulgaria,1980.0,8,44,39,91
26251,Bulgaria,1988.0,10,14,17,41
26252,Bulgaria,1976.0,8,13,18,39
26253,Bulgaria,1996.0,3,12,6,21
26254,Bulgaria,1996.0,3,12,6,21
26255,Bulgaria,2004.0,2,1,14,17
26256,Bulgaria,2004.0,2,1,14,17
26257,Bulgaria,2008.0,1,1,3,5
26258,Bulgaria,1968.0,2,21,3,26
26259,Bulgaria,1976.0,8,13,18,39
26260,Bulgaria,1980.0,8,44,39,91
26261,Bulgaria,1996.0,3,12,6,21
26262,Bulgaria,2016.0,0,1,6,7
26263,Bulgaria,1980.0,8,44,39,91
26264,Bulgaria,1972.0,6,10,6,22
26265,Bulgaria,1976.0,8,13,18,39
26266,Bulgaria,1980.0,8,44,39,91
26267,Bulgaria,1996.0,3,12,6,21
26268,Bulgaria,1988.0,10,14,17,41
26269,Bulgaria,2000.0,5,6,2,13
26270,Bulgaria,1980.0,8,44,39,91
26271,Bulgaria,1988.0,10,14,17,41
26272,Bulgaria,1988.0,10,14,17,41
26273,Bulgaria,1980.0,8,44,39,91
26274,Bulgaria,1960.0,1,3,3,7
26275,Bulgaria,1964.0,3,5,2,10
26276,Bulgaria,1968.0,2,21,3,26
26277,Bulgaria,1988.0,10,14,17,41
26278,Bulgaria,1988.0,10,14,17,41
26279,Bulgaria,1976.0,8,13,18,39
26280,Bulgaria,1968.0,2,21,3,26
26281,Bulgaria,1996.0,3,12,6,21
26282,Bulgaria,1964.0,3,5,2,10
26283,Bulgaria,2008.0,1,1,3,5
26284,Bulgaria,1980.0,8,44,39,91
26285,Bulgaria,1976.0,8,13,18,39
26286,Bulgaria,1980.0,8,44,39,91
26287,Bulgaria,2004.0,2,1,14,17
26288,Bulgaria,2008.0,1,1,3,5
26289,Bulgaria,1968.0,2,21,3,26
26290,Bulgaria,1956.0,1,3,14,18
26291,Bulgaria,1980.0,8,44,39,91
26292,Bulgaria,2016.0,0,1,6,7
26293,Bulgaria,1968.0,2,21,3,26
26294,Bulgaria,1992.0,3,7,7,17
26295,Bulgaria,1996.0,3,12,6,21
26296,Bulgaria,1976.0,8,13,18,39
26297,Bulgaria,1976.0,8,13,18,39
26298,Bulgaria,1976.0,8,13,18,39
26299,Bulgaria,1996.0,3,12,6,21
26300,Bulgaria,1972.0,6,10,6,22
26301,Bulgaria,1956.0,1,3,14,18
26302,Bulgaria,1992.0,3,7,7,17
26303,Bulgaria,1996.0,3,12,6,21
26304,Bulgaria,2000.0,5,6,2,13
26305,Bulgaria,2000.0,5,6,2,13
26306,Bulgaria,2004.0,2,1,14,17
26307,Bulgaria,2004.0,2,1,14,17
26308,Bulgaria,1968.0,2,21,3,26
26309,Bulgaria,1960.0,1,3,3,7
26310,Bulgaria,1980.0,8,44,39,91
26311,Bulgaria,1980.0,8,44,39,91
26312,Bulgaria,1968.0,2,21,3,26
26313,Bulgaria,1980.0,8,44,39,91
26314,Bulgaria,1980.0,8,44,39,91
26315,Bulgaria,2008.0,1,1,3,5
26316,Bulgaria,2012.0,0,1,1,2
26317,Egypt,2012.0,0,2,0,2
26318,Egypt,2004.0,1,1,3,5
26319,Egypt,2004.0,1,1,3,5
26320,Egypt,1936.0,2,1,2,5
26321,Egypt,1948.0,2,2,1,5
26322,Egypt,2004.0,1,1,3,5
26323,Egypt,2012.0,0,2,0,2
26324,Egypt,1948.0,2,2,1,5
26325,Egypt,1936.0,2,1,2,5
26326,Egypt,2016.0,0,0,3,3
26327,Egypt,2004.0,1,1,3,5
26328,Egypt,2016.0,0,0,3,3
26329,Egypt,2008.0,0,0,1,1
26330,Egypt,1948.0,2,2,1,5
26331,Egypt,1936.0,2,1,2,5
26332,Egypt,1928.0,2,1,1,4
26333,Egypt,1928.0,2,1,1,4
26334,Egypt,1948.0,2,2,1,5
26335,Egypt,1952.0,0,0,1,1
26336,Egypt,1984.0,0,1,0,1
26337,Egypt,2004.0,1,1,3,5
26338,Egypt,2016.0,0,0,3,3
26339,Egypt,1936.0,2,1,2,5
26340,Egypt,1948.0,2,2,1,5
26341,Egypt,1928.0,2,1,1,4
26342,Egypt,1928.0,2,1,1,4
26343,Egypt,1936.0,2,1,2,5
26344,Great Britain,1980.0,6,18,24,48
26345,Great Britain,1924.0,31,34,30,95
26346,Great Britain,1924.0,31,34,30,95
26347,Great Britain,1980.0,6,18,24,48
26348,Great Britain,1984.0,11,20,42,73
26349,Great Britain,2012.0,48,30,48,126
26350,Great Britain,2016.0,64,55,26,145
26351,Great Britain,2014.0,1,4,5,10
26352,Great Britain,1948.0,7,42,14,63
26353,Great Britain,2008.0,31,25,25,81
26354,Great Britain,2008.0,31,25,25,81
26355,Great Britain,2012.0,48,30,48,126
26356,Great Britain,2012.0,48,30,48,126
26357,Great Britain,1908.0,147,131,90,368
26358,Great Britain,1996.0,2,15,9,26
26359,Great Britain,2000.0,22,20,12,54
26360,Great Britain,2004.0,17,25,15,57
26361,Great Britain,2008.0,31,25,25,81
26362,Great Britain,2012.0,48,30,48,126
26363,Great Britain,1920.0,52,42,17,111
26364,Great Britain,1968.0,9,5,5,19
26365,Great Britain-1,1912.0,47,64,59,170
26366,Great Britain,1984.0,11,20,42,73
26367,Great Britain,1992.0,8,3,39,50
26368,Great Britain,1992.0,8,3,39,50
26369,Great Britain,1920.0,52,42,17,111
26370,Great Britain,1920.0,52,42,17,111
26371,Great Britain,1924.0,31,34,30,95
26372,Great Britain,1908.0,147,131,90,368
26373,Great Britain,1960.0,2,11,15,28
26374,Great Britain,1984.0,11,20,42,73
26375,Great Britain,1984.0,11,20,42,73
26376,Great Britain,1988.0,22,17,15,54
26377,Great Britain,2000.0,22,20,12,54
26378,Great Britain,1968.0,9,5,5,19
26379,Great Britain,1968.0,9,5,5,19
26380,Ireland-2,1908.0,147,131,90,368
26381,Great Britain,1948.0,7,42,14,63
26382,Great Britain,1952.0,4,2,26,32
26383,Great Britain,1908.0,147,131,90,368
26384,Great Britain,1908.0,147,131,90,368
26385,Great Britain,1908.0,147,131,90,368
26386,Great Britain,1968.0,9,5,5,19
26387,Union des Socits Franais de Sports Athletiques,1900.0,59,34,15,108
26388,Great Britain,1924.0,31,34,30,95
26389,Great Britain,2014.0,1,4,5,10
26390,Great Britain,1920.0,52,42,17,111
26391,Great Britain,2016.0,64,55,26,145
26392,Great Britain,1912.0,47,64,59,170
26393,Great Britain,1912.0,47,64,59,170
26394,Great Britain,1948.0,7,42,14,63
26395,Great Britain,1936.0,24,17,12,53
26396,Great Britain-2,2000.0,22,20,12,54
26397,Great Britain,2016.0,64,55,26,145
26398,Great Britain,1964.0,6,19,5,30
26399,Great Britain,1952.0,4,2,26,32
26400,Great Britain,1956.0,8,16,22,46
26401,Great Britain,2012.0,48,30,48,126
26402,Great Britain,1920.0,52,42,17,111
26403,Great Britain-1,1924.0,31,34,30,95
26404,Great Britain,1900.0,59,34,15,108
26405,Great Britain,2016.0,64,55,26,145
26406,Hera-1,1908.0,147,131,90,368
26407,Great Britain,1984.0,11,20,42,73
26408,Great Britain,1908.0,147,131,90,368
26409,Great Britain-1,1908.0,147,131,90,368
26410,Great Britain,1920.0,52,42,17,111
26411,Great Britain,1992.0,8,3,39,50
26412,Great Britain,2000.0,22,20,12,54
26413,Great Britain,1998.0,0,0,4,4
26414,Great Britain,2004.0,17,25,15,57
26415,Great Britain,2008.0,31,25,25,81
26416,Great Britain,1992.0,8,3,39,50
26417,Great Britain,1996.0,2,15,9,26
26418,Great Britain,2000.0,22,20,12,54
26419,Bluebottle,1956.0,8,16,22,46
26420,Great Britain,1908.0,147,131,90,368
26421,Great Britain,1928.0,7,27,25,59
26422,Great Britain,1932.0,9,12,14,35
26423,Great Britain,1908.0,147,131,90,368
26424,Great Britain,1952.0,4,2,26,32
26425,Great Britain-1,2012.0,48,30,48,126
26426,Great Britain,1976.0,7,15,11,33
26427,England-1,1908.0,147,131,90,368
26428,Great Britain,1920.0,52,42,17,111
26429,Great Britain,2012.0,48,30,48,126
26430,Great Britain,1976.0,7,15,11,33
26431,Great Britain,1948.0,7,42,14,63
26432,Great Britain,1984.0,11,20,42,73
26433,Great Britain,1988.0,22,17,15,54
26434,Great Britain,2016.0,64,55,26,145
26435,Great Britain,1924.0,31,34,30,95
26436,Leander Club-2,1908.0,147,131,90,368
26437,Great Britain,2000.0,22,20,12,54
26438,Great Britain,1908.0,147,131,90,368
26439,Great Britain,1936.0,24,17,12,53
26440,Great Britain,1920.0,52,42,17,111
26441,Great Britain,1924.0,31,34,30,95
26442,London City Police-1,1908.0,147,131,90,368
26443,Great Britain,1908.0,147,131,90,368
26444,Great Britain-1,1908.0,147,131,90,368
26445,Great Britain-1,1912.0,47,64,59,170
26446,Great Britain,1964.0,6,19,5,30
26447,Great Britain,1908.0,147,131,90,368
26448,Great Britain,2012.0,48,30,48,126
26449,Great Britain,2012.0,48,30,48,126
26450,Great Britain,1948.0,7,42,14,63
26451,Great Britain,1984.0,11,20,42,73
26452,Great Britain,1988.0,22,17,15,54
26453,Great Britain,1896.0,3,3,3,9
26454,Great Britain,2000.0,22,20,12,54
26455,Great Britain,2000.0,22,20,12,54
26456,Great Britain,1908.0,147,131,90,368
26457,Great Britain,1912.0,47,64,59,170
26458,Great Britain,1996.0,2,15,9,26
26459,Mouchette-2,1908.0,147,131,90,368
26460,Moseley Wanderers,1900.0,59,34,15,108
26461,Great Britain,1992.0,8,3,39,50
26462,Devon and Somerset Wanderers,1900.0,59,34,15,108
26463,Great Britain-2,1912.0,47,64,59,170
26464,Great Britain,1920.0,52,42,17,111
26465,Great Britain,1980.0,6,18,24,48
26466,Great Britain,2008.0,31,25,25,81
26467,Great Britain,2012.0,48,30,48,126
26468,Great Britain,2012.0,48,30,48,126
26469,Great Britain,2012.0,48,30,48,126
26470,Great Britain,1908.0,147,131,90,368
26471,Great Britain,1928.0,7,27,25,59
26472,Lalage,1936.0,24,17,12,53
26473,Great Britain,1900.0,59,34,15,108
26474,Great Britain,1900.0,59,34,15,108
26475,Amateur Athletic Association,1900.0,59,34,15,108
26476,Great Britain,1920.0,52,42,17,111
26477,Great Britain,2016.0,64,55,26,145
26478,Great Britain,2016.0,64,55,26,145
26479,Great Britain,1972.0,8,9,12,29
26480,Great Britain,1976.0,7,15,11,33
26481,Great Britain,2016.0,64,55,26,145
26482,Great Britain,1984.0,11,20,42,73
26483,Great Britain,1912.0,47,64,59,170
26484,Great Britain,1920.0,52,42,17,111
26485,Great Britain,1924.0,31,34,30,95
26486,Great Britain,1928.0,7,27,25,59
26487,Great Britain,1932.0,9,12,14,35
26488,Great Britain,1936.0,24,17,12,53
26489,Foxhunters Hurlingham,1900.0,59,34,15,108
26490,Thames Rowing Club,1912.0,47,64,59,170
26491,Great Britain,1920.0,52,42,17,111
26492,Great Britain,1908.0,147,131,90,368
26493,Great Britain,1912.0,47,64,59,170
26494,Great Britain,1912.0,47,64,59,170
26495,Great Britain,1928.0,7,27,25,59
26496,Great Britain,1984.0,11,20,42,73
26497,Great Britain,1988.0,22,17,15,54
26498,Great Britain,2016.0,64,55,26,145
26499,Great Britain,1964.0,6,19,5,30
26500,Great Britain,1964.0,6,19,5,30
26501,Great Britain,1964.0,6,19,5,30
26502,Great Britain,2016.0,64,55,26,145
26503,Great Britain,1924.0,31,34,30,95
26504,Great Britain,2008.0,31,25,25,81
26505,Heroine,1908.0,147,131,90,368
26506,Great Britain,1948.0,7,42,14,63
26507,Devon and Somerset Wanderers,1900.0,59,34,15,108
26508,Moseley Wanderers,1900.0,59,34,15,108
26509,Great Britain,2004.0,17,25,15,57
26510,Great Britain,2012.0,48,30,48,126
26511,Great Britain,1992.0,8,3,39,50
26512,Great Britain,1996.0,2,15,9,26
26513,Great Britain,1996.0,2,15,9,26
26514,Chuckles,1956.0,8,16,22,46
26515,Great Britain,1908.0,147,131,90,368
26516,Great Britain,1920.0,52,42,17,111
26517,Great Britain,1908.0,147,131,90,368
26518,Great Britain,1968.0,9,5,5,19
26519,Great Britain,1992.0,8,3,39,50
26520,Great Britain,1996.0,2,15,9,26
26521,Lalage,1936.0,24,17,12,53
26522,Great Britain,1896.0,3,3,3,9
26523,Great Britain/Germany,1896.0,3,3,3,9
26524,Swift,1948.0,7,42,14,63
26525,Great Britain,1908.0,147,131,90,368
26526,Great Britain,1936.0,24,17,12,53
26527,Great Britain,1948.0,7,42,14,63
26528,Great Britain,1906.0,9,22,8,39
26529,"New College, Oxford-2",1912.0,47,64,59,170
26530,Devon and Somerset Wanderers,1900.0,59,34,15,108
26531,Vision,1956.0,8,16,22,46
26532,Cambridge University Boat Club-2,1908.0,147,131,90,368
26533,Great Britain,2000.0,22,20,12,54
26534,Great Britain,2008.0,31,25,25,81
26535,Great Britain,2008.0,31,25,25,81
26536,Union des Socits Franais de Sports Athletiques,1900.0,59,34,15,108
26537,Great Britain,1968.0,9,5,5,19
26538,Great Britain,2000.0,22,20,12,54
26539,Great Britain,2004.0,17,25,15,57
26540,Great Britain,2012.0,48,30,48,126
26541,Great Britain,1956.0,8,16,22,46
26542,Great Britain,2016.0,64,55,26,145
26543,Great Britain,1912.0,47,64,59,170
26544,Great Britain,1936.0,24,17,12,53
26545,Great Britain,1964.0,6,19,5,30
26546,Great Britain,1976.0,7,15,11,33
26547,Great Britain,1936.0,24,17,12,53
26548,Great Britain,1956.0,8,16,22,46
26549,Great Britain,1996.0,2,15,9,26
26550,Great Britain,1928.0,7,27,25,59
26551,Great Britain,1948.0,7,42,14,63
26552,Great Britain,1976.0,7,15,11,33
26553,Great Britain,1988.0,22,17,15,54
26554,Great Britain,1908.0,147,131,90,368
26555,Great Britain,1908.0,147,131,90,368
26556,Great Britain,1960.0,2,11,15,28
26557,Great Britain,1968.0,9,5,5,19
26558,Great Britain-1,1924.0,31,34,30,95
26559,Great Britain,1908.0,147,131,90,368
26560,Great Britain,1936.0,24,17,12,53
26561,Great Britain,1936.0,24,17,12,53
26562,Great Britain,1936.0,24,17,12,53
26563,Ireland-2,1908.0,147,131,90,368
26564,Great Britain,1992.0,8,3,39,50
26565,Great Britain,1984.0,11,20,42,73
26566,Great Britain,1984.0,11,20,42,73
26567,Great Britain-2,1908.0,147,131,90,368
26568,Union des Socits Franais de Sports Athletiques,1900.0,59,34,15,108
26569,Great Britain,2012.0,48,30,48,126
26570,Great Britain,2016.0,64,55,26,145
26571,Great Britain,2012.0,48,30,48,126
26572,Great Britain,2016.0,64,55,26,145
26573,Great Britain,1924.0,31,34,30,95
26574,Great Britain,1924.0,31,34,30,95
26575,Great Britain,2012.0,48,30,48,126
26576,Great Britain,2016.0,64,55,26,145
26577,Hera-1,1908.0,147,131,90,368
26578,Upton Park FC,1900.0,59,34,15,108
26579,Great Britain,1908.0,147,131,90,368
26580,Devon and Somerset Wanderers,1900.0,59,34,15,108
26581,"BLO Polo Club, Rugby",1900.0,59,34,15,108
26582,Hurlingham-2,1908.0,147,131,90,368
26583,Leander Club-1,1908.0,147,131,90,368
26584,Great Britain,1984.0,11,20,42,73
26585,Great Britain,1912.0,47,64,59,170
26586,Great Britain,1920.0,52,42,17,111
26587,Great Britain,1968.0,9,5,5,19
26588,Great Britain,1988.0,22,17,15,54
26589,Hera-1,1908.0,147,131,90,368
26590,Devon and Somerset Wanderers,1900.0,59,34,15,108
26591,"New College, Oxford-2",1912.0,47,64,59,170
26592,Libellule de Paris,1900.0,59,34,15,108
26593,Great Britain,1952.0,4,2,26,32
26594,Great Britain,1956.0,8,16,22,46
26595,Leander Club-1,1912.0,47,64,59,170
26596,Great Britain,2016.0,64,55,26,145
26597,Great Britain,1928.0,7,27,25,59
26598,Great Britain,1932.0,9,12,14,35
26599,Great Britain,1936.0,24,17,12,53
26600,Great Britain,2008.0,31,25,25,81
26601,Great Britain,2012.0,48,30,48,126
26602,Great Britain,2016.0,64,55,26,145
26603,Cambridge University Boat Club-2,1908.0,147,131,90,368
26604,Great Britain,1912.0,47,64,59,170
26605,Leander Club-1,1908.0,147,131,90,368
26606,Great Britain,1948.0,7,42,14,63
26607,Great Britain,1912.0,47,64,59,170
26608,Upton Park FC,1900.0,59,34,15,108
26609,Scotland-3,1908.0,147,131,90,368
26610,Great Britain,1912.0,47,64,59,170
26611,Scotland-3,1908.0,147,131,90,368
26612,Great Britain-2,1908.0,147,131,90,368
26613,Great Britain,1948.0,7,42,14,63
26614,Great Britain,1920.0,52,42,17,111
26615,Great Britain,1920.0,52,42,17,111
26616,Great Britain,1924.0,31,34,30,95
26617,Great Britain,1924.0,31,34,30,95
26618,Liverpool Police Team-2,1908.0,147,131,90,368
26619,Great Britain-2,1908.0,147,131,90,368
26620,Great Britain,1912.0,47,64,59,170
26621,Great Britain,1988.0,22,17,15,54
26622,Brynhild-2,1900.0,59,34,15,108
26623,Great Britain,2012.0,48,30,48,126
26624,Cobweb-1,1908.0,147,131,90,368
26625,Great Britain,1920.0,52,42,17,111
26626,Great Britain,2000.0,22,20,12,54
26627,Great Britain,2004.0,17,25,15,57
26628,Great Britain,1920.0,52,42,17,111
26629,Great Britain,2012.0,48,30,48,126
26630,Ireland-2,1908.0,147,131,90,368
26631,Great Britain,1920.0,52,42,17,111
26632,Moseley Wanderers,1900.0,59,34,15,108
26633,Great Britain,1936.0,24,17,12,53
26634,Great Britain,1908.0,147,131,90,368
26635,Great Britain-2,1908.0,147,131,90,368
26636,Great Britain,2016.0,64,55,26,145
26637,Great Britain,2016.0,64,55,26,145
26638,Great Britain,1980.0,6,18,24,48
26639,Great Britain,2016.0,64,55,26,145
26640,Great Britain,1908.0,147,131,90,368
26641,Great Britain,1952.0,4,2,26,32
26642,Great Britain,1948.0,7,42,14,63
26643,Thames Rowing Club,1912.0,47,64,59,170
26644,Great Britain,1924.0,31,34,30,95
26645,Great Britain,1924.0,31,34,30,95
26646,Great Britain,1924.0,31,34,30,95
26647,Great Britain,1924.0,31,34,30,95
26648,Cambridge University Boat Club-2,1908.0,147,131,90,368
26649,Great Britain,1920.0,52,42,17,111
26650,Great Britain,1984.0,11,20,42,73
26651,Great Britain,2016.0,64,55,26,145
26652,Great Britain,1952.0,4,2,26,32
26653,Great Britain-3,1908.0,147,131,90,368
26654,K Division Metropolitan Police Team-3,1908.0,147,131,90,368
26655,Great Britain,1912.0,47,64,59,170
26656,Upton Park FC,1900.0,59,34,15,108
26657,Great Britain,1928.0,7,27,25,59
26658,Great Britain,1932.0,9,12,14,35
26659,Great Britain,2012.0,48,30,48,126
26660,Great Britain,2012.0,48,30,48,126
26661,Great Britain,1932.0,9,12,14,35
26662,Great Britain,1908.0,147,131,90,368
26663,Great Britain,1936.0,24,17,12,53
26664,Great Britain,2012.0,48,30,48,126
26665,Smyrna,1906.0,9,22,8,39
26666,Great Britain,1952.0,4,2,26,32
26667,Great Britain,2016.0,64,55,26,145
26668,Devon and Somerset Wanderers,1900.0,59,34,15,108
26669,Great Britain,1988.0,22,17,15,54
26670,Great Britain,1988.0,22,17,15,54
26671,Great Britain,1992.0,8,3,39,50
26672,Great Britain,2008.0,31,25,25,81
26673,Great Britain,2012.0,48,30,48,126
26674,Great Britain,2012.0,48,30,48,126
26675,Great Britain,2016.0,64,55,26,145
26676,Great Britain,1984.0,11,20,42,73
26677,Great Britain,1924.0,31,34,30,95
26678,Great Britain,1976.0,7,15,11,33
26679,Great Britain,2012.0,48,30,48,126
26680,Great Britain,2016.0,64,55,26,145
26681,Great Britain,1924.0,31,34,30,95
26682,Liverpool Police Team-2,1908.0,147,131,90,368
26683,Great Britain,2016.0,64,55,26,145
26684,Great Britain,1924.0,31,34,30,95
26685,Great Britain,1980.0,6,18,24,48
26686,Great Britain,2000.0,22,20,12,54
26687,Great Britain,1948.0,7,42,14,63
26688,Great Britain,1988.0,22,17,15,54
26689,Great Britain,1932.0,9,12,14,35
26690,Great Britain,1968.0,9,5,5,19
26691,Great Britain,1908.0,147,131,90,368
26692,Great Britain,1984.0,11,20,42,73
26693,Great Britain,1984.0,11,20,42,73
26694,Cobweb-1,1908.0,147,131,90,368
26695,Great Britain,1952.0,4,2,26,32
26696,Great Britain,1980.0,6,18,24,48
26697,Great Britain,1980.0,6,18,24,48
26698,Great Britain,1984.0,11,20,42,73
26699,Great Britain,1984.0,11,20,42,73
26700,"Osborne Swimming Club, Manchester",1900.0,59,34,15,108
26701,Ancora,1920.0,52,42,17,111
26702,Great Britain,1908.0,147,131,90,368
26703,Great Britain,1936.0,24,17,12,53
26704,Great Britain,1928.0,7,27,25,59
26705,Great Britain-1,1924.0,31,34,30,95
26706,Great Britain,1908.0,147,131,90,368
26707,Wales-4,1908.0,147,131,90,368
26708,Great Britain,1984.0,11,20,42,73
26709,Great Britain,1952.0,4,2,26,32
26710,Great Britain,2016.0,64,55,26,145
26711,Great Britain,2004.0,17,25,15,57
26712,Great Britain,1984.0,11,20,42,73
26713,Great Britain,2000.0,22,20,12,54
26714,Great Britain,1920.0,52,42,17,111
26715,Great Britain,2008.0,31,25,25,81
26716,Great Britain,2008.0,31,25,25,81
26717,Great Britain,2012.0,48,30,48,126
26718,Great Britain,1920.0,52,42,17,111
26719,Great Britain,2008.0,31,25,25,81
26720,Great Britain,2002.0,5,0,1,6
26721,Great Britain,1900.0,59,34,15,108
26722,Great Britain,1900.0,59,34,15,108
26723,Great Britain,1964.0,6,19,5,30
26724,Great Britain,1964.0,6,19,5,30
26725,Great Britain,1928.0,7,27,25,59
26726,Great Britain,1928.0,7,27,25,59
26727,Great Britain,1928.0,7,27,25,59
26728,Great Britain,1932.0,9,12,14,35
26729,Great Britain,1984.0,11,20,42,73
26730,Great Britain,1988.0,22,17,15,54
26731,Great Britain,2012.0,48,30,48,126
26732,Great Britain,1948.0,7,42,14,63
26733,Great Britain,1908.0,147,131,90,368
26734,Devon and Somerset Wanderers,1900.0,59,34,15,108
26735,Great Britain,1932.0,9,12,14,35
26736,Great Britain,1908.0,147,131,90,368
26737,Great Britain,1912.0,47,64,59,170
26738,Great Britain,1912.0,47,64,59,170
26739,Great Britain,1912.0,47,64,59,170
26740,Great Britain,1912.0,47,64,59,170
26741,Great Britain,1980.0,6,18,24,48
26742,Smyrna,1906.0,9,22,8,39
26743,Great Britain,2000.0,22,20,12,54
26744,Great Britain-2,1924.0,31,34,30,95
26745,Great Britain,1936.0,24,17,12,53
26746,Great Britain,1976.0,7,15,11,33
26747,Great Britain,1912.0,47,64,59,170
26748,Great Britain,2000.0,22,20,12,54
26749,Great Britain,2004.0,17,25,15,57
26750,Great Britain,1984.0,11,20,42,73
26751,Great Britain,1948.0,7,42,14,63
26752,Great Britain,1924.0,31,34,30,95
26753,"Osborne Swimming Club, Manchester",1900.0,59,34,15,108
26754,Great Britain-2,1908.0,147,131,90,368
26755,Great Britain,1948.0,7,42,14,63
26756,Dormy-1,1908.0,147,131,90,368
26757,Great Britain,1920.0,52,42,17,111
26758,Great Britain,1980.0,6,18,24,48
26759,Great Britain,1984.0,11,20,42,73
26760,Great Britain,1976.0,7,15,11,33
26761,Great Britain,1976.0,7,15,11,33
26762,Great Britain,1980.0,6,18,24,48
26763,Great Britain,1984.0,11,20,42,73
26764,Great Britain,2016.0,64,55,26,145
26765,Great Britain,1912.0,47,64,59,170
26766,Great Britain,1906.0,9,22,8,39
26767,Great Britain,1906.0,9,22,8,39
26768,Great Britain,1992.0,8,3,39,50
26769,Magdalen College Boat Club-1,1908.0,147,131,90,368
26770,Great Britain,2012.0,48,30,48,126
26771,Great Britain,2016.0,64,55,26,145
26772,Devon and Somerset Wanderers,1900.0,59,34,15,108
26773,Great Britain,1908.0,147,131,90,368
26774,Great Britain,2004.0,17,25,15,57
26775,Great Britain,1920.0,52,42,17,111
26776,Great Britain,1952.0,4,2,26,32
26777,Scotia,1900.0,59,34,15,108
26778,Scotia,1900.0,59,34,15,108
26779,Great Britain,1976.0,7,15,11,33
26780,Great Britain,1924.0,31,34,30,95
26781,Great Britain,1920.0,52,42,17,111
26782,Great Britain,1912.0,47,64,59,170
26783,Great Britain,1952.0,4,2,26,32
26784,Great Britain,1984.0,11,20,42,73
26785,Great Britain,1936.0,24,17,12,53
26786,Great Britain,2012.0,48,30,48,126
26787,Great Britain,2016.0,64,55,26,145
26788,Foxhunters Hurlingham,1900.0,59,34,15,108
26789,Great Britain,1904.0,1,1,0,2
26790,Great Britain,1908.0,147,131,90,368
26791,Great Britain,2012.0,48,30,48,126
26792,Great Britain,2016.0,64,55,26,145
26793,Great Britain,2008.0,31,25,25,81
26794,Moseley Wanderers,1900.0,59,34,15,108
26795,England-1,1912.0,47,64,59,170
26796,Great Britain,1936.0,24,17,12,53
26797,Cornwall,1908.0,147,131,90,368
26798,Mouchette-2,1908.0,147,131,90,368
26799,Great Britain,1972.0,8,9,12,29
26800,Great Britain,2004.0,17,25,15,57
26801,Great Britain,2008.0,31,25,25,81
26802,Great Britain,2016.0,64,55,26,145
26803,Great Britain,1964.0,6,19,5,30
26804,Great Britain,1948.0,7,42,14,63
26805,Great Britain,1980.0,6,18,24,48
26806,Great Britain,1932.0,9,12,14,35
26807,Great Britain,1932.0,9,12,14,35
26808,Great Britain,1924.0,31,34,30,95
26809,Great Britain,1912.0,47,64,59,170
26810,Great Britain,1936.0,24,17,12,53
26811,Great Britain,1952.0,4,2,26,32
26812,Great Britain,1908.0,147,131,90,368
26813,Great Britain,1908.0,147,131,90,368
26814,Great Britain,2016.0,64,55,26,145
26815,Great Britain,1908.0,147,131,90,368
26816,Great Britain,1920.0,52,42,17,111
26817,Great Britain-1,1984.0,11,20,42,73
26818,Great Britain,1994.0,0,0,3,3
26819,Cornwall,1908.0,147,131,90,368
26820,Great Britain,1948.0,7,42,14,63
26821,Great Britain,2008.0,31,25,25,81
26822,Great Britain,2004.0,17,25,15,57
26823,Great Britain,2012.0,48,30,48,126
26824,Great Britain,2016.0,64,55,26,145
26825,Great Britain,2000.0,22,20,12,54
26826,Scotland-3,1908.0,147,131,90,368
26827,Great Britain,1908.0,147,131,90,368
26828,Great Britain,1906.0,9,22,8,39
26829,Great Britain,1908.0,147,131,90,368
26830,Great Britain,1906.0,9,22,8,39
26831,Great Britain,1952.0,4,2,26,32
26832,Great Britain,1928.0,7,27,25,59
26833,Great Britain,2004.0,17,25,15,57
26834,Moseley Wanderers,1900.0,59,34,15,108
26835,Great Britain,2016.0,64,55,26,145
26836,Great Britain,2008.0,31,25,25,81
26837,Great Britain,1912.0,47,64,59,170
26838,Vision,1956.0,8,16,22,46
26839,Great Britain,1912.0,47,64,59,170
26840,Great Britain,1952.0,4,2,26,32
26841,Great Britain-3,1908.0,147,131,90,368
26842,Great Britain-2,1912.0,47,64,59,170
26843,Great Britain,1912.0,47,64,59,170
26844,Great Britain-2,1912.0,47,64,59,170
26845,Heroine,1908.0,147,131,90,368
26846,Great Britain-1,1964.0,6,19,5,30
26847,Great Britain,1992.0,8,3,39,50
26848,Great Britain,1908.0,147,131,90,368
26849,Great Britain,1908.0,147,131,90,368
26850,Great Britain,1984.0,11,20,42,73
26851,Great Britain,1988.0,22,17,15,54
26852,Great Britain,1900.0,59,34,15,108
26853,United States/Great Britain,1900.0,59,34,15,108
26854,Great Britain-1,1900.0,59,34,15,108
26855,Great Britain,1900.0,59,34,15,108
26856,Great Britain,1900.0,59,34,15,108
26857,Great Britain-1,1900.0,59,34,15,108
26858,Great Britain-1,1908.0,147,131,90,368
26859,Devon and Somerset Wanderers,1900.0,59,34,15,108
26860,Great Britain,1908.0,147,131,90,368
26861,Great Britain,2000.0,22,20,12,54
26862,Great Britain,1992.0,8,3,39,50
26863,Great Britain,2016.0,64,55,26,145
26864,K Division Metropolitan Police Team-3,1908.0,147,131,90,368
26865,Great Britain,1912.0,47,64,59,170
26866,Hera-1,1908.0,147,131,90,368
26867,Hera-1,1908.0,147,131,90,368
26868,Great Britain,1976.0,7,15,11,33
26869,Great Britain,2004.0,17,25,15,57
26870,Great Britain,2014.0,1,4,5,10
26871,Great Britain,1912.0,47,64,59,170
26872,Great Britain,1906.0,9,22,8,39
26873,Great Britain,1936.0,24,17,12,53
26874,Great Britain,2012.0,48,30,48,126
26875,Great Britain,2012.0,48,30,48,126
26876,Great Britain,2016.0,64,55,26,145
26877,Great Britain,2016.0,64,55,26,145
26878,Hera-1,1908.0,147,131,90,368
26879,Great Britain,1976.0,7,15,11,33
26880,Great Britain,1912.0,47,64,59,170
26881,Great Britain,1912.0,47,64,59,170
26882,Great Britain,2016.0,64,55,26,145
26883,Great Britain,1984.0,11,20,42,73
26884,Great Britain,1908.0,147,131,90,368
26885,Great Britain,1952.0,4,2,26,32
26886,Great Britain,1920.0,52,42,17,111
26887,Great Britain-1,1908.0,147,131,90,368
26888,Great Britain,1984.0,11,20,42,73
26889,Great Britain,1908.0,147,131,90,368
26890,Great Britain,1908.0,147,131,90,368
26891,K Division Metropolitan Police Team-3,1908.0,147,131,90,368
26892,Great Britain,1984.0,11,20,42,73
26893,Great Britain,2016.0,64,55,26,145
26894,Great Britain,2008.0,31,25,25,81
26895,Great Britain,1920.0,52,42,17,111
26896,Great Britain,1920.0,52,42,17,111
26897,Great Britain,1932.0,9,12,14,35
26898,Great Britain,1932.0,9,12,14,35
26899,Great Britain,1996.0,2,15,9,26
26900,Great Britain,2000.0,22,20,12,54
26901,Great Britain,1956.0,8,16,22,46
26902,Great Britain,2008.0,31,25,25,81
26903,Great Britain,2012.0,48,30,48,126
26904,Great Britain,1924.0,31,34,30,95
26905,Great Britain,1908.0,147,131,90,368
26906,Great Britain,1908.0,147,131,90,368
26907,Great Britain,1896.0,3,3,3,9
26908,Great Britain,1896.0,3,3,3,9
26909,Great Britain,1924.0,31,34,30,95
26910,Great Britain,1988.0,22,17,15,54
26911,Great Britain,2016.0,64,55,26,145
26912,Great Britain,1984.0,11,20,42,73
26913,Great Britain-1,2004.0,17,25,15,57
26914,Great Britain,2012.0,48,30,48,126
26915,Great Britain,2016.0,64,55,26,145
26916,Great Britain,1936.0,24,17,12,53
26917,Leander Club-1,1908.0,147,131,90,368
26918,Great Britain,2012.0,48,30,48,126
26919,Wales-4,1908.0,147,131,90,368
26920,Great Britain,1972.0,8,9,12,29
26921,Great Britain,1908.0,147,131,90,368
26922,Great Britain,1932.0,9,12,14,35
26923,Great Britain,1912.0,47,64,59,170
26924,Olle,1900.0,59,34,15,108
26925,Olle,1900.0,59,34,15,108
26926,Leander Club #2-2,1908.0,147,131,90,368
26927,Great Britain,1992.0,8,3,39,50
26928,Great Britain,1936.0,24,17,12,53
26929,Great Britain,2012.0,48,30,48,126
26930,Great Britain,2012.0,48,30,48,126
26931,Great Britain,2016.0,64,55,26,145
26932,Great Britain,2016.0,64,55,26,145
26933,Great Britain,2000.0,22,20,12,54
26934,Great Britain,1988.0,22,17,15,54
26935,Great Britain,2008.0,31,25,25,81
26936,Leander Club #1-1,1908.0,147,131,90,368
26937,Leander Club-2,1908.0,147,131,90,368
26938,Great Britain,1960.0,2,11,15,28
26939,Great Britain,1932.0,9,12,14,35
26940,Gyrinus-1,1908.0,147,131,90,368
26941,Gyrinus-1,1908.0,147,131,90,368
26942,Leander Club-2,1908.0,147,131,90,368
26943,Great Britain,1932.0,9,12,14,35
26944,Great Britain,1936.0,24,17,12,53
26945,Great Britain,1968.0,9,5,5,19
26946,Great Britain,1960.0,2,11,15,28
26947,"New College, Oxford-2",1912.0,47,64,59,170
26948,Great Britain,1908.0,147,131,90,368
26949,Leander Club-1,1912.0,47,64,59,170
26950,Great Britain,1912.0,47,64,59,170
26951,Great Britain,1912.0,47,64,59,170
26952,Great Britain,1952.0,4,2,26,32
26953,Great Britain,1948.0,7,42,14,63
26954,Great Britain,2004.0,17,25,15,57
26955,Great Britain,2008.0,31,25,25,81
26956,Great Britain,2008.0,31,25,25,81
26957,Great Britain-2,2012.0,48,30,48,126
26958,Great Britain,2016.0,64,55,26,145
26959,Great Britain,2012.0,48,30,48,126
26960,Great Britain,1908.0,147,131,90,368
26961,Great Britain,1976.0,7,15,11,33
26962,Great Britain,1936.0,24,17,12,53
26963,Great Britain,1996.0,2,15,9,26
26964,Great Britain,2000.0,22,20,12,54
26965,Great Britain,1908.0,147,131,90,368
26966,Great Britain,1912.0,47,64,59,170
26967,Great Britain,1952.0,4,2,26,32
26968,Great Britain,1956.0,8,16,22,46
26969,Scotland-3,1908.0,147,131,90,368
26970,Great Britain,1936.0,24,17,12,53
26971,Emily,1924.0,31,34,30,95
26972,Great Britain,1976.0,7,15,11,33
26973,Great Britain,2004.0,17,25,15,57
26974,Great Britain,2008.0,31,25,25,81
26975,Great Britain,2012.0,48,30,48,126
26976,Great Britain,1912.0,47,64,59,170
26977,Great Britain,1920.0,52,42,17,111
26978,Scotland-3,1908.0,147,131,90,368
26979,Great Britain,1992.0,8,3,39,50
26980,Great Britain,1992.0,8,3,39,50
26981,"BLO Polo Club, Rugby",1900.0,59,34,15,108
26982,Hurlingham-2,1908.0,147,131,90,368
26983,England-1,1908.0,147,131,90,368
26984,Great Britain,1928.0,7,27,25,59
26985,Great Britain,1920.0,52,42,17,111
26986,Great Britain,2012.0,48,30,48,126
26987,Great Britain,2016.0,64,55,26,145
26988,Great Britain,1908.0,147,131,90,368
26989,Great Britain,1912.0,47,64,59,170
26990,Great Britain,2000.0,22,20,12,54
26991,Great Britain,2004.0,17,25,15,57
26992,Great Britain,2004.0,17,25,15,57
26993,Great Britain,1956.0,8,16,22,46
26994,Great Britain,1988.0,22,17,15,54
26995,Great Britain,2004.0,17,25,15,57
26996,Mouchette-2,1908.0,147,131,90,368
26997,Great Britain,1948.0,7,42,14,63
26998,Great Britain,1956.0,8,16,22,46
26999,Leander Club-1,1912.0,47,64,59,170
27000,England-1,1912.0,47,64,59,170
27001,Great Britain,1956.0,8,16,22,46
27002,Great Britain,1948.0,7,42,14,63
27003,Great Britain,1932.0,9,12,14,35
27004,England-1,1912.0,47,64,59,170
27005,Great Britain,2012.0,48,30,48,126
27006,Great Britain,1948.0,7,42,14,63
27007,Great Britain,1928.0,7,27,25,59
27008,"Bagatelle Polo Club, Paris",1900.0,59,34,15,108
27009,Magdalen College Boat Club-1,1908.0,147,131,90,368
27010,Leander Club-1,1912.0,47,64,59,170
27011,"New College, Oxford-2",1912.0,47,64,59,170
27012,Great Britain,1988.0,22,17,15,54
27013,Great Britain,1992.0,8,3,39,50
27014,Great Britain,1908.0,147,131,90,368
27015,Leander Club-1,1908.0,147,131,90,368
27016,Great Britain,2004.0,17,25,15,57
27017,Great Britain,2008.0,31,25,25,81
27018,Hera-1,1908.0,147,131,90,368
27019,Great Britain,1912.0,47,64,59,170
27020,Great Britain,2012.0,48,30,48,126
27021,Great Britain,2016.0,64,55,26,145
27022,Great Britain,1896.0,3,3,3,9
27023,Great Britain,1980.0,6,18,24,48
27024,Great Britain,1984.0,11,20,42,73
27025,Great Britain,1948.0,7,42,14,63
27026,Great Britain,1948.0,7,42,14,63
27027,Cambridge University Boat Club-2,1908.0,147,131,90,368
27028,Great Britain,1928.0,7,27,25,59
27029,Great Britain,1994.0,0,0,3,3
27030,Great Britain,2016.0,64,55,26,145
27031,London City Police-1,1908.0,147,131,90,368
27032,Great Britain,2014.0,1,4,5,10
27033,Great Britain,1980.0,6,18,24,48
27034,Great Britain,1980.0,6,18,24,48
27035,Great Britain,2008.0,31,25,25,81
27036,Great Britain,1924.0,31,34,30,95
27037,Great Britain,1952.0,4,2,26,32
27038,Great Britain,1972.0,8,9,12,29
27039,Great Britain,1908.0,147,131,90,368
27040,Great Britain-1,1908.0,147,131,90,368
27041,Upton Park FC,1900.0,59,34,15,108
27042,Great Britain,2016.0,64,55,26,145
27043,Great Britain,1896.0,3,3,3,9
27044,Great Britain,2012.0,48,30,48,126
27045,Great Britain,1908.0,147,131,90,368
27046,Great Britain,1964.0,6,19,5,30
27047,Ireland-2,1908.0,147,131,90,368
27048,Great Britain,2000.0,22,20,12,54
27049,Great Britain,2004.0,17,25,15,57
27050,Great Britain,2008.0,31,25,25,81
27051,Great Britain,2012.0,48,30,48,126
27052,Great Britain,2016.0,64,55,26,145
27053,Great Britain,1936.0,24,17,12,53
27054,England-1,1908.0,147,131,90,368
27055,Great Britain,1932.0,9,12,14,35
27056,Great Britain,1908.0,147,131,90,368
27057,Great Britain,1908.0,147,131,90,368
27058,Ireland-2,1908.0,147,131,90,368
27059,Liverpool Police Team-2,1908.0,147,131,90,368
27060,Great Britain,2012.0,48,30,48,126
27061,Great Britain,2016.0,64,55,26,145
27062,Great Britain,1948.0,7,42,14,63
27063,Scotia,1900.0,59,34,15,108
27064,Scotia,1900.0,59,34,15,108
27065,Great Britain,2016.0,64,55,26,145
27066,Great Britain,1948.0,7,42,14,63
27067,Great Britain,1920.0,52,42,17,111
27068,Great Britain,1988.0,22,17,15,54
27069,Great Britain,1992.0,8,3,39,50
27070,Great Britain,1956.0,8,16,22,46
27071,Great Britain,1912.0,47,64,59,170
27072,England,1912.0,47,64,59,170
27073,England-1,1912.0,47,64,59,170
27074,Great Britain,1984.0,11,20,42,73
27075,Great Britain,2000.0,22,20,12,54
27076,Great Britain,1924.0,31,34,30,95
27077,Great Britain,1936.0,24,17,12,53
27078,Great Britain,1932.0,9,12,14,35
27079,Great Britain,1920.0,52,42,17,111
27080,Great Britain,1908.0,147,131,90,368
27081,Great Britain,1992.0,8,3,39,50
27082,Great Britain,1992.0,8,3,39,50
27083,Great Britain,2016.0,64,55,26,145
27084,Great Britain,2016.0,64,55,26,145
27085,Great Britain,1908.0,147,131,90,368
27086,Great Britain,1908.0,147,131,90,368
27087,Great Britain,1972.0,8,9,12,29
27088,Great Britain,1976.0,7,15,11,33
27089,Great Britain,1988.0,22,17,15,54
27090,Great Britain,1992.0,8,3,39,50
27091,Great Britain,1948.0,7,42,14,63
27092,Great Britain,1908.0,147,131,90,368
27093,Great Britain,1908.0,147,131,90,368
27094,Great Britain,1932.0,9,12,14,35
27095,Great Britain,1906.0,9,22,8,39
27096,Great Britain,1906.0,9,22,8,39
27097,Great Britain,1908.0,147,131,90,368
27098,Great Britain,2014.0,1,4,5,10
27099,Great Britain,1928.0,7,27,25,59
27100,Great Britain,1908.0,147,131,90,368
27101,England-1,1912.0,47,64,59,170
27102,Great Britain,1932.0,9,12,14,35
27103,Great Britain,1932.0,9,12,14,35
27104,Great Britain-2,1912.0,47,64,59,170
27105,Great Britain,1912.0,47,64,59,170
27106,Great Britain,1912.0,47,64,59,170
27107,Great Britain,1912.0,47,64,59,170
27108,Great Britain,1984.0,11,20,42,73
27109,Great Britain,1984.0,11,20,42,73
27110,Great Britain,1924.0,31,34,30,95
27111,Great Britain,1908.0,147,131,90,368
27112,Great Britain,1908.0,147,131,90,368
27113,Great Britain,2004.0,17,25,15,57
27114,Lalage,1936.0,24,17,12,53
27115,Great Britain,1936.0,24,17,12,53
27116,Scotland-3,1908.0,147,131,90,368
27117,Great Britain,1948.0,7,42,14,63
27118,Great Britain,1948.0,7,42,14,63
27119,Great Britain,2000.0,22,20,12,54
27120,Great Britain,1960.0,2,11,15,28
27121,Great Britain,1976.0,7,15,11,33
27122,Great Britain,1928.0,7,27,25,59
27123,Great Britain,1932.0,9,12,14,35
27124,Great Britain,1920.0,52,42,17,111
27125,Upton Park FC,1900.0,59,34,15,108
27126,Great Britain,1912.0,47,64,59,170
27127,Great Britain,1912.0,47,64,59,170
27128,Great Britain,1912.0,47,64,59,170
27129,Great Britain,1920.0,52,42,17,111
27130,Great Britain,1908.0,147,131,90,368
27131,Great Britain,1908.0,147,131,90,368
27132,Great Britain,1906.0,9,22,8,39
27133,Great Britain,1908.0,147,131,90,368
27134,Great Britain,2004.0,17,25,15,57
27135,Great Britain,2004.0,17,25,15,57
27136,Great Britain,1906.0,9,22,8,39
27137,Great Britain,1984.0,11,20,42,73
27138,Great Britain,2012.0,48,30,48,126
27139,Great Britain,2016.0,64,55,26,145
27140,Great Britain,2016.0,64,55,26,145
27141,Great Britain,2008.0,31,25,25,81
27142,Great Britain,1964.0,6,19,5,30
27143,Great Britain,1920.0,52,42,17,111
27144,Great Britain,1968.0,9,5,5,19
27145,Great Britain,1972.0,8,9,12,29
27146,Great Britain,1972.0,8,9,12,29
27147,Great Britain,1912.0,47,64,59,170
27148,Great Britain,1996.0,2,15,9,26
27149,Great Britain,2016.0,64,55,26,145
27150,"Osborne Swimming Club, Manchester",1900.0,59,34,15,108
27151,Great Britain,1906.0,9,22,8,39
27152,Great Britain,1992.0,8,3,39,50
27153,Great Britain,1964.0,6,19,5,30
27154,Great Britain,2012.0,48,30,48,126
27155,Great Britain,2016.0,64,55,26,145
27156,Great Britain,1912.0,47,64,59,170
27157,England-1,1912.0,47,64,59,170
27158,Great Britain,1956.0,8,16,22,46
27159,Great Britain,1900.0,59,34,15,108
27160,Great Britain,1920.0,52,42,17,111
27161,Great Britain,1920.0,52,42,17,111
27162,Great Britain,1920.0,52,42,17,111
27163,Great Britain,1912.0,47,64,59,170
27164,Great Britain,1956.0,8,16,22,46
27165,Great Britain,1936.0,24,17,12,53
27166,Great Britain,2012.0,48,30,48,126
27167,Great Britain,2016.0,64,55,26,145
27168,Great Britain,1908.0,147,131,90,368
27169,Great Britain-1,1908.0,147,131,90,368
27170,Great Britain,2016.0,64,55,26,145
27171,Great Britain,1936.0,24,17,12,53
27172,Great Britain,2012.0,48,30,48,126
27173,Great Britain,2016.0,64,55,26,145
27174,London City Police-1,1908.0,147,131,90,368
27175,Great Britain,1932.0,9,12,14,35
27176,Great Britain,1936.0,24,17,12,53
27177,Great Britain,2000.0,22,20,12,54
27178,Great Britain,2004.0,17,25,15,57
27179,Great Britain,2016.0,64,55,26,145
27180,Great Britain,1912.0,47,64,59,170
27181,Great Britain,1920.0,52,42,17,111
27182,Great Britain,1920.0,52,42,17,111
27183,Great Britain,1912.0,47,64,59,170
27184,Great Britain,1984.0,11,20,42,73
27185,Great Britain,1984.0,11,20,42,73
27186,Great Britain,1988.0,22,17,15,54
27187,Great Britain,1988.0,22,17,15,54
27188,Great Britain,1932.0,9,12,14,35
27189,Great Britain,2016.0,64,55,26,145
27190,Great Britain,1920.0,52,42,17,111
27191,Great Britain,1920.0,52,42,17,111
27192,Great Britain,1908.0,147,131,90,368
27193,Great Britain,1984.0,11,20,42,73
27194,Great Britain,1988.0,22,17,15,54
27195,Great Britain,1988.0,22,17,15,54
27196,Great Britain,1956.0,8,16,22,46
27197,Ireland-2,1908.0,147,131,90,368
27198,Great Britain,1920.0,52,42,17,111
27199,Great Britain,1924.0,31,34,30,95
27200,Great Britain,2000.0,22,20,12,54
27201,Great Britain,2004.0,17,25,15,57
27202,Great Britain,2004.0,17,25,15,57
27203,Great Britain,1908.0,147,131,90,368
27204,Great Britain,1912.0,47,64,59,170
27205,K Division Metropolitan Police Team-3,1908.0,147,131,90,368
27206,Moseley Wanderers,1900.0,59,34,15,108
27207,Great Britain,1956.0,8,16,22,46
27208,Bona Fide,1900.0,59,34,15,108
27209,Laurea-1,1900.0,59,34,15,108
27210,Great Britain,1908.0,147,131,90,368
27211,Union des Socits Franais de Sports Athletiques,1900.0,59,34,15,108
27212,Leander Club-1,1912.0,47,64,59,170
27213,Great Britain,1920.0,52,42,17,111
27214,Great Britain,2012.0,48,30,48,126
27215,Great Britain,1960.0,2,11,15,28
27216,Great Britain,1964.0,6,19,5,30
27217,Great Britain,2004.0,17,25,15,57
27218,Great Britain,2008.0,31,25,25,81
27219,Great Britain,2016.0,64,55,26,145
27220,Great Britain-2,2012.0,48,30,48,126
27221,Great Britain,2016.0,64,55,26,145
27222,Great Britain,2008.0,31,25,25,81
27223,Great Britain,1960.0,2,11,15,28
27224,Great Britain,1936.0,24,17,12,53
27225,Great Britain,1984.0,11,20,42,73
27226,Great Britain,1992.0,8,3,39,50
27227,Great Britain,2000.0,22,20,12,54
27228,Great Britain,2000.0,22,20,12,54
27229,Great Britain,2004.0,17,25,15,57
27230,Great Britain,2008.0,31,25,25,81
27231,Great Britain,2008.0,31,25,25,81
27232,Great Britain,2008.0,31,25,25,81
27233,Great Britain,2012.0,48,30,48,126
27234,Great Britain,2012.0,48,30,48,126
27235,Great Britain,1980.0,6,18,24,48
27236,Great Britain,1980.0,6,18,24,48
27237,Sorais-2,1908.0,147,131,90,368
27238,Great Britain,1932.0,9,12,14,35
27239,Sorais-2,1908.0,147,131,90,368
27240,Great Britain,1932.0,9,12,14,35
27241,Great Britain,1984.0,11,20,42,73
27242,Great Britain,1908.0,147,131,90,368
27243,Great Britain,1908.0,147,131,90,368
27244,Great Britain,1912.0,47,64,59,170
27245,London City Police-1,1908.0,147,131,90,368
27246,Great Britain,1912.0,47,64,59,170
27247,Great Britain,1920.0,52,42,17,111
27248,Great Britain,1912.0,47,64,59,170
27249,Sorais-2,1908.0,147,131,90,368
27250,Great Britain,1972.0,8,9,12,29
27251,Great Britain,1908.0,147,131,90,368
27252,Great Britain,2008.0,31,25,25,81
27253,Great Britain,2000.0,22,20,12,54
27254,Great Britain,1980.0,6,18,24,48
27255,Great Britain,1984.0,11,20,42,73
27256,Great Britain,2008.0,31,25,25,81
27257,Great Britain,2012.0,48,30,48,126
27258,Great Britain,1912.0,47,64,59,170
27259,Great Britain,1912.0,47,64,59,170
27260,Great Britain-2,1908.0,147,131,90,368
27261,Great Britain,1996.0,2,15,9,26
27262,Great Britain,1960.0,2,11,15,28
27263,Great Britain,1960.0,2,11,15,28
27264,Great Britain,1964.0,6,19,5,30
27265,Great Britain,1912.0,47,64,59,170
27266,Great Britain,1956.0,8,16,22,46
27267,Great Britain,2008.0,31,25,25,81
27268,Great Britain,1920.0,52,42,17,111
27269,London City Police-1,1908.0,147,131,90,368
27270,Great Britain,1908.0,147,131,90,368
27271,Cornwall,1908.0,147,131,90,368
27272,Cornwall,1908.0,147,131,90,368
27273,Great Britain,1972.0,8,9,12,29
27274,Great Britain,1956.0,8,16,22,46
27275,Great Britain,1956.0,8,16,22,46
27276,Great Britain,1912.0,47,64,59,170
27277,Great Britain,1988.0,22,17,15,54
27278,Great Britain,2008.0,31,25,25,81
27279,Great Britain,1924.0,31,34,30,95
27280,Great Britain,1936.0,24,17,12,53
27281,Great Britain,1924.0,31,34,30,95
27282,Emily,1924.0,31,34,30,95
27283,Great Britain,1912.0,47,64,59,170
27284,Great Britain,1984.0,11,20,42,73
27285,Joy,1932.0,9,12,14,35
27286,Great Britain,1928.0,7,27,25,59
27287,Great Britain,2016.0,64,55,26,145
27288,Great Britain,2016.0,64,55,26,145
27289,Great Britain,1920.0,52,42,17,111
27290,Great Britain,1964.0,6,19,5,30
27291,Great Britain,2008.0,31,25,25,81
27292,Great Britain,2012.0,48,30,48,126
27293,Great Britain,1920.0,52,42,17,111
27294,Great Britain,1988.0,22,17,15,54
27295,Great Britain,1980.0,6,18,24,48
27296,Great Britain,2012.0,48,30,48,126
27297,Bluebottle,1956.0,8,16,22,46
27298,Great Britain,1968.0,9,5,5,19
27299,"Osborne Swimming Club, Manchester",1900.0,59,34,15,108
27300,Great Britain,1900.0,59,34,15,108
27301,Great Britain,1900.0,59,34,15,108
27302,Great Britain,1906.0,9,22,8,39
27303,Great Britain,1906.0,9,22,8,39
27304,Great Britain,1906.0,9,22,8,39
27305,Great Britain,1960.0,2,11,15,28
27306,Great Britain,1960.0,2,11,15,28
27307,Great Britain,1920.0,52,42,17,111
27308,Great Britain,1924.0,31,34,30,95
27309,Bona Fide,1900.0,59,34,15,108
27310,Great Britain,2008.0,31,25,25,81
27311,Mouchette-2,1908.0,147,131,90,368
27312,Great Britain,1972.0,8,9,12,29
27313,Cambridge University Boat Club-2,1908.0,147,131,90,368
27314,Great Britain,1956.0,8,16,22,46
27315,Great Britain,1956.0,8,16,22,46
27316,Great Britain,1932.0,9,12,14,35
27317,Great Britain,1936.0,24,17,12,53
27318,Great Britain,1908.0,147,131,90,368
27319,Great Britain-1,1908.0,147,131,90,368
27320,Great Britain,1992.0,8,3,39,50
27321,Great Britain,1948.0,7,42,14,63
27322,Great Britain-1,1908.0,147,131,90,368
27323,Great Britain-1,1920.0,52,42,17,111
27324,Great Britain,1908.0,147,131,90,368
27325,Great Britain,1920.0,52,42,17,111
27326,Great Britain,1920.0,52,42,17,111
27327,Great Britain,1908.0,147,131,90,368
27328,Great Britain,1908.0,147,131,90,368
27329,Great Britain,1924.0,31,34,30,95
27330,Leander Club-1,1908.0,147,131,90,368
27331,Great Britain,1920.0,52,42,17,111
27332,Great Britain,1908.0,147,131,90,368
27333,Great Britain,1908.0,147,131,90,368
27334,Great Britain,1908.0,147,131,90,368
27335,Great Britain,1968.0,9,5,5,19
27336,Great Britain,1920.0,52,42,17,111
27337,Great Britain,1960.0,2,11,15,28
27338,Cornwall,1908.0,147,131,90,368
27339,Great Britain,1908.0,147,131,90,368
27340,Great Britain,2012.0,48,30,48,126
27341,Great Britain,2016.0,64,55,26,145
27342,Upton Park FC,1900.0,59,34,15,108
27343,Great Britain,2014.0,1,4,5,10
27344,Great Britain,1948.0,7,42,14,63
27345,England-1,1912.0,47,64,59,170
27346,Hurlingham-2,1908.0,147,131,90,368
27347,Union des Socits Franais de Sports Athletiques,1900.0,59,34,15,108
27348,Cornwall,1908.0,147,131,90,368
27349,Great Britain,2012.0,48,30,48,126
27350,Great Britain,2016.0,64,55,26,145
27351,Great Britain,1928.0,7,27,25,59
27352,Great Britain,1924.0,31,34,30,95
27353,Great Britain,1980.0,6,18,24,48
27354,Great Britain,1948.0,7,42,14,63
27355,Great Britain,1972.0,8,9,12,29
27356,Great Britain,1896.0,3,3,3,9
27357,Leander Club-1,1908.0,147,131,90,368
27358,Great Britain,1980.0,6,18,24,48
27359,"Osborne Swimming Club, Manchester",1900.0,59,34,15,108
27360,Great Britain,1900.0,59,34,15,108
27361,Great Britain,1912.0,47,64,59,170
27362,Great Britain,1912.0,47,64,59,170
27363,Mouchette-2,1908.0,147,131,90,368
27364,Great Britain,2012.0,48,30,48,126
27365,Ireland-2,1908.0,147,131,90,368
27366,Vision,1956.0,8,16,22,46
27367,Great Britain,2008.0,31,25,25,81
27368,Great Britain,2008.0,31,25,25,81
27369,Great Britain,2012.0,48,30,48,126
27370,Great Britain,2012.0,48,30,48,126
27371,Great Britain,2016.0,64,55,26,145
27372,Great Britain,2016.0,64,55,26,145
27373,Great Britain,2016.0,64,55,26,145
27374,Great Britain,1984.0,11,20,42,73
27375,Great Britain,1988.0,22,17,15,54
27376,Great Britain,2004.0,17,25,15,57
27377,Liverpool Police Team-2,1908.0,147,131,90,368
27378,Great Britain,1904.0,1,1,0,2
27379,Great Britain,1928.0,7,27,25,59
27380,Great Britain,1936.0,24,17,12,53
27381,Great Britain,1936.0,24,17,12,53
27382,Great Britain,2012.0,48,30,48,126
27383,Great Britain,1928.0,7,27,25,59
27384,Great Britain,1928.0,7,27,25,59
27385,Great Britain,1908.0,147,131,90,368
27386,Great Britain,1908.0,147,131,90,368
27387,Great Britain,1912.0,47,64,59,170
27388,Leander Club-1,1912.0,47,64,59,170
27389,England-1,1912.0,47,64,59,170
27390,Great Britain,1988.0,22,17,15,54
27391,Cambridge University Boat Club-2,1908.0,147,131,90,368
27392,Great Britain,1928.0,7,27,25,59
27393,Great Britain,1912.0,47,64,59,170
27394,Great Britain,1928.0,7,27,25,59
27395,Great Britain,2002.0,5,0,1,6
27396,Great Britain,1972.0,8,9,12,29
27397,Smyrna,1906.0,9,22,8,39
27398,Great Britain,1992.0,8,3,39,50
27399,Great Britain,1996.0,2,15,9,26
27400,Scotland-3,1908.0,147,131,90,368
27401,Great Britain,1908.0,147,131,90,368
27402,Great Britain,1920.0,52,42,17,111
27403,Great Britain,1928.0,7,27,25,59
27404,Great Britain,1928.0,7,27,25,59
27405,Great Britain,1908.0,147,131,90,368
27406,Great Britain,2016.0,64,55,26,145
27407,Great Britain,2008.0,31,25,25,81
27408,Great Britain,2012.0,48,30,48,126
27409,Great Britain,2016.0,64,55,26,145
27410,Great Britain,1980.0,6,18,24,48
27411,Great Britain,1948.0,7,42,14,63
27412,Great Britain,1908.0,147,131,90,368
27413,Great Britain,1908.0,147,131,90,368
27414,Great Britain,2016.0,64,55,26,145
27415,Great Britain,2016.0,64,55,26,145
27416,Great Britain,1948.0,7,42,14,63
27417,Great Britain,1928.0,7,27,25,59
27418,Great Britain,2004.0,17,25,15,57
27419,Great Britain,2008.0,31,25,25,81
27420,Wales-4,1908.0,147,131,90,368
27421,Great Britain,2000.0,22,20,12,54
27422,Great Britain,2004.0,17,25,15,57
27423,Great Britain,2004.0,17,25,15,57
27424,Cornwall,1908.0,147,131,90,368
27425,Dormy-1,1908.0,147,131,90,368
27426,Lalage,1936.0,24,17,12,53
27427,Great Britain,1908.0,147,131,90,368
27428,Great Britain-3,1908.0,147,131,90,368
27429,Great Britain,1906.0,9,22,8,39
27430,Great Britain,1906.0,9,22,8,39
27431,Great Britain,1908.0,147,131,90,368
27432,Great Britain,1900.0,59,34,15,108
27433,Great Britain,1900.0,59,34,15,108
27434,Great Britain,2016.0,64,55,26,145
27435,Great Britain,1920.0,52,42,17,111
27436,Great Britain,1984.0,11,20,42,73
27437,Great Britain,1988.0,22,17,15,54
27438,Great Britain,1952.0,4,2,26,32
27439,Great Britain,1912.0,47,64,59,170
27440,Great Britain,1976.0,7,15,11,33
27441,Great Britain,1996.0,2,15,9,26
27442,Great Britain,2000.0,22,20,12,54
27443,Great Britain,2004.0,17,25,15,57
27444,Great Britain,1924.0,31,34,30,95
27445,Great Britain,1924.0,31,34,30,95
27446,Great Britain,2000.0,22,20,12,54
27447,Great Britain,2000.0,22,20,12,54
27448,Great Britain,1920.0,52,42,17,111
27449,Great Britain,1948.0,7,42,14,63
27450,Great Britain,1948.0,7,42,14,63
27451,Great Britain,2016.0,64,55,26,145
27452,Great Britain,2016.0,64,55,26,145
27453,Great Britain,1992.0,8,3,39,50
27454,Mouchette-2,1908.0,147,131,90,368
27455,"New College, Oxford-2",1912.0,47,64,59,170
27456,Great Britain,1912.0,47,64,59,170
27457,Great Britain,1948.0,7,42,14,63
27458,Great Britain,1952.0,4,2,26,32
27459,Great Britain,1948.0,7,42,14,63
27460,Ireland-3,1908.0,147,131,90,368
27461,Great Britain,1960.0,2,11,15,28
27462,Great Britain,1984.0,11,20,42,73
27463,Great Britain,1920.0,52,42,17,111
27464,Thames Rowing Club,1912.0,47,64,59,170
27465,England-1,1908.0,147,131,90,368
27466,Moseley Wanderers,1900.0,59,34,15,108
27467,Great Britain,1928.0,7,27,25,59
27468,Great Britain,1928.0,7,27,25,59
27469,Great Britain,1924.0,31,34,30,95
27470,Great Britain,1960.0,2,11,15,28
27471,Great Britain,2012.0,48,30,48,126
27472,Great Britain,2016.0,64,55,26,145
27473,Moseley Wanderers,1900.0,59,34,15,108
27474,Great Britain,1980.0,6,18,24,48
27475,Great Britain,1924.0,31,34,30,95
27476,Great Britain,1928.0,7,27,25,59
27477,Liverpool Police Team-2,1908.0,147,131,90,368
27478,Great Britain,1920.0,52,42,17,111
27479,Great Britain,1912.0,47,64,59,170
27480,Great Britain,2008.0,31,25,25,81
27481,Great Britain,1908.0,147,131,90,368
27482,Wales-4,1908.0,147,131,90,368
27483,Great Britain,1908.0,147,131,90,368
27484,Great Britain,1920.0,52,42,17,111
27485,Great Britain,1924.0,31,34,30,95
27486,Great Britain,1924.0,31,34,30,95
27487,Great Britain,2002.0,5,0,1,6
27488,Great Britain,1980.0,6,18,24,48
27489,Great Britain,1968.0,9,5,5,19
27490,Union des Socits Franais de Sports Athletiques,1900.0,59,34,15,108
27491,Great Britain,1912.0,47,64,59,170
27492,Mouchette-2,1908.0,147,131,90,368
27493,Mouchette-2,1908.0,147,131,90,368
27494,Hera-1,1908.0,147,131,90,368
27495,Magdalen College Boat Club-1,1908.0,147,131,90,368
27496,Great Britain,1912.0,47,64,59,170
27497,Great Britain,1924.0,31,34,30,95
27498,Great Britain,1924.0,31,34,30,95
27499,Great Britain,1924.0,31,34,30,95
27500,Leander Club-1,1908.0,147,131,90,368
27501,Great Britain,2000.0,22,20,12,54
27502,Great Britain,2012.0,48,30,48,126
27503,Great Britain,2016.0,64,55,26,145
27504,Great Britain,1924.0,31,34,30,95
27505,Ancora,1920.0,52,42,17,111
27506,Great Britain,2012.0,48,30,48,126
27507,Great Britain,2012.0,48,30,48,126
27508,Great Britain,1980.0,6,18,24,48
27509,Great Britain,1988.0,22,17,15,54
27510,Great Britain,1900.0,59,34,15,108
27511,France/Great Britain,1900.0,59,34,15,108
27512,Great Britain-2,1900.0,59,34,15,108
27513,Great Britain,1948.0,7,42,14,63
27514,Great Britain,1920.0,52,42,17,111
27515,Great Britain,1924.0,31,34,30,95
27516,Great Britain,1924.0,31,34,30,95
27517,Great Britain,1948.0,7,42,14,63
27518,Bluebottle,1956.0,8,16,22,46
27519,Great Britain,2000.0,22,20,12,54
27520,Great Britain,2004.0,17,25,15,57
27521,Great Britain,2008.0,31,25,25,81
27522,Great Britain,1980.0,6,18,24,48
27523,Great Britain,2016.0,64,55,26,145
27524,Great Britain,1920.0,52,42,17,111
27525,Great Britain,1992.0,8,3,39,50
27526,Great Britain,1908.0,147,131,90,368
27527,Great Britain,1928.0,7,27,25,59
27528,Cornwall,1908.0,147,131,90,368
27529,Great Britain,1980.0,6,18,24,48
27530,Hera-1,1908.0,147,131,90,368
27531,Great Britain,1908.0,147,131,90,368
27532,Lalage,1936.0,24,17,12,53
27533,Great Britain,1960.0,2,11,15,28
27534,Great Britain,1964.0,6,19,5,30
27535,Great Britain,1908.0,147,131,90,368
27536,Great Britain,2002.0,5,0,1,6
27537,Great Britain,1984.0,11,20,42,73
27538,Great Britain,1988.0,22,17,15,54
27539,Great Britain,1912.0,47,64,59,170
27540,Great Britain,1908.0,147,131,90,368
27541,Great Britain,2008.0,31,25,25,81
27542,Great Britain,2016.0,64,55,26,145
27543,Great Britain,1948.0,7,42,14,63
27544,Great Britain,1976.0,7,15,11,33
27545,Great Britain,1906.0,9,22,8,39
27546,Great Britain,1964.0,6,19,5,30
27547,Great Britain,1908.0,147,131,90,368
27548,Great Britain,1908.0,147,131,90,368
27549,Scotia,1900.0,59,34,15,108
27550,Scotia,1900.0,59,34,15,108
27551,Great Britain,1908.0,147,131,90,368
27552,Great Britain-1,1908.0,147,131,90,368
27553,Great Britain,1912.0,47,64,59,170
27554,Great Britain,1976.0,7,15,11,33
27555,Great Britain,2016.0,64,55,26,145
27556,Ireland-3,1908.0,147,131,90,368
27557,Great Britain,1976.0,7,15,11,33
27558,Great Britain,1988.0,22,17,15,54
27559,Great Britain,1984.0,11,20,42,73
27560,Great Britain,2016.0,64,55,26,145
27561,Great Britain,1956.0,8,16,22,46
27562,Great Britain,1948.0,7,42,14,63
27563,Great Britain,1908.0,147,131,90,368
27564,Great Britain,1980.0,6,18,24,48
27565,Great Britain,1936.0,24,17,12,53
27566,Great Britain,1988.0,22,17,15,54
27567,Great Britain,1906.0,9,22,8,39
27568,Great Britain,1980.0,6,18,24,48
27569,Great Britain,1920.0,52,42,17,111
27570,Great Britain,1964.0,6,19,5,30
27571,Great Britain,2000.0,22,20,12,54
27572,Great Britain,1988.0,22,17,15,54
27573,Great Britain,1920.0,52,42,17,111
27574,Great Britain-3,1920.0,52,42,17,111
27575,Great Britain,1920.0,52,42,17,111
27576,Great Britain,1924.0,31,34,30,95
27577,Great Britain-2,1924.0,31,34,30,95
27578,Great Britain,2012.0,48,30,48,126
27579,Great Britain,1920.0,52,42,17,111
27580,Great Britain,1920.0,52,42,17,111
27581,Great Britain,1924.0,31,34,30,95
27582,Great Britain,1924.0,31,34,30,95
27583,Great Britain,1908.0,147,131,90,368
27584,Great Britain,1912.0,47,64,59,170
27585,Great Britain,1984.0,11,20,42,73
27586,Mouchette-2,1908.0,147,131,90,368
27587,Dormy-1,1908.0,147,131,90,368
27588,Great Britain,1920.0,52,42,17,111
27589,Great Britain,1980.0,6,18,24,48
27590,Great Britain,1920.0,52,42,17,111
27591,Great Britain,1956.0,8,16,22,46
27592,Great Britain,1960.0,2,11,15,28
27593,Great Britain,1912.0,47,64,59,170
27594,Great Britain,1992.0,8,3,39,50
27595,Great Britain,1968.0,9,5,5,19
27596,Great Britain,1972.0,8,9,12,29
27597,Great Britain,1972.0,8,9,12,29
27598,Great Britain,2016.0,64,55,26,145
27599,Great Britain,1948.0,7,42,14,63
27600,Great Britain,1920.0,52,42,17,111
27601,Great Britain,1984.0,11,20,42,73
27602,Great Britain,1908.0,147,131,90,368
27603,England-1,1912.0,47,64,59,170
27604,England-1,1912.0,47,64,59,170
27605,Great Britain,1906.0,9,22,8,39
27606,Great Britain,1906.0,9,22,8,39
27607,Great Britain,1906.0,9,22,8,39
27608,Great Britain,1906.0,9,22,8,39
27609,Great Britain,1996.0,2,15,9,26
27610,London City Police-1,1908.0,147,131,90,368
27611,Great Britain,2000.0,22,20,12,54
27612,Great Britain,1912.0,47,64,59,170
27613,Great Britain,1964.0,6,19,5,30
27614,Great Britain,1948.0,7,42,14,63
27615,Great Britain,1928.0,7,27,25,59
27616,Great Britain,1952.0,4,2,26,32
27617,Great Britain,1908.0,147,131,90,368
27618,Roehampton-1,1908.0,147,131,90,368
27619,Roehampton-1,1908.0,147,131,90,368
27620,Great Britain,1992.0,8,3,39,50
27621,Great Britain,1908.0,147,131,90,368
27622,London City Police-1,1908.0,147,131,90,368
27623,Great Britain,1912.0,47,64,59,170
27624,Great Britain,1920.0,52,42,17,111
27625,Great Britain,1936.0,24,17,12,53
27626,Great Britain,2012.0,48,30,48,126
27627,Great Britain,2016.0,64,55,26,145
27628,Great Britain,2016.0,64,55,26,145
27629,Great Britain,1912.0,47,64,59,170
27630,Great Britain,1912.0,47,64,59,170
27631,Great Britain,1972.0,8,9,12,29
27632,Great Britain,1924.0,31,34,30,95
27633,Great Britain,2016.0,64,55,26,145
27634,Great Britain,1908.0,147,131,90,368
27635,Great Britain,1912.0,47,64,59,170
27636,Great Britain,1972.0,8,9,12,29
27637,Great Britain-1,1908.0,147,131,90,368
27638,Great Britain,1912.0,47,64,59,170
27639,Great Britain,1972.0,8,9,12,29
27640,Great Britain,1912.0,47,64,59,170
27641,Great Britain,1988.0,22,17,15,54
27642,Great Britain,1928.0,7,27,25,59
27643,Great Britain,1992.0,8,3,39,50
27644,Lady C,1964.0,6,19,5,30
27645,Great Britain,1908.0,147,131,90,368
27646,Great Britain,1924.0,31,34,30,95
27647,Swift,1948.0,7,42,14,63
27648,Great Britain-2,1908.0,147,131,90,368
27649,Great Britain,1924.0,31,34,30,95
27650,Great Britain,1924.0,31,34,30,95
27651,Great Britain,1924.0,31,34,30,95
27652,Great Britain,2002.0,5,0,1,6
27653,England-1,1912.0,47,64,59,170
27654,Great Britain,2004.0,17,25,15,57
27655,Great Britain,1980.0,6,18,24,48
27656,Great Britain,1924.0,31,34,30,95
27657,Great Britain,2012.0,48,30,48,126
27658,Great Britain,2016.0,64,55,26,145
27659,Great Britain,2014.0,1,4,5,10
27660,K Division Metropolitan Police Team-3,1908.0,147,131,90,368
27661,Great Britain,1912.0,47,64,59,170
27662,Great Britain,2014.0,1,4,5,10
27663,Ireland-2,1908.0,147,131,90,368
27664,Great Britain,2012.0,48,30,48,126
27665,Great Britain,2012.0,48,30,48,126
27666,Great Britain,2016.0,64,55,26,145
27667,Great Britain,1912.0,47,64,59,170
27668,Great Britain,2012.0,48,30,48,126
27669,Great Britain,1924.0,31,34,30,95
27670,Great Britain,1988.0,22,17,15,54
27671,Great Britain,1980.0,6,18,24,48
27672,Lady C,1964.0,6,19,5,30
27673,Great Britain,2012.0,48,30,48,126
27674,Great Britain,2016.0,64,55,26,145
27675,Great Britain-1,1964.0,6,19,5,30
27676,Great Britain,1924.0,31,34,30,95
27677,Scotland-3,1908.0,147,131,90,368
27678,Great Britain,2016.0,64,55,26,145
27679,Great Britain,2008.0,31,25,25,81
27680,Great Britain,1992.0,8,3,39,50
27681,Great Britain,1908.0,147,131,90,368
27682,Great Britain,1908.0,147,131,90,368
27683,Great Britain,1952.0,4,2,26,32
27684,Great Britain,1952.0,4,2,26,32
27685,Great Britain,2000.0,22,20,12,54
27686,Great Britain,2004.0,17,25,15,57
27687,Great Britain,2008.0,31,25,25,81
27688,Great Britain,1906.0,9,22,8,39
27689,Great Britain,1924.0,31,34,30,95
27690,Upton Park FC,1900.0,59,34,15,108
27691,Great Britain,1956.0,8,16,22,46
27692,Great Britain,1920.0,52,42,17,111
27693,Great Britain,1992.0,8,3,39,50
27694,Great Britain,1928.0,7,27,25,59
27695,Leander Club-1,1908.0,147,131,90,368
27696,Great Britain,1920.0,52,42,17,111
27697,Great Britain,1928.0,7,27,25,59
27698,Roehampton-1,1908.0,147,131,90,368
27699,Great Britain,1912.0,47,64,59,170
27700,Moseley Wanderers,1900.0,59,34,15,108
27701,Great Britain,1948.0,7,42,14,63
27702,Great Britain,1976.0,7,15,11,33
27703,Great Britain,1964.0,6,19,5,30
27704,Great Britain,1928.0,7,27,25,59
27705,Great Britain,1908.0,147,131,90,368
27706,England-1,1908.0,147,131,90,368
27707,Great Britain,1908.0,147,131,90,368
27708,Great Britain-3,1908.0,147,131,90,368
27709,Great Britain,1924.0,31,34,30,95
27710,Great Britain,1924.0,31,34,30,95
27711,Great Britain,1900.0,59,34,15,108
27712,Great Britain-2,1900.0,59,34,15,108
27713,Great Britain,1952.0,4,2,26,32
27714,Great Britain,2016.0,64,55,26,145
27715,Great Britain,1924.0,31,34,30,95
27716,Great Britain,1952.0,4,2,26,32
27717,Great Britain,1952.0,4,2,26,32
27718,Great Britain,1980.0,6,18,24,48
27719,Great Britain,1928.0,7,27,25,59
27720,Great Britain,1912.0,47,64,59,170
27721,Great Britain,1996.0,2,15,9,26
27722,Great Britain,1906.0,9,22,8,39
27723,Great Britain,1906.0,9,22,8,39
27724,Great Britain,2016.0,64,55,26,145
27725,Great Britain,1936.0,24,17,12,53
27726,Great Britain,1948.0,7,42,14,63
27727,Great Britain,1928.0,7,27,25,59
27728,Great Britain,2012.0,48,30,48,126
27729,Great Britain,2008.0,31,25,25,81
27730,Great Britain,2012.0,48,30,48,126
27731,Great Britain,2016.0,64,55,26,145
27732,Great Britain,1908.0,147,131,90,368
27733,Great Britain,2012.0,48,30,48,126
27734,Great Britain,1908.0,147,131,90,368
27735,Great Britain,1936.0,24,17,12,53
27736,Great Britain,1998.0,0,0,4,4
27737,Great Britain,1908.0,147,131,90,368
27738,Great Britain,1912.0,47,64,59,170
27739,Great Britain,2016.0,64,55,26,145
27740,Ireland-3,1908.0,147,131,90,368
27741,Scotland-3,1908.0,147,131,90,368
27742,Great Britain,1976.0,7,15,11,33
27743,Great Britain,1980.0,6,18,24,48
27744,Great Britain,1984.0,11,20,42,73
27745,Great Britain,1980.0,6,18,24,48
27746,Great Britain,1980.0,6,18,24,48
27747,Great Britain,1908.0,147,131,90,368
27748,Great Britain,1912.0,47,64,59,170
27749,Great Britain,2016.0,64,55,26,145
27750,Great Britain,1964.0,6,19,5,30
27751,Great Britain,1964.0,6,19,5,30
27752,Great Britain,1908.0,147,131,90,368
27753,Great Britain,2016.0,64,55,26,145
27754,England-1,1908.0,147,131,90,368
27755,Wales-4,1908.0,147,131,90,368
27756,Great Britain-1,1908.0,147,131,90,368
27757,Great Britain,1912.0,47,64,59,170
27758,Great Britain,1996.0,2,15,9,26
27759,Great Britain,2012.0,48,30,48,126
27760,Great Britain,1988.0,22,17,15,54
27761,Great Britain,1972.0,8,9,12,29
27762,Great Britain-2,1908.0,147,131,90,368
27763,Great Britain,1976.0,7,15,11,33
27764,Great Britain,1972.0,8,9,12,29
27765,"New College, Oxford-2",1912.0,47,64,59,170
27766,Great Britain,1908.0,147,131,90,368
27767,Great Britain,1968.0,9,5,5,19
27768,Great Britain,1908.0,147,131,90,368
27769,Great Britain,1912.0,47,64,59,170
27770,Great Britain,2004.0,17,25,15,57
27771,Great Britain,1912.0,47,64,59,170
27772,Great Britain,2008.0,31,25,25,81
27773,Great Britain,2012.0,48,30,48,126
27774,Great Britain,1972.0,8,9,12,29
27775,Great Britain,1956.0,8,16,22,46
27776,Great Britain,2012.0,48,30,48,126
27777,Great Britain,2008.0,31,25,25,81
27778,Great Britain,1968.0,9,5,5,19
27779,Great Britain,1972.0,8,9,12,29
27780,Great Britain,1976.0,7,15,11,33
27781,Great Britain,1908.0,147,131,90,368
27782,Great Britain,2008.0,31,25,25,81
27783,Great Britain,1920.0,52,42,17,111
27784,Great Britain,1948.0,7,42,14,63
27785,Great Britain,2016.0,64,55,26,145
27786,Great Britain,2016.0,64,55,26,145
27787,Great Britain,2000.0,22,20,12,54
27788,Great Britain,1960.0,2,11,15,28
27789,Great Britain,2008.0,31,25,25,81
27790,Great Britain,2012.0,48,30,48,126
27791,Great Britain,2012.0,48,30,48,126
27792,Great Britain-1,1908.0,147,131,90,368
27793,Great Britain,1912.0,47,64,59,170
27794,Great Britain,1912.0,47,64,59,170
27795,Great Britain,1912.0,47,64,59,170
27796,Great Britain,2000.0,22,20,12,54
27797,Great Britain,2008.0,31,25,25,81
27798,Great Britain,2012.0,48,30,48,126
27799,Great Britain,1924.0,31,34,30,95
27800,Vision,1956.0,8,16,22,46
27801,Great Britain,1920.0,52,42,17,111
27802,Great Britain,1972.0,8,9,12,29
27803,Ireland-2,1908.0,147,131,90,368
27804,Ireland-2,1908.0,147,131,90,368
27805,Great Britain,1906.0,9,22,8,39
27806,Great Britain,1960.0,2,11,15,28
27807,Great Britain,1988.0,22,17,15,54
27808,Liverpool Police Team-2,1908.0,147,131,90,368
27809,Great Britain,2016.0,64,55,26,145
27810,Wales-4,1908.0,147,131,90,368
27811,Great Britain,1972.0,8,9,12,29
27812,Great Britain,1988.0,22,17,15,54
27813,Great Britain,2012.0,48,30,48,126
27814,Great Britain,1908.0,147,131,90,368
27815,Great Britain,1928.0,7,27,25,59
27816,Great Britain-1,1908.0,147,131,90,368
27817,Great Britain,1908.0,147,131,90,368
27818,Great Britain,1912.0,47,64,59,170
27819,Great Britain,1912.0,47,64,59,170
27820,Great Britain,1992.0,8,3,39,50
27821,Great Britain,1996.0,2,15,9,26
27822,Great Britain,2000.0,22,20,12,54
27823,Great Britain,2004.0,17,25,15,57
27824,Great Britain,1956.0,8,16,22,46
27825,Great Britain,1924.0,31,34,30,95
27826,"New College, Oxford-2",1912.0,47,64,59,170
27827,Great Britain,2008.0,31,25,25,81
27828,Great Britain,1912.0,47,64,59,170
27829,Great Britain,1932.0,9,12,14,35
27830,Great Britain,1924.0,31,34,30,95
27831,Great Britain-1,1908.0,147,131,90,368
27832,Great Britain,1984.0,11,20,42,73
27833,Great Britain,1988.0,22,17,15,54
27834,Great Britain,1912.0,47,64,59,170
27835,Great Britain,1912.0,47,64,59,170
27836,Great Britain,1912.0,47,64,59,170
27837,Great Britain,1912.0,47,64,59,170
27838,Cambridge University Boat Club-2,1908.0,147,131,90,368
27839,Ireland-2,1908.0,147,131,90,368
27840,Devon and Somerset Wanderers,1900.0,59,34,15,108
27841,Great Britain,1984.0,11,20,42,73
27842,Great Britain,1908.0,147,131,90,368
27843,Great Britain,2008.0,31,25,25,81
27844,England-1,1908.0,147,131,90,368
27845,Great Britain,1988.0,22,17,15,54
27846,Great Britain,1992.0,8,3,39,50
27847,Great Britain,1984.0,11,20,42,73
27848,Great Britain,1980.0,6,18,24,48
27849,Great Britain,1980.0,6,18,24,48
27850,Great Britain,1920.0,52,42,17,111
27851,Great Britain,2008.0,31,25,25,81
27852,Great Britain,2012.0,48,30,48,126
27853,Great Britain,1908.0,147,131,90,368
27854,Great Britain,2012.0,48,30,48,126
27855,Upton Park FC,1900.0,59,34,15,108
27856,Great Britain,2000.0,22,20,12,54
27857,Great Britain,2000.0,22,20,12,54
27858,Great Britain,2016.0,64,55,26,145
27859,Cicely-1,1900.0,59,34,15,108
27860,Great Britain,1960.0,2,11,15,28
27861,Great Britain,1928.0,7,27,25,59
27862,Great Britain,1920.0,52,42,17,111
27863,Great Britain,1960.0,2,11,15,28
27864,Great Britain,1960.0,2,11,15,28
27865,Great Britain,1908.0,147,131,90,368
27866,Great Britain,1908.0,147,131,90,368
27867,Great Britain,1912.0,47,64,59,170
27868,Great Britain,1920.0,52,42,17,111
27869,Great Britain,1932.0,9,12,14,35
27870,Great Britain,1936.0,24,17,12,53
27871,Great Britain,1992.0,8,3,39,50
27872,Great Britain,1908.0,147,131,90,368
27873,Great Britain,1924.0,31,34,30,95
27874,Great Britain,1928.0,7,27,25,59
27875,Great Britain,1928.0,7,27,25,59
27876,Great Britain,1908.0,147,131,90,368
27877,Great Britain,1908.0,147,131,90,368
27878,Great Britain,1908.0,147,131,90,368
27879,Great Britain,2002.0,5,0,1,6
27880,Great Britain,2012.0,48,30,48,126
27881,Great Britain,2016.0,64,55,26,145
27882,Great Britain,2000.0,22,20,12,54
27883,Joy,1932.0,9,12,14,35
27884,Sorais-2,1908.0,147,131,90,368
27885,Foxhunters Hurlingham,1900.0,59,34,15,108
27886,Great Britain,1920.0,52,42,17,111
27887,Great Britain,1984.0,11,20,42,73
27888,Great Britain,1988.0,22,17,15,54
27889,Great Britain,1988.0,22,17,15,54
27890,Great Britain,1992.0,8,3,39,50
27891,Great Britain,1996.0,2,15,9,26
27892,Great Britain,2000.0,22,20,12,54
27893,Gyrinus-1,1908.0,147,131,90,368
27894,Gyrinus-1,1908.0,147,131,90,368
27895,Great Britain,2008.0,31,25,25,81
27896,Great Britain,2012.0,48,30,48,126
27897,Great Britain,2016.0,64,55,26,145
27898,England-1,1908.0,147,131,90,368
27899,Great Britain,2004.0,17,25,15,57
27900,Great Britain,1988.0,22,17,15,54
27901,Great Britain,1992.0,8,3,39,50
27902,Great Britain,1912.0,47,64,59,170
27903,Great Britain,1992.0,8,3,39,50
27904,Great Britain,1976.0,7,15,11,33
27905,Great Britain,1992.0,8,3,39,50
27906,Great Britain,1924.0,31,34,30,95
27907,Great Britain,2016.0,64,55,26,145
27908,Great Britain,1948.0,7,42,14,63
27909,Great Britain,1956.0,8,16,22,46
27910,Great Britain,1972.0,8,9,12,29
27911,Cobweb-1,1908.0,147,131,90,368
27912,Wales-4,1908.0,147,131,90,368
27913,Great Britain,1984.0,11,20,42,73
27914,Great Britain,1948.0,7,42,14,63
27915,Great Britain-1,1924.0,31,34,30,95
27916,Great Britain,1948.0,7,42,14,63
27917,Great Britain,1992.0,8,3,39,50
27918,Great Britain,1996.0,2,15,9,26
27919,Great Britain,1908.0,147,131,90,368
27920,Great Britain,2012.0,48,30,48,126
27921,Great Britain,2016.0,64,55,26,145
27922,Great Britain,2012.0,48,30,48,126
27923,Great Britain,2016.0,64,55,26,145
27924,Great Britain,1952.0,4,2,26,32
27925,Great Britain,1948.0,7,42,14,63
27926,Emily,1924.0,31,34,30,95
27927,Emily,1924.0,31,34,30,95
27928,Great Britain,1900.0,59,34,15,108
27929,Amateur Athletic Association,1900.0,59,34,15,108
27930,Great Britain,1924.0,31,34,30,95
27931,Great Britain,1908.0,147,131,90,368
27932,Great Britain-2,1908.0,147,131,90,368
27933,Great Britain,1908.0,147,131,90,368
27934,Heroine,1908.0,147,131,90,368
27935,Heroine,1908.0,147,131,90,368
27936,Great Britain,1936.0,24,17,12,53
27937,Great Britain,1908.0,147,131,90,368
27938,Great Britain,1908.0,147,131,90,368
27939,Great Britain,1900.0,59,34,15,108
27940,Australia/Great Britain,1896.0,3,3,3,9
27941,Great Britain,1976.0,7,15,11,33
27942,Great Britain,2016.0,64,55,26,145
27943,Great Britain-1,2004.0,17,25,15,57
27944,Great Britain,2000.0,22,20,12,54
27945,Great Britain,2004.0,17,25,15,57
27946,Great Britain,1956.0,8,16,22,46
27947,Great Britain,1964.0,6,19,5,30
27948,Great Britain,1952.0,4,2,26,32
27949,Union des Socits Franais de Sports Athletiques,1900.0,59,34,15,108
27950,Ireland-2,1908.0,147,131,90,368
27951,England-1,1908.0,147,131,90,368
27952,Great Britain,1900.0,59,34,15,108
27953,Great Britain,1900.0,59,34,15,108
27954,Amateur Athletic Association,1900.0,59,34,15,108
27955,Great Britain,1908.0,147,131,90,368
27956,Great Britain,2012.0,48,30,48,126
27957,Great Britain,1908.0,147,131,90,368
27958,Great Britain,2016.0,64,55,26,145
27959,Great Britain,1908.0,147,131,90,368
27960,Great Britain,2012.0,48,30,48,126
27961,Great Britain,2004.0,17,25,15,57
27962,Great Britain,2008.0,31,25,25,81
27963,Great Britain,2004.0,17,25,15,57
27964,Great Britain,2008.0,31,25,25,81
27965,Emily,1924.0,31,34,30,95
27966,Great Britain,1956.0,8,16,22,46
27967,Great Britain,2008.0,31,25,25,81
27968,Great Britain,2016.0,64,55,26,145
27969,Great Britain,1912.0,47,64,59,170
27970,Ireland-3,1908.0,147,131,90,368
27971,Thames Rowing Club,1912.0,47,64,59,170
27972,Great Britain,2008.0,31,25,25,81
27973,Great Britain,1988.0,22,17,15,54
27974,Great Britain,2012.0,48,30,48,126
27975,Great Britain,2016.0,64,55,26,145
27976,Great Britain,1924.0,31,34,30,95
27977,Great Britain,2006.0,0,1,0,1
27978,Great Britain,1998.0,0,0,4,4
27979,Great Britain,1906.0,9,22,8,39
27980,Great Britain,1908.0,147,131,90,368
27981,Great Britain,1964.0,6,19,5,30
27982,Great Britain,2012.0,48,30,48,126
27983,Great Britain,2016.0,64,55,26,145
27984,Great Britain,1900.0,59,34,15,108
27985,Great Britain,1920.0,52,42,17,111
27986,Great Britain,1920.0,52,42,17,111
27987,Great Britain,1956.0,8,16,22,46
27988,Great Britain,1924.0,31,34,30,95
27989,Leander Club-1,1908.0,147,131,90,368
27990,Great Britain,1984.0,11,20,42,73
27991,Great Britain,2012.0,48,30,48,126
27992,Great Britain,2016.0,64,55,26,145
27993,Great Britain,1920.0,52,42,17,111
27994,Great Britain,2012.0,48,30,48,126
27995,Great Britain,2016.0,64,55,26,145
27996,Great Britain,2000.0,22,20,12,54
27997,Union des Socits Franais de Sports Athletiques,1900.0,59,34,15,108
27998,Great Britain,2012.0,48,30,48,126
27999,Great Britain,2016.0,64,55,26,145
28000,Great Britain,1996.0,2,15,9,26
28001,Great Britain,1936.0,24,17,12,53
28002,Great Britain,1908.0,147,131,90,368
28003,Great Britain,1948.0,7,42,14,63
28004,Great Britain,2016.0,64,55,26,145
28005,Great Britain,2016.0,64,55,26,145
28006,Great Britain,2016.0,64,55,26,145
28007,Great Britain,1948.0,7,42,14,63
28008,Potsdam,1936.0,24,17,12,53
28009,Great Britain,2016.0,64,55,26,145
28010,Great Britain,1912.0,47,64,59,170
28011,Great Britain,1956.0,8,16,22,46
28012,Great Britain,1920.0,52,42,17,111
28013,Great Britain,1924.0,31,34,30,95
28014,Great Britain,1992.0,8,3,39,50
28015,Great Britain,1996.0,2,15,9,26
28016,Great Britain,2012.0,48,30,48,126
28017,Great Britain,1992.0,8,3,39,50
28018,Great Britain,1996.0,2,15,9,26
28019,Great Britain,1912.0,47,64,59,170
28020,Great Britain,1960.0,2,11,15,28
28021,Great Britain,1906.0,9,22,8,39
28022,Great Britain,1908.0,147,131,90,368
28023,Great Britain,1912.0,47,64,59,170
28024,Great Britain,1912.0,47,64,59,170
28025,Great Britain,1920.0,52,42,17,111
28026,Great Britain,1924.0,31,34,30,95
28027,Great Britain,1928.0,7,27,25,59
28028,Great Britain,1912.0,47,64,59,170
28029,Great Britain,2008.0,31,25,25,81
28030,Great Britain,1956.0,8,16,22,46
28031,Wales-4,1908.0,147,131,90,368
28032,London City Police-1,1908.0,147,131,90,368
28033,Great Britain,1912.0,47,64,59,170
28034,Great Britain,1920.0,52,42,17,111
28035,Great Britain-1,1924.0,31,34,30,95
28036,Great Britain,1988.0,22,17,15,54
28037,Great Britain,1968.0,9,5,5,19
28038,Great Britain,1960.0,2,11,15,28
28039,Great Britain,1920.0,52,42,17,111
28040,England-1,1908.0,147,131,90,368
28041,Great Britain,1920.0,52,42,17,111
28042,Great Britain,1928.0,7,27,25,59
28043,Great Britain,1948.0,7,42,14,63
28044,Great Britain,1912.0,47,64,59,170
28045,Great Britain-2,1908.0,147,131,90,368
28046,Great Britain,2008.0,31,25,25,81
28047,Great Britain,2012.0,48,30,48,126
28048,Great Britain,1964.0,6,19,5,30
28049,Great Britain,1956.0,8,16,22,46
28050,Great Britain,1992.0,8,3,39,50
28051,Great Britain,2012.0,48,30,48,126
28052,Great Britain,2016.0,64,55,26,145
28053,Great Britain,1912.0,47,64,59,170
28054,Great Britain,2016.0,64,55,26,145
28055,Great Britain,2016.0,64,55,26,145
28056,Great Britain-2,1908.0,147,131,90,368
28057,K Division Metropolitan Police Team-3,1908.0,147,131,90,368
28058,Great Britain,1908.0,147,131,90,368
28059,Great Britain,2014.0,1,4,5,10
28060,Great Britain,1984.0,11,20,42,73
28061,Great Britain,1976.0,7,15,11,33
28062,Great Britain,1980.0,6,18,24,48
28063,Great Britain,1984.0,11,20,42,73
28064,Great Britain,1984.0,11,20,42,73
28065,Great Britain,1928.0,7,27,25,59
28066,Great Britain,1908.0,147,131,90,368
28067,Great Britain,1912.0,47,64,59,170
28068,Great Britain,1920.0,52,42,17,111
28069,Great Britain,2008.0,31,25,25,81
28070,Liverpool Police Team-2,1908.0,147,131,90,368
28071,Great Britain,1996.0,2,15,9,26
28072,Great Britain,1908.0,147,131,90,368
28073,Great Britain,1928.0,7,27,25,59
28074,Great Britain,1992.0,8,3,39,50
28075,Great Britain,2008.0,31,25,25,81
28076,Great Britain,2012.0,48,30,48,126
28077,Great Britain,2012.0,48,30,48,126
28078,Great Britain,2016.0,64,55,26,145
28079,Great Britain,1980.0,6,18,24,48
28080,Great Britain,1992.0,8,3,39,50
28081,Great Britain,1996.0,2,15,9,26
28082,Great Britain,1984.0,11,20,42,73
28083,Chuckles,1956.0,8,16,22,46
28084,Moseley Wanderers,1900.0,59,34,15,108
28085,Great Britain,1920.0,52,42,17,111
28086,Great Britain,1928.0,7,27,25,59
28087,Great Britain,1956.0,8,16,22,46
28088,Great Britain-1,1924.0,31,34,30,95
28089,Cornwall,1908.0,147,131,90,368
28090,Cornwall,1908.0,147,131,90,368
28091,Magdalen College Boat Club-1,1908.0,147,131,90,368
28092,Great Britain,1924.0,31,34,30,95
28093,Great Britain,2004.0,17,25,15,57
28094,Great Britain,1928.0,7,27,25,59
28095,Great Britain,1928.0,7,27,25,59
28096,Great Britain,1932.0,9,12,14,35
28097,Great Britain,1928.0,7,27,25,59
28098,Great Britain,1912.0,47,64,59,170
28099,Great Britain,1936.0,24,17,12,53
28100,Great Britain,1912.0,47,64,59,170
28101,Upton Park FC,1900.0,59,34,15,108
28102,Great Britain,1984.0,11,20,42,73
28103,Great Britain,1912.0,47,64,59,170
28104,Mouchette-2,1908.0,147,131,90,368
28105,Great Britain,1908.0,147,131,90,368
28106,Great Britain,1908.0,147,131,90,368
28107,Great Britain,1956.0,8,16,22,46
28108,Great Britain,2008.0,31,25,25,81
28109,Great Britain,1924.0,31,34,30,95
28110,Great Britain,2008.0,31,25,25,81
28111,Great Britain,1912.0,47,64,59,170
28112,Great Britain,1980.0,6,18,24,48
28113,Great Britain,2012.0,48,30,48,126
28114,Great Britain,2016.0,64,55,26,145
28115,"Osborne Swimming Club, Manchester",1900.0,59,34,15,108
28116,Great Britain,1908.0,147,131,90,368
28117,Great Britain,1972.0,8,9,12,29
28118,Great Britain,1976.0,7,15,11,33
28119,Great Britain,1984.0,11,20,42,73
28120,Great Britain,1988.0,22,17,15,54
28121,Great Britain,1988.0,22,17,15,54
28122,Great Britain,2000.0,22,20,12,54
28123,Great Britain,2000.0,22,20,12,54
28124,Great Britain,2004.0,17,25,15,57
28125,Great Britain,2008.0,31,25,25,81
28126,Great Britain,1912.0,47,64,59,170
28127,Great Britain,1992.0,8,3,39,50
28128,Scotland-3,1908.0,147,131,90,368
28129,Great Britain,2008.0,31,25,25,81
28130,Great Britain,1960.0,2,11,15,28
28131,Great Britain,1960.0,2,11,15,28
28132,Great Britain,1912.0,47,64,59,170
28133,Great Britain,1912.0,47,64,59,170
28134,Great Britain,1912.0,47,64,59,170
28135,Great Britain,1928.0,7,27,25,59
28136,Great Britain,1988.0,22,17,15,54
28137,Great Britain,1952.0,4,2,26,32
28138,Great Britain,1972.0,8,9,12,29
28139,Great Britain,1920.0,52,42,17,111
28140,Great Britain,1992.0,8,3,39,50
28141,Great Britain,1920.0,52,42,17,111
28142,Great Britain,1936.0,24,17,12,53
28143,England-1,1912.0,47,64,59,170
28144,Great Britain,1932.0,9,12,14,35
28145,Great Britain,2012.0,48,30,48,126
28146,Great Britain-1,2012.0,48,30,48,126
28147,Great Britain,1992.0,8,3,39,50
28148,Great Britain,1988.0,22,17,15,54
28149,Great Britain,1952.0,4,2,26,32
28150,Great Britain,1984.0,11,20,42,73
28151,Great Britain,1924.0,31,34,30,95
28152,Great Britain,1924.0,31,34,30,95
28153,Cambridge University Boat Club-2,1908.0,147,131,90,368
28154,Great Britain,1936.0,24,17,12,53
28155,Great Britain,1908.0,147,131,90,368
28156,Great Britain,1912.0,47,64,59,170
28157,Great Britain,1928.0,7,27,25,59
28158,Great Britain,1984.0,11,20,42,73
28159,Cobweb-1,1908.0,147,131,90,368
28160,Great Britain,2016.0,64,55,26,145
28161,Leander Club-1,1912.0,47,64,59,170
28162,Great Britain,1920.0,52,42,17,111
28163,Great Britain,1976.0,7,15,11,33
28164,Great Britain,1988.0,22,17,15,54
28165,Liverpool Police Team-2,1908.0,147,131,90,368
28166,Great Britain-2,1908.0,147,131,90,368
28167,Great Britain,1908.0,147,131,90,368
28168,Great Britain-2,1908.0,147,131,90,368
28169,Devon and Somerset Wanderers,1900.0,59,34,15,108
28170,Hera-1,1908.0,147,131,90,368
28171,Moseley Wanderers,1900.0,59,34,15,108
28172,K Division Metropolitan Police Team-3,1908.0,147,131,90,368
28173,Great Britain,1924.0,31,34,30,95
28174,Great Britain,1928.0,7,27,25,59
28175,Great Britain,1906.0,9,22,8,39
28176,Great Britain,1906.0,9,22,8,39
28177,Great Britain,1906.0,9,22,8,39
28178,Great Britain,1908.0,147,131,90,368
28179,Great Britain,1908.0,147,131,90,368
28180,Great Britain,1908.0,147,131,90,368
28181,Great Britain,1912.0,47,64,59,170
28182,Great Britain,1920.0,52,42,17,111
28183,Bona Fide,1900.0,59,34,15,108
28184,Great Britain,1984.0,11,20,42,73
28185,Great Britain,1988.0,22,17,15,54
28186,Great Britain,1952.0,4,2,26,32
28187,Great Britain,2004.0,17,25,15,57
28188,Great Britain,1980.0,6,18,24,48
28189,Union des Socits Franais de Sports Athletiques,1900.0,59,34,15,108
28190,Great Britain,1992.0,8,3,39,50
28191,Great Britain,1992.0,8,3,39,50
28192,Great Britain,2008.0,31,25,25,81
28193,Great Britain,2012.0,48,30,48,126
28194,Great Britain,1908.0,147,131,90,368
28195,Great Britain,1996.0,2,15,9,26
28196,Great Britain,2012.0,48,30,48,126
28197,Great Britain,2012.0,48,30,48,126
28198,Great Britain,1948.0,7,42,14,63
28199,Great Britain,1980.0,6,18,24,48
28200,Great Britain,1984.0,11,20,42,73
28201,Great Britain,1960.0,2,11,15,28
28202,Great Britain,1992.0,8,3,39,50
28203,Great Britain,1948.0,7,42,14,63
28204,Leander Club #1-1,1908.0,147,131,90,368
28205,Leander Club-2,1908.0,147,131,90,368
28206,Great Britain,2004.0,17,25,15,57
28207,Great Britain,2008.0,31,25,25,81
28208,Great Britain,2012.0,48,30,48,126
28209,Great Britain,1920.0,52,42,17,111
28210,Great Britain,2016.0,64,55,26,145
28211,Univ. of Brussels,1900.0,59,34,15,108
28212,Gyrinus-1,1908.0,147,131,90,368
28213,Gyrinus-1,1908.0,147,131,90,368
28214,Great Britain,1908.0,147,131,90,368
28215,Great Britain,2016.0,64,55,26,145
28216,Great Britain,1912.0,47,64,59,170
28217,Great Britain,2008.0,31,25,25,81
28218,Devon and Somerset Wanderers,1900.0,59,34,15,108
28219,Great Britain,1924.0,31,34,30,95
28220,Great Britain-1,1984.0,11,20,42,73
28221,Great Britain,1994.0,0,0,3,3
28222,Great Britain,1980.0,6,18,24,48
28223,Great Britain,2016.0,64,55,26,145
28224,Great Britain,2000.0,22,20,12,54
28225,Cornwall,1908.0,147,131,90,368
28226,Great Britain,1908.0,147,131,90,368
28227,Cornwall,1908.0,147,131,90,368
28228,Great Britain,2008.0,31,25,25,81
28229,Great Britain,2012.0,48,30,48,126
28230,Great Britain,2016.0,64,55,26,145
28231,Great Britain,2012.0,48,30,48,126
28232,Great Britain,2012.0,48,30,48,126
28233,Great Britain,2016.0,64,55,26,145
28234,Great Britain,2016.0,64,55,26,145
28235,Wales-4,1908.0,147,131,90,368
28236,Great Britain-2,1920.0,52,42,17,111
28237,Wales-4,1908.0,147,131,90,368
28238,Upton Park FC,1900.0,59,34,15,108
28239,Great Britain,1972.0,8,9,12,29
28240,Great Britain,2012.0,48,30,48,126
28241,Great Britain,2012.0,48,30,48,126
28242,Great Britain,2016.0,64,55,26,145
28243,Great Britain,1908.0,147,131,90,368
28244,Great Britain,1900.0,59,34,15,108
28245,Amateur Athletic Association,1900.0,59,34,15,108
28246,Great Britain,2012.0,48,30,48,126
28247,Great Britain,2016.0,64,55,26,145
28248,Great Britain,1988.0,22,17,15,54
28249,Great Britain,1932.0,9,12,14,35
28250,Great Britain,1908.0,147,131,90,368
28251,Leander Club #2-2,1908.0,147,131,90,368
28252,Great Britain,2008.0,31,25,25,81
28253,Thames Rowing Club,1912.0,47,64,59,170
28254,Great Britain,1960.0,2,11,15,28
28255,Great Britain,1912.0,47,64,59,170
28256,Great Britain,1908.0,147,131,90,368
28257,Great Britain,1920.0,52,42,17,111
28258,Great Britain,1924.0,31,34,30,95
28259,Great Britain,1912.0,47,64,59,170
28260,Great Britain,1948.0,7,42,14,63
28261,Great Britain,2016.0,64,55,26,145
28262,Scotland-3,1908.0,147,131,90,368
28263,Great Britain,1996.0,2,15,9,26
28264,Great Britain,2000.0,22,20,12,54
28265,"New College, Oxford-2",1912.0,47,64,59,170
28266,Great Britain,1912.0,47,64,59,170
28267,Great Britain,2016.0,64,55,26,145
28268,Great Britain,2016.0,64,55,26,145
28269,Great Britain,1908.0,147,131,90,368
28270,Moseley Wanderers,1900.0,59,34,15,108
28271,Great Britain,2004.0,17,25,15,57
28272,Great Britain,2012.0,48,30,48,126
28273,Great Britain,1998.0,0,0,4,4
28274,Sorais-2,1908.0,147,131,90,368
28275,Great Britain,1964.0,6,19,5,30
28276,Bohemia/Great Britain,1900.0,59,34,15,108
28277,Great Britain,1972.0,8,9,12,29
28278,Great Britain,1928.0,7,27,25,59
28279,Great Britain,2004.0,17,25,15,57
28280,Great Britain,1948.0,7,42,14,63
28281,Great Britain,1988.0,22,17,15,54
28282,Great Britain,2016.0,64,55,26,145
28283,Great Britain,1908.0,147,131,90,368
28284,Great Britain,1908.0,147,131,90,368
28285,Great Britain,1912.0,47,64,59,170
28286,Great Britain,2016.0,64,55,26,145
28287,Great Britain,2004.0,17,25,15,57
28288,Great Britain,2008.0,31,25,25,81
28289,Great Britain,1932.0,9,12,14,35
28290,Great Britain,1908.0,147,131,90,368
28291,Great Britain,1924.0,31,34,30,95
28292,Cornwall,1908.0,147,131,90,368
28293,Great Britain,1956.0,8,16,22,46
28294,Great Britain,1956.0,8,16,22,46
28295,Great Britain,1980.0,6,18,24,48
28296,Great Britain,1980.0,6,18,24,48
28297,Great Britain,1984.0,11,20,42,73
28298,Leander Club-1,1912.0,47,64,59,170
28299,Great Britain,2008.0,31,25,25,81
28300,Great Britain,1924.0,31,34,30,95
28301,Great Britain,1928.0,7,27,25,59
28302,Great Britain,2008.0,31,25,25,81
28303,Great Britain,2000.0,22,20,12,54
28304,Great Britain,1984.0,11,20,42,73
28305,Great Britain,1956.0,8,16,22,46
28306,Great Britain-2,1908.0,147,131,90,368
28307,Great Britain,1912.0,47,64,59,170
28308,Great Britain,1984.0,11,20,42,73
28309,Great Britain,1912.0,47,64,59,170
28310,Great Britain,1984.0,11,20,42,73
28311,Great Britain,1984.0,11,20,42,73
28312,Great Britain,1988.0,22,17,15,54
28313,Great Britain,1920.0,52,42,17,111
28314,Great Britain,1912.0,47,64,59,170
28315,Great Britain,1948.0,7,42,14,63
28316,Great Britain,2012.0,48,30,48,126
28317,Great Britain,2016.0,64,55,26,145
28318,Great Britain,1976.0,7,15,11,33
28319,Great Britain,1952.0,4,2,26,32
28320,Great Britain,1956.0,8,16,22,46
28321,Great Britain,1960.0,2,11,15,28
28322,Great Britain,1908.0,147,131,90,368
28323,Great Britain,1936.0,24,17,12,53
28324,Great Britain,2012.0,48,30,48,126
28325,Great Britain,2012.0,48,30,48,126
28326,Great Britain,2016.0,64,55,26,145
28327,Great Britain,2016.0,64,55,26,145
28328,Great Britain,2016.0,64,55,26,145
28329,Smyrna,1906.0,9,22,8,39
28330,Smyrna,1906.0,9,22,8,39
28331,Smyrna,1906.0,9,22,8,39
28332,Smyrna,1906.0,9,22,8,39
28333,Smyrna,1906.0,9,22,8,39
28334,Moseley Wanderers,1900.0,59,34,15,108
28335,Moseley Wanderers,1900.0,59,34,15,108
28336,Great Britain,1924.0,31,34,30,95
28337,Great Britain,1980.0,6,18,24,48
28338,Great Britain,1980.0,6,18,24,48
28339,"New College, Oxford-2",1912.0,47,64,59,170
28340,Great Britain,2000.0,22,20,12,54
28341,Great Britain,2004.0,17,25,15,57
28342,Great Britain,2004.0,17,25,15,57
28343,Great Britain,2004.0,17,25,15,57
28344,Great Britain,2008.0,31,25,25,81
28345,Great Britain,2008.0,31,25,25,81
28346,Great Britain,2012.0,48,30,48,126
28347,Great Britain,2016.0,64,55,26,145
28348,Great Britain,1972.0,8,9,12,29
28349,Great Britain,1976.0,7,15,11,33
28350,Great Britain,1976.0,7,15,11,33
28351,Great Britain,1920.0,52,42,17,111
28352,Great Britain,1908.0,147,131,90,368
28353,Great Britain,1912.0,47,64,59,170
28354,Cornwall,1908.0,147,131,90,368
28355,Great Britain,2010.0,1,0,0,1
28356,Great Britain-1,1920.0,52,42,17,111
28357,Cambridge University Boat Club-2,1908.0,147,131,90,368
28358,Wales-4,1908.0,147,131,90,368
28359,Great Britain,2012.0,48,30,48,126
28360,Great Britain,2004.0,17,25,15,57
28361,Great Britain,2008.0,31,25,25,81
28362,Great Britain,2004.0,17,25,15,57
28363,Great Britain,1948.0,7,42,14,63
28364,Great Britain,1980.0,6,18,24,48
28365,Cornwall,1908.0,147,131,90,368
28366,Moseley Wanderers,1900.0,59,34,15,108
28367,Great Britain,1908.0,147,131,90,368
28368,Great Britain,1908.0,147,131,90,368
28369,Roehampton-1,1908.0,147,131,90,368
28370,Great Britain,1948.0,7,42,14,63
28371,Great Britain,1920.0,52,42,17,111
28372,Great Britain,1920.0,52,42,17,111
28373,Great Britain,2016.0,64,55,26,145
28374,Great Britain,2012.0,48,30,48,126
28375,Great Britain,2016.0,64,55,26,145
28376,Great Britain,2012.0,48,30,48,126
28377,Great Britain,2008.0,31,25,25,81
28378,Great Britain,2016.0,64,55,26,145
28379,Great Britain,1908.0,147,131,90,368
28380,Great Britain,2004.0,17,25,15,57
28381,Great Britain,1924.0,31,34,30,95
28382,Hurlingham-2,1908.0,147,131,90,368
28383,Great Britain,1920.0,52,42,17,111
28384,Great Britain,1936.0,24,17,12,53
28385,Cobweb-1,1908.0,147,131,90,368
28386,England-1,1908.0,147,131,90,368
28387,Great Britain,1908.0,147,131,90,368
28388,K Division Metropolitan Police Team-3,1908.0,147,131,90,368
28389,Great Britain,1988.0,22,17,15,54
28390,Great Britain,1968.0,9,5,5,19
28391,Great Britain,1928.0,7,27,25,59
28392,Great Britain,1908.0,147,131,90,368
28393,Great Britain,1912.0,47,64,59,170
28394,Great Britain-3,1920.0,52,42,17,111
28395,Great Britain-2,1920.0,52,42,17,111
28396,Leander Club-1,1912.0,47,64,59,170
28397,Ancora,1920.0,52,42,17,111
28398,Ancora,1920.0,52,42,17,111
28399,Great Britain,1912.0,47,64,59,170
28400,Great Britain,1948.0,7,42,14,63
28401,Great Britain,1920.0,52,42,17,111
28402,Great Britain-2,2000.0,22,20,12,54
28403,Great Britain,1924.0,31,34,30,95
28404,Great Britain,1928.0,7,27,25,59
28405,Great Britain,1928.0,7,27,25,59
28406,Great Britain,1928.0,7,27,25,59
28407,Great Britain,1936.0,24,17,12,53
28408,Great Britain,2004.0,17,25,15,57
28409,Great Britain,1976.0,7,15,11,33
28410,Great Britain,2014.0,1,4,5,10
28411,Upton Park FC,1900.0,59,34,15,108
28412,Jordan,2016.0,1,0,0,1
28413,Romania,2008.0,5,1,16,22
28414,Romania,1976.0,4,28,23,55
28415,Romania,1984.0,40,31,35,106
28416,Romania,1984.0,40,31,35,106
28417,Romania,1980.0,7,15,46,68
28418,Romania,1972.0,3,10,27,40
28419,Romania,1996.0,13,10,15,38
28420,Romania,1996.0,13,10,15,38
28421,Romania,1996.0,13,10,15,38
28422,Romania,1996.0,13,10,15,38
28423,Romania,2000.0,27,6,13,46
28424,Romania,2000.0,27,6,13,46
28425,Romania,2000.0,27,6,13,46
28426,Romania,1980.0,7,15,46,68
28427,Romania,1984.0,40,31,35,106
28428,Romania,1996.0,13,10,15,38
28429,Romania,1988.0,8,34,16,58
28430,Romania,1988.0,8,34,16,58
28431,Romania,1980.0,7,15,46,68
28432,Romania,1984.0,40,31,35,106
28433,Romania,1980.0,7,15,46,68
28434,Romania,1984.0,40,31,35,106
28435,Romania,1988.0,8,34,16,58
28436,Romania,1988.0,8,34,16,58
28437,Romania,1924.0,0,0,16,16
28438,Romania,1984.0,40,31,35,106
28439,Romania,1988.0,8,34,16,58
28440,Romania,1988.0,8,34,16,58
28441,Romania,1992.0,8,31,14,53
28442,Romania,1988.0,8,34,16,58
28443,Romania,1992.0,8,31,14,53
28444,Romania,1968.0,5,9,11,25
28445,Romania,1984.0,40,31,35,106
28446,Romania,1988.0,8,34,16,58
28447,Romania,1992.0,8,31,14,53
28448,Romania,1960.0,3,1,11,15
28449,Romania,1964.0,2,4,10,16
28450,Romania,2004.0,23,5,11,39
28451,Romania,2008.0,5,1,16,22
28452,Romania,1984.0,40,31,35,106
28453,Romania,2000.0,27,6,13,46
28454,Romania,1984.0,40,31,35,106
28455,Romania,1924.0,0,0,16,16
28456,Romania,1984.0,40,31,35,106
28457,Romania,1972.0,3,10,27,40
28458,Romania,1976.0,4,28,23,55
28459,Romania,2016.0,4,2,10,16
28460,Romania,1984.0,40,31,35,106
28461,Romania,1984.0,40,31,35,106
28462,Romania,1980.0,7,15,46,68
28463,Romania,1972.0,3,10,27,40
28464,Romania,1976.0,4,28,23,55
28465,Romania,1980.0,7,15,46,68
28466,Romania,1992.0,8,31,14,53
28467,Romania,2000.0,27,6,13,46
28468,Romania,2016.0,4,2,10,16
28469,Romania,1980.0,7,15,46,68
28470,Romania,1992.0,8,31,14,53
28471,Romania,1992.0,8,31,14,53
28472,Romania,1980.0,7,15,46,68
28473,Romania,1984.0,40,31,35,106
28474,Romania,1996.0,13,10,15,38
28475,Romania,2008.0,5,1,16,22
28476,Romania,2016.0,4,2,10,16
28477,Romania,1980.0,7,15,46,68
28478,Romania,1972.0,3,10,27,40
28479,Romania,1964.0,2,4,10,16
28480,Romania,1984.0,40,31,35,106
28481,Romania,2012.0,2,8,6,16
28482,Romania,1996.0,13,10,15,38
28483,Romania,1968.0,5,9,11,25
28484,Romania,2012.0,2,8,6,16
28485,Romania,1980.0,7,15,46,68
28486,Romania,1992.0,8,31,14,53
28487,Romania,1996.0,13,10,15,38
28488,Romania,1996.0,13,10,15,38
28489,Romania,1972.0,3,10,27,40
28490,Romania,1960.0,3,1,11,15
28491,Romania,1964.0,2,4,10,16
28492,Romania,1984.0,40,31,35,106
28493,Romania,1988.0,8,34,16,58
28494,Romania,1988.0,8,34,16,58
28495,Romania,1992.0,8,31,14,53
28496,Romania,2012.0,2,8,6,16
28497,Romania,1984.0,40,31,35,106
28498,Romania,1980.0,7,15,46,68
28499,Romania,2004.0,23,5,11,39
28500,Romania,1980.0,7,15,46,68
28501,Romania,1992.0,8,31,14,53
28502,Romania,1984.0,40,31,35,106
28503,Romania,2004.0,23,5,11,39
28504,Romania,1984.0,40,31,35,106
28505,Romania,1980.0,7,15,46,68
28506,Romania,1988.0,8,34,16,58
28507,Romania,1992.0,8,31,14,53
28508,Romania,2000.0,27,6,13,46
28509,Romania,2000.0,27,6,13,46
28510,Romania,2012.0,2,8,6,16
28511,Romania,1976.0,4,28,23,55
28512,Romania,1988.0,8,34,16,58
28513,Romania,1988.0,8,34,16,58
28514,Romania,1992.0,8,31,14,53
28515,Romania,1992.0,8,31,14,53
28516,Romania,1996.0,13,10,15,38
28517,Romania,2000.0,27,6,13,46
28518,Romania,2016.0,4,2,10,16
28519,Romania,2016.0,4,2,10,16
28520,Romania,1984.0,40,31,35,106
28521,Romania,1976.0,4,28,23,55
28522,Romania,1976.0,4,28,23,55
28523,Romania,1976.0,4,28,23,55
28524,Romania,1976.0,4,28,23,55
28525,Romania,1976.0,4,28,23,55
28526,Romania,1980.0,7,15,46,68
28527,Romania,1980.0,7,15,46,68
28528,Romania,1980.0,7,15,46,68
28529,Romania,1980.0,7,15,46,68
28530,Romania,1976.0,4,28,23,55
28531,Romania,1980.0,7,15,46,68
28532,Romania,1984.0,40,31,35,106
28533,Romania,1972.0,3,10,27,40
28534,Romania,1976.0,4,28,23,55
28535,Romania,1980.0,7,15,46,68
28536,Romania,1984.0,40,31,35,106
28537,Romania,1968.0,5,9,11,25
28538,Romania,1972.0,3,10,27,40
28539,Romania,2000.0,27,6,13,46
28540,Romania,2008.0,5,1,16,22
28541,Romania,1964.0,2,4,10,16
28542,Romania,1984.0,40,31,35,106
28543,Romania,1968.0,5,9,11,25
28544,Romania,1976.0,4,28,23,55
28545,Romania,1976.0,4,28,23,55
28546,Romania,2000.0,27,6,13,46
28547,Romania,2000.0,27,6,13,46
28548,Romania,2004.0,23,5,11,39
28549,Romania,2004.0,23,5,11,39
28550,Romania,2008.0,5,1,16,22
28551,Romania,2008.0,5,1,16,22
28552,Romania,1984.0,40,31,35,106
28553,Romania,1976.0,4,28,23,55
28554,Romania,1968.0,5,9,11,25
28555,Romania,1972.0,3,10,27,40
28556,Romania,1984.0,40,31,35,106
28557,Romania,1976.0,4,28,23,55
28558,Romania,1976.0,4,28,23,55
28559,Romania,1980.0,7,15,46,68
28560,Romania,1980.0,7,15,46,68
28561,Romania,1980.0,7,15,46,68
28562,Romania,1972.0,3,10,27,40
28563,Romania,2016.0,4,2,10,16
28564,Romania,2008.0,5,1,16,22
28565,Romania,1988.0,8,34,16,58
28566,Romania,1988.0,8,34,16,58
28567,Romania,1992.0,8,31,14,53
28568,Romania,1956.0,6,3,10,19
28569,Romania,1980.0,7,15,46,68
28570,Romania,1984.0,40,31,35,106
28571,Romania,1972.0,3,10,27,40
28572,Romania,1984.0,40,31,35,106
28573,Romania,2012.0,2,8,6,16
28574,Romania,1980.0,7,15,46,68
28575,Romania,1992.0,8,31,14,53
28576,Romania,1996.0,13,10,15,38
28577,Romania,1976.0,4,28,23,55
28578,Romania,1980.0,7,15,46,68
28579,Romania,2008.0,5,1,16,22
28580,Romania,2004.0,23,5,11,39
28581,Romania,2004.0,23,5,11,39
28582,Romania,2004.0,23,5,11,39
28583,Romania,1984.0,40,31,35,106
28584,Romania,1968.0,5,9,11,25
28585,Romania,2016.0,4,2,10,16
28586,Romania,1980.0,7,15,46,68
28587,Romania,2000.0,27,6,13,46
28588,Romania,1956.0,6,3,10,19
28589,Romania,1988.0,8,34,16,58
28590,Romania,1960.0,3,1,11,15
28591,Romania,2012.0,2,8,6,16
28592,Romania,1992.0,8,31,14,53
28593,Romania,1956.0,6,3,10,19
28594,Romania,2008.0,5,1,16,22
28595,Romania,2012.0,2,8,6,16
28596,Romania,1980.0,7,15,46,68
28597,Romania,1984.0,40,31,35,106
28598,Romania,1984.0,40,31,35,106
28599,Romania,1968.0,5,9,11,25
28600,Romania,1972.0,3,10,27,40
28601,Romania,1980.0,7,15,46,68
28602,Romania,1980.0,7,15,46,68
28603,Romania,1984.0,40,31,35,106
28604,Romania,1980.0,7,15,46,68
28605,Romania,1980.0,7,15,46,68
28606,Romania,1980.0,7,15,46,68
28607,Romania,2004.0,23,5,11,39
28608,Romania,2004.0,23,5,11,39
28609,Romania,1980.0,7,15,46,68
28610,Romania,1952.0,1,1,2,4
28611,Romania,2004.0,23,5,11,39
28612,Romania,2004.0,23,5,11,39
28613,Romania,2008.0,5,1,16,22
28614,Romania,1924.0,0,0,16,16
28615,Romania,1976.0,4,28,23,55
28616,Romania,1980.0,7,15,46,68
28617,Romania,1984.0,40,31,35,106
28618,Romania,1984.0,40,31,35,106
28619,Romania,1980.0,7,15,46,68
28620,Romania,1984.0,40,31,35,106
28621,Romania,1976.0,4,28,23,55
28622,Romania,1996.0,13,10,15,38
28623,Romania,2000.0,27,6,13,46
28624,Romania,2004.0,23,5,11,39
28625,Romania,1972.0,3,10,27,40
28626,Romania,1976.0,4,28,23,55
28627,Romania,1980.0,7,15,46,68
28628,Romania,1988.0,8,34,16,58
28629,Romania,1992.0,8,31,14,53
28630,Romania,1996.0,13,10,15,38
28631,Romania,2000.0,27,6,13,46
28632,Romania,2004.0,23,5,11,39
28633,Romania,2008.0,5,1,16,22
28634,Romania,2004.0,23,5,11,39
28635,Romania,1988.0,8,34,16,58
28636,Romania,1992.0,8,31,14,53
28637,Romania,1988.0,8,34,16,58
28638,Romania,2016.0,4,2,10,16
28639,Romania,1976.0,4,28,23,55
28640,Romania,1980.0,7,15,46,68
28641,Romania,1924.0,0,0,16,16
28642,Romania,1976.0,4,28,23,55
28643,Romania,1996.0,13,10,15,38
28644,Romania,1992.0,8,31,14,53
28645,Romania,1996.0,13,10,15,38
28646,Romania,1996.0,13,10,15,38
28647,Romania,1996.0,13,10,15,38
28648,Romania,1996.0,13,10,15,38
28649,Romania,1988.0,8,34,16,58
28650,Romania,1976.0,4,28,23,55
28651,Romania,1976.0,4,28,23,55
28652,Romania,1976.0,4,28,23,55
28653,Romania,1980.0,7,15,46,68
28654,Romania,1984.0,40,31,35,106
28655,Romania,1992.0,8,31,14,53
28656,Romania,2008.0,5,1,16,22
28657,Romania,1992.0,8,31,14,53
28658,Romania,1984.0,40,31,35,106
28659,Romania,1972.0,3,10,27,40
28660,Romania,1972.0,3,10,27,40
28661,Romania,1976.0,4,28,23,55
28662,Romania,1984.0,40,31,35,106
28663,Romania,1992.0,8,31,14,53
28664,Romania,1968.0,5,9,11,25
28665,Romania,1972.0,3,10,27,40
28666,Romania,1992.0,8,31,14,53
28667,Romania,1980.0,7,15,46,68
28668,Romania,1984.0,40,31,35,106
28669,Romania,1988.0,8,34,16,58
28670,Romania,1988.0,8,34,16,58
28671,Romania,1956.0,6,3,10,19
28672,Romania,1956.0,6,3,10,19
28673,Romania,1992.0,8,31,14,53
28674,Romania,1996.0,13,10,15,38
28675,Romania,2000.0,27,6,13,46
28676,Romania,2000.0,27,6,13,46
28677,Romania,2004.0,23,5,11,39
28678,Romania,2008.0,5,1,16,22
28679,Romania,1964.0,2,4,10,16
28680,Romania,1988.0,8,34,16,58
28681,Romania,1980.0,7,15,46,68
28682,Romania,1984.0,40,31,35,106
28683,Romania,1984.0,40,31,35,106
28684,Romania,1980.0,7,15,46,68
28685,Romania,1984.0,40,31,35,106
28686,Romania,1960.0,3,1,11,15
28687,Romania,1980.0,7,15,46,68
28688,Romania,1984.0,40,31,35,106
28689,Romania,2000.0,27,6,13,46
28690,Romania,2012.0,2,8,6,16
28691,Romania,1972.0,3,10,27,40
28692,Romania,1984.0,40,31,35,106
28693,Romania,1956.0,6,3,10,19
28694,Romania,1960.0,3,1,11,15
28695,Romania,1976.0,4,28,23,55
28696,Romania,2000.0,27,6,13,46
28697,Romania,1956.0,6,3,10,19
28698,Romania,1972.0,3,10,27,40
28699,Romania,1988.0,8,34,16,58
28700,Romania,1988.0,8,34,16,58
28701,Romania,1968.0,5,9,11,25
28702,Romania,1968.0,5,9,11,25
28703,Romania,2008.0,5,1,16,22
28704,Romania,2008.0,5,1,16,22
28705,Romania,2012.0,2,8,6,16
28706,Romania,2012.0,2,8,6,16
28707,Romania,1972.0,3,10,27,40
28708,Romania,1976.0,4,28,23,55
28709,Romania,1964.0,2,4,10,16
28710,Romania,1964.0,2,4,10,16
28711,Romania,1984.0,40,31,35,106
28712,Romania,1976.0,4,28,23,55
28713,Romania,1992.0,8,31,14,53
28714,Romania,1996.0,13,10,15,38
28715,Romania,1992.0,8,31,14,53
28716,Romania,1956.0,6,3,10,19
28717,Romania,1956.0,6,3,10,19
28718,Romania,1960.0,3,1,11,15
28719,Romania,1952.0,1,1,2,4
28720,Romania,1956.0,6,3,10,19
28721,Romania,1972.0,3,10,27,40
28722,Romania,1976.0,4,28,23,55
28723,Romania,2000.0,27,6,13,46
28724,Romania,1956.0,6,3,10,19
28725,Romania,1996.0,13,10,15,38
28726,Romania,1984.0,40,31,35,106
28727,Romania,1984.0,40,31,35,106
28728,Romania,1972.0,3,10,27,40
28729,Romania,1988.0,8,34,16,58
28730,Romania,1988.0,8,34,16,58
28731,Romania,1988.0,8,34,16,58
28732,Romania,1980.0,7,15,46,68
28733,Romania,1996.0,13,10,15,38
28734,Romania,1976.0,4,28,23,55
28735,Romania,1960.0,3,1,11,15
28736,Romania,1964.0,2,4,10,16
28737,Romania,1968.0,5,9,11,25
28738,Romania,1924.0,0,0,16,16
28739,Romania,1956.0,6,3,10,19
28740,Romania,1960.0,3,1,11,15
28741,Romania,1924.0,0,0,16,16
28742,Romania,1976.0,4,28,23,55
28743,Romania,1984.0,40,31,35,106
28744,Romania,1972.0,3,10,27,40
28745,Romania,1992.0,8,31,14,53
28746,Romania,1996.0,13,10,15,38
28747,Romania,1984.0,40,31,35,106
28748,Romania,2012.0,2,8,6,16
28749,Romania,1968.0,5,9,11,25
28750,Romania,1972.0,3,10,27,40
28751,Romania,1992.0,8,31,14,53
28752,Romania,1984.0,40,31,35,106
28753,Romania,1976.0,4,28,23,55
28754,Romania,1972.0,3,10,27,40
28755,Romania,2016.0,4,2,10,16
28756,Romania,1976.0,4,28,23,55
28757,Romania,1924.0,0,0,16,16
28758,Romania,1984.0,40,31,35,106
28759,Romania,1992.0,8,31,14,53
28760,Romania,1992.0,8,31,14,53
28761,Romania,1992.0,8,31,14,53
28762,Romania,1992.0,8,31,14,53
28763,Romania,1996.0,13,10,15,38
28764,Romania,1996.0,13,10,15,38
28765,Romania,2000.0,27,6,13,46
28766,Romania,2000.0,27,6,13,46
28767,Romania,1984.0,40,31,35,106
28768,Romania,2012.0,2,8,6,16
28769,Romania,1960.0,3,1,11,15
28770,Romania,1968.0,5,9,11,25
28771,Romania,1976.0,4,28,23,55
28772,Romania,1976.0,4,28,23,55
28773,Romania,1980.0,7,15,46,68
28774,Romania,1984.0,40,31,35,106
28775,Romania,1976.0,4,28,23,55
28776,Romania,1984.0,40,31,35,106
28777,Romania,2000.0,27,6,13,46
28778,Romania,1976.0,4,28,23,55
28779,Romania,1992.0,8,31,14,53
28780,Romania-1,1968.0,5,9,11,25
28781,Romania,1988.0,8,34,16,58
28782,Romania,1988.0,8,34,16,58
28783,Romania,1988.0,8,34,16,58
28784,Romania,1992.0,8,31,14,53
28785,Romania,1992.0,8,31,14,53
28786,Romania,1924.0,0,0,16,16
28787,Romania,1956.0,6,3,10,19
28788,Romania,1924.0,0,0,16,16
28789,Romania,1972.0,3,10,27,40
28790,Romania,1984.0,40,31,35,106
28791,Romania,1976.0,4,28,23,55
28792,Romania,2008.0,5,1,16,22
28793,Romania,1984.0,40,31,35,106
28794,Romania,1988.0,8,34,16,58
28795,Romania,1988.0,8,34,16,58
28796,Romania,1996.0,13,10,15,38
28797,Romania,1984.0,40,31,35,106
28798,Romania,2000.0,27,6,13,46
28799,Romania,2000.0,27,6,13,46
28800,Romania,1984.0,40,31,35,106
28801,Romania,1988.0,8,34,16,58
28802,Romania,1988.0,8,34,16,58
28803,Romania,1992.0,8,31,14,53
28804,Romania,1992.0,8,31,14,53
28805,Romania,1996.0,13,10,15,38
28806,Romania,2000.0,27,6,13,46
28807,Romania,2004.0,23,5,11,39
28808,Romania,1992.0,8,31,14,53
28809,Romania,1996.0,13,10,15,38
28810,Romania,2000.0,27,6,13,46
28811,Romania,2016.0,4,2,10,16
28812,Romania,2004.0,23,5,11,39
28813,Romania,1984.0,40,31,35,106
28814,Romania,1984.0,40,31,35,106
28815,Romania,1956.0,6,3,10,19
28816,Romania,1968.0,5,9,11,25
28817,Romania,1972.0,3,10,27,40
28818,Romania,1984.0,40,31,35,106
28819,Romania,1980.0,7,15,46,68
28820,Romania,1984.0,40,31,35,106
28821,Romania,1992.0,8,31,14,53
28822,Romania-1,1968.0,5,9,11,25
28823,Romania,2004.0,23,5,11,39
28824,Romania,2008.0,5,1,16,22
28825,Romania,1992.0,8,31,14,53
28826,Romania,1984.0,40,31,35,106
28827,Romania,1968.0,5,9,11,25
28828,Romania,1972.0,3,10,27,40
28829,Romania,1972.0,3,10,27,40
28830,Romania,1980.0,7,15,46,68
28831,Romania,1980.0,7,15,46,68
28832,Romania,1984.0,40,31,35,106
28833,Romania,1984.0,40,31,35,106
28834,Romania,1984.0,40,31,35,106
28835,Romania,1984.0,40,31,35,106
28836,Romania,1984.0,40,31,35,106
28837,Romania,1964.0,2,4,10,16
28838,Romania,1968.0,5,9,11,25
28839,Romania,1972.0,3,10,27,40
28840,Romania,1976.0,4,28,23,55
28841,Romania,1956.0,6,3,10,19
28842,Romania,2016.0,4,2,10,16
28843,Romania,1992.0,8,31,14,53
28844,Romania,1996.0,13,10,15,38
28845,Romania,2000.0,27,6,13,46
28846,Romania,2004.0,23,5,11,39
28847,Romania,2008.0,5,1,16,22
28848,Romania,1960.0,3,1,11,15
28849,Romania,1964.0,2,4,10,16
28850,Romania,1984.0,40,31,35,106
28851,Romania,2004.0,23,5,11,39
28852,Romania,2004.0,23,5,11,39
28853,Romania,2004.0,23,5,11,39
28854,Romania,2012.0,2,8,6,16
28855,Romania,2012.0,2,8,6,16
28856,Romania,1976.0,4,28,23,55
28857,Romania,1984.0,40,31,35,106
28858,Romania,1980.0,7,15,46,68
28859,Romania,2016.0,4,2,10,16
28860,Romania,1988.0,8,34,16,58
28861,Romania,2016.0,4,2,10,16
28862,Romania,2004.0,23,5,11,39
28863,Romania,1984.0,40,31,35,106
28864,Romania,1988.0,8,34,16,58
28865,Romania,1992.0,8,31,14,53
28866,Romania,1992.0,8,31,14,53
28867,Romania,2000.0,27,6,13,46
28868,Romania,2000.0,27,6,13,46
28869,Romania,1968.0,5,9,11,25
28870,Romania,1984.0,40,31,35,106
28871,Romania,1996.0,13,10,15,38
28872,Romania,1960.0,3,1,11,15
28873,Romania,2004.0,23,5,11,39
28874,Romania,1988.0,8,34,16,58
28875,Romania,1988.0,8,34,16,58
28876,Romania,1988.0,8,34,16,58
28877,Romania,2004.0,23,5,11,39
28878,Romania,1980.0,7,15,46,68
28879,Romania,2000.0,27,6,13,46
28880,Romania,2000.0,27,6,13,46
28881,Romania,2000.0,27,6,13,46
28882,Romania,1984.0,40,31,35,106
28883,Romania,1984.0,40,31,35,106
28884,Romania,1984.0,40,31,35,106
28885,Romania,1988.0,8,34,16,58
28886,Romania,2000.0,27,6,13,46
28887,Romania,1984.0,40,31,35,106
28888,Romania,2000.0,27,6,13,46
28889,Romania,2000.0,27,6,13,46
28890,Romania,1984.0,40,31,35,106
28891,Romania,1992.0,8,31,14,53
28892,Romania,1992.0,8,31,14,53
28893,Romania,2000.0,27,6,13,46
28894,Romania,1936.0,0,1,0,1
28895,Romania,2000.0,27,6,13,46
28896,Romania,1988.0,8,34,16,58
28897,Romania,1992.0,8,31,14,53
28898,Romania,1968.0,5,9,11,25
28899,Romania,1980.0,7,15,46,68
28900,Romania,1980.0,7,15,46,68
28901,Romania,1984.0,40,31,35,106
28902,Romania,2004.0,23,5,11,39
28903,Romania,2004.0,23,5,11,39
28904,Romania,1972.0,3,10,27,40
28905,Romania,1956.0,6,3,10,19
28906,Romania,1956.0,6,3,10,19
28907,Romania,1960.0,3,1,11,15
28908,Romania,1980.0,7,15,46,68
28909,Romania,1980.0,7,15,46,68
28910,Romania,1980.0,7,15,46,68
28911,Romania,1992.0,8,31,14,53
28912,Romania,1992.0,8,31,14,53
28913,Romania,1976.0,4,28,23,55
28914,Romania,1980.0,7,15,46,68
28915,Romania,1984.0,40,31,35,106
28916,Romania,1956.0,6,3,10,19
28917,Romania,1972.0,3,10,27,40
28918,Romania,2016.0,4,2,10,16
28919,Romania,1984.0,40,31,35,106
28920,Romania,1996.0,13,10,15,38
28921,Romania,1972.0,3,10,27,40
28922,Romania,1964.0,2,4,10,16
28923,Romania,1972.0,3,10,27,40
28924,Romania,2004.0,23,5,11,39
28925,Romania,1976.0,4,28,23,55
28926,Romania,1924.0,0,0,16,16
28927,Romania,1924.0,0,0,16,16
28928,Romania,1964.0,2,4,10,16
28929,Romania,1980.0,7,15,46,68
28930,Romania,1968.0,5,9,11,25
28931,Romania,1988.0,8,34,16,58
28932,Romania,1988.0,8,34,16,58
28933,Romania,1988.0,8,34,16,58
28934,Romania,1988.0,8,34,16,58
28935,Romania,1988.0,8,34,16,58
28936,Romania,1988.0,8,34,16,58
28937,Romania,1984.0,40,31,35,106
28938,Romania,2000.0,27,6,13,46
28939,Romania,1996.0,13,10,15,38
28940,Romania,2000.0,27,6,13,46
28941,Romania,1976.0,4,28,23,55
28942,Romania,1976.0,4,28,23,55
28943,Romania,1980.0,7,15,46,68
28944,Romania,1984.0,40,31,35,106
28945,Romania,1984.0,40,31,35,106
28946,Romania,1976.0,4,28,23,55
28947,Romania,2000.0,27,6,13,46
28948,Romania,1952.0,1,1,2,4
28949,Romania,2012.0,2,8,6,16
28950,Romania,1988.0,8,34,16,58
28951,Romania,1984.0,40,31,35,106
28952,Romania,1988.0,8,34,16,58
28953,Romania,1988.0,8,34,16,58
28954,Romania,1992.0,8,31,14,53
28955,Romania,1984.0,40,31,35,106
28956,Romania,2004.0,23,5,11,39
28957,Romania,2004.0,23,5,11,39
28958,Romania,1984.0,40,31,35,106
28959,Romania,1988.0,8,34,16,58
28960,Romania,1996.0,13,10,15,38
28961,Romania,1968.0,5,9,11,25
28962,Romania,1972.0,3,10,27,40
28963,Romania,1984.0,40,31,35,106
28964,Romania,1984.0,40,31,35,106
28965,Romania,1984.0,40,31,35,106
28966,Romania,1984.0,40,31,35,106
28967,Romania,1980.0,7,15,46,68
28968,Romania,1924.0,0,0,16,16
28969,Romania,1980.0,7,15,46,68
28970,Romania,1984.0,40,31,35,106
28971,Romania,1972.0,3,10,27,40
28972,Romania,1976.0,4,28,23,55
28973,Romania,1980.0,7,15,46,68
28974,Romania,2008.0,5,1,16,22
28975,Romania,2004.0,23,5,11,39
28976,Romania,2016.0,4,2,10,16
28977,Romania,2004.0,23,5,11,39
28978,Romania,2000.0,27,6,13,46
28979,Romania,2004.0,23,5,11,39
28980,Romania,2004.0,23,5,11,39
28981,Romania,2008.0,5,1,16,22
28982,Romania,2008.0,5,1,16,22
28983,Romania,1984.0,40,31,35,106
28984,Romania,1984.0,40,31,35,106
28985,Romania,1984.0,40,31,35,106
28986,Romania,1984.0,40,31,35,106
28987,Romania,1984.0,40,31,35,106
28988,Romania,1996.0,13,10,15,38
28989,Romania,2000.0,27,6,13,46
28990,Romania,2000.0,27,6,13,46
28991,Romania,1984.0,40,31,35,106
28992,Romania,1984.0,40,31,35,106
28993,Romania,1992.0,8,31,14,53
28994,Romania,1992.0,8,31,14,53
28995,Romania,1992.0,8,31,14,53
28996,Romania,1992.0,8,31,14,53
28997,Romania,2008.0,5,1,16,22
28998,Romania,2000.0,27,6,13,46
28999,Romania,2004.0,23,5,11,39
29000,Romania,1984.0,40,31,35,106
29001,Romania,1996.0,13,10,15,38
29002,Romania,1924.0,0,0,16,16
29003,Romania,1984.0,40,31,35,106
29004,Romania,1960.0,3,1,11,15
29005,Romania,2004.0,23,5,11,39
29006,Romania,1984.0,40,31,35,106
29007,Romania,2016.0,4,2,10,16
29008,Romania,1988.0,8,34,16,58
29009,Romania,1952.0,1,1,2,4
29010,Romania,1980.0,7,15,46,68
29011,Romania,2000.0,27,6,13,46
29012,Romania,1984.0,40,31,35,106
29013,Romania,1984.0,40,31,35,106
29014,Romania,1988.0,8,34,16,58
29015,Romania,1984.0,40,31,35,106
29016,Romania,1988.0,8,34,16,58
29017,Romania,1988.0,8,34,16,58
29018,Romania,1964.0,2,4,10,16
29019,Romania,1976.0,4,28,23,55
29020,Romania,1972.0,3,10,27,40
29021,Romania,1976.0,4,28,23,55
29022,Romania,1972.0,3,10,27,40
29023,Romania,1976.0,4,28,23,55
29024,Romania,1996.0,13,10,15,38
29025,Romania,1964.0,2,4,10,16
29026,Romania,1968.0,5,9,11,25
29027,Romania,1980.0,7,15,46,68
29028,Romania,1976.0,4,28,23,55
29029,Romania,1976.0,4,28,23,55
29030,Romania,1976.0,4,28,23,55
29031,Romania,1996.0,13,10,15,38
29032,Romania,2000.0,27,6,13,46
29033,Romania,2004.0,23,5,11,39
29034,Romania,2004.0,23,5,11,39
29035,Romania,1924.0,0,0,16,16
29036,Romania,1972.0,3,10,27,40
29037,Romania,1980.0,7,15,46,68
29038,Romania,1980.0,7,15,46,68
29039,Romania,1984.0,40,31,35,106
29040,Romania,1956.0,6,3,10,19
29041,Romania,1960.0,3,1,11,15
29042,Romania,1980.0,7,15,46,68
29043,Romania,1964.0,2,4,10,16
29044,Romania,1964.0,2,4,10,16
29045,Romania,1972.0,3,10,27,40
29046,Romania,1960.0,3,1,11,15
29047,Romania,1968.0,5,9,11,25
29048,Romania,1924.0,0,0,16,16
29049,Romania,1968.0,5,9,11,25
29050,Romania,1992.0,8,31,14,53
29051,Romania,1984.0,40,31,35,106
29052,Romania,1988.0,8,34,16,58
29053,Romania,1996.0,13,10,15,38
29054,Romania,1972.0,3,10,27,40
29055,Romania,1976.0,4,28,23,55
29056,Romania,1980.0,7,15,46,68
29057,Romania,1988.0,8,34,16,58
29058,Romania,1980.0,7,15,46,68
29059,Romania,1984.0,40,31,35,106
29060,Romania,1924.0,0,0,16,16
29061,Romania,1984.0,40,31,35,106
29062,Romania,1972.0,3,10,27,40
29063,Romania,1980.0,7,15,46,68
29064,Romania,2012.0,2,8,6,16
29065,Romania,1976.0,4,28,23,55
29066,Puerto Rico,1992.0,0,0,1,1
29067,Puerto Rico,2012.0,0,1,1,2
29068,Puerto Rico,2012.0,0,1,1,2
29069,Puerto Rico,1984.0,0,1,1,2
29070,Puerto Rico,1976.0,0,0,1,1
29071,Puerto Rico,1984.0,0,1,1,2
29072,Puerto Rico,2016.0,1,0,0,1
29073,Puerto Rico,1996.0,0,0,1,1
29074,Puerto Rico,1948.0,0,0,1,1
29075,Mexico,1984.0,2,3,1,6
29076,Mexico,2012.0,16,5,3,24
29077,Mexico,2012.0,16,5,3,24
29078,Mexico,1980.0,0,1,9,10
29079,Mexico,1976.0,1,0,1,2
29080,Mexico,2000.0,1,2,3,6
29081,Mexico,1936.0,0,0,16,16
29082,Mexico,1936.0,0,0,16,16
29083,Mexico,1960.0,0,0,1,1
29084,Mexico,1932.0,0,2,0,2
29085,Mexico,1948.0,4,1,4,9
29086,Mexico,1984.0,2,3,1,6
29087,Mexico,1948.0,4,1,4,9
29088,Mexico,1952.0,0,1,0,1
29089,Mexico,1956.0,1,0,1,2
29090,Mexico,1956.0,1,0,1,2
29091,Mexico,2012.0,16,5,3,24
29092,Mexico,1936.0,0,0,16,16
29093,Mexico,2012.0,16,5,3,24
29094,Mexico,2012.0,16,5,3,24
29095,Mexico,1936.0,0,0,16,16
29096,Mexico,1968.0,3,3,3,9
29097,Mexico,2012.0,16,5,3,24
29098,Mexico,2012.0,16,5,3,24
29099,A North American Team,1900.0,0,0,3,3
29100,A North American Team,1900.0,0,0,3,3
29101,A North American Team,1900.0,0,0,3,3
29102,Mexico,2008.0,2,0,2,4
29103,Mexico,2012.0,16,5,3,24
29104,Mexico,2008.0,2,0,2,4
29105,Mexico,2012.0,16,5,3,24
29106,Mexico,2016.0,0,3,2,5
29107,Mexico,2000.0,1,2,3,6
29108,Mexico,2012.0,16,5,3,24
29109,Mexico,1964.0,0,0,1,1
29110,Mexico,1936.0,0,0,16,16
29111,Mexico,2012.0,16,5,3,24
29112,Mexico,1968.0,3,3,3,9
29113,Mexico,1980.0,0,1,9,10
29114,Mexico,1936.0,0,0,16,16
29115,Mexico,1980.0,0,1,9,10
29116,Mexico,2016.0,0,3,2,5
29117,Mexico,1988.0,0,0,2,2
29118,Mexico,1984.0,2,3,1,6
29119,Mexico,1984.0,2,3,1,6
29120,Mexico,1936.0,0,0,16,16
29121,Mexico,2004.0,0,3,1,4
29122,Mexico,2004.0,0,3,1,4
29123,Mexico,2016.0,0,3,2,5
29124,Mexico,2000.0,1,2,3,6
29125,Mexico,1936.0,0,0,16,16
29126,Mexico,2012.0,16,5,3,24
29127,Mexico,1932.0,0,2,0,2
29128,Mexico,2012.0,16,5,3,24
29129,Mexico,2012.0,16,5,3,24
29130,Mexico,2000.0,1,2,3,6
29131,Mexico,1984.0,2,3,1,6
29132,Mexico,1948.0,4,1,4,9
29133,Mexico,1948.0,4,1,4,9
29134,Mexico,1948.0,4,1,4,9
29135,Mexico,1936.0,0,0,16,16
29136,Mexico,1988.0,0,0,2,2
29137,Mexico,1980.0,0,1,9,10
29138,Mexico,1992.0,0,1,0,1
29139,Mexico,2012.0,16,5,3,24
29140,Mexico,1936.0,0,0,16,16
29141,Mexico,1968.0,3,3,3,9
29142,Mexico,1936.0,0,0,16,16
29143,Mexico,1936.0,0,0,16,16
29144,Mexico,2012.0,16,5,3,24
29145,Mexico,1936.0,0,0,16,16
29146,Mexico,2008.0,2,0,2,4
29147,Mexico,1936.0,0,0,16,16
29148,Mexico,1976.0,1,0,1,2
29149,Mexico,1968.0,3,3,3,9
29150,Mexico,2012.0,16,5,3,24
29151,Mexico,2008.0,2,0,2,4
29152,Mexico,1980.0,0,1,9,10
29153,Mexico,1980.0,0,1,9,10
29154,Mexico,1980.0,0,1,9,10
29155,Mexico,2000.0,1,2,3,6
29156,Mexico,2012.0,16,5,3,24
29157,Mexico,1968.0,3,3,3,9
29158,Mexico,1936.0,0,0,16,16
29159,Mexico,2012.0,16,5,3,24
29160,Mexico,1968.0,3,3,3,9
29161,Mexico,2016.0,0,3,2,5
29162,Mexico,1968.0,3,3,3,9
29163,Mexico,1968.0,3,3,3,9
29164,Mexico,2012.0,16,5,3,24
29165,Mexico,2004.0,0,3,1,4
29166,Mexico,2004.0,0,3,1,4
29167,Mexico,2012.0,16,5,3,24
29168,Mexico,2012.0,16,5,3,24
29169,Mexico,2016.0,0,3,2,5
29170,Mexico,2000.0,1,2,3,6
29171,Mexico,2012.0,16,5,3,24
29172,Mexico,1996.0,0,0,1,1
29173,Mexico,1936.0,0,0,16,16
29174,Mexico,1948.0,4,1,4,9
29175,Mexico,1980.0,0,1,9,10
29176,Mexico,1948.0,4,1,4,9
29177,Mexico,1948.0,4,1,4,9
29178,Mexico,1980.0,0,1,9,10
29179,Mexico,1948.0,4,1,4,9
29180,Mexico,1980.0,0,1,9,10
29181,Mexico,2012.0,16,5,3,24
29182,Mexico,1984.0,2,3,1,6
29183,Mexico,1972.0,0,1,0,1
29184,Mexico,1968.0,3,3,3,9
29185,Ghana,1992.0,0,0,20,20
29186,Ghana,1992.0,0,0,20,20
29187,Ghana,1992.0,0,0,20,20
29188,Ghana,1992.0,0,0,20,20
29189,Ghana,1992.0,0,0,20,20
29190,Ghana,1972.0,0,0,1,1
29191,Ghana,1992.0,0,0,20,20
29192,Ghana,1992.0,0,0,20,20
29193,Ghana,1992.0,0,0,20,20
29194,Ghana,1964.0,0,0,1,1
29195,Ghana,1992.0,0,0,20,20
29196,Ghana,1992.0,0,0,20,20
29197,Ghana,1992.0,0,0,20,20
29198,Ghana,1992.0,0,0,20,20
29199,Ghana,1992.0,0,0,20,20
29200,Ghana,1992.0,0,0,20,20
29201,Ghana,1992.0,0,0,20,20
29202,Ghana,1992.0,0,0,20,20
29203,Ghana,1992.0,0,0,20,20
29204,Ghana,1992.0,0,0,20,20
29205,Ghana,1960.0,0,1,0,1
29206,Ghana,1992.0,0,0,20,20
29207,Ghana,1992.0,0,0,20,20
29208,Morocco,1988.0,1,0,2,3
29209,Morocco,1992.0,1,1,1,3
29210,Morocco,1984.0,2,0,0,2
29211,Morocco,1988.0,1,0,2,3
29212,Morocco,1960.0,0,1,0,1
29213,Morocco,2004.0,2,1,0,3
29214,Morocco,2008.0,0,1,1,2
29215,Morocco,2000.0,0,1,4,5
29216,Morocco,1996.0,0,0,2,2
29217,Morocco,1988.0,1,0,2,3
29218,Morocco,2000.0,0,1,4,5
29219,Morocco,2004.0,2,1,0,3
29220,Morocco,2004.0,2,1,0,3
29221,Morocco,1992.0,1,1,1,3
29222,Morocco,1984.0,2,0,0,2
29223,Morocco,2000.0,0,1,4,5
29224,Morocco,2008.0,0,1,1,2
29225,Morocco,1996.0,0,0,2,2
29226,Morocco,2012.0,0,0,1,1
29227,Morocco,2000.0,0,1,4,5
29228,Morocco,2016.0,0,0,1,1
29229,Morocco,1992.0,1,1,1,3
29230,Morocco,2000.0,0,1,4,5
29231,New Zealand,1976.0,15,1,9,25
29232,New Zealand,2008.0,4,2,9,15
29233,New Zealand,2012.0,9,3,15,27
29234,New Zealand,2016.0,6,25,5,36
29235,New Zealand,2012.0,9,3,15,27
29236,New Zealand,2016.0,6,25,5,36
29237,New Zealand,1992.0,1,10,5,16
29238,New Zealand,1976.0,15,1,9,25
29239,New Zealand,2008.0,4,2,9,15
29240,New Zealand,2016.0,6,25,5,36
29241,New Zealand,1968.0,5,0,2,7
29242,New Zealand,1984.0,16,1,6,23
29243,New Zealand,2016.0,6,25,5,36
29244,New Zealand,1988.0,4,4,16,24
29245,New Zealand,2008.0,4,2,9,15
29246,New Zealand,2012.0,9,3,15,27
29247,New Zealand,1988.0,4,4,16,24
29248,New Zealand,2012.0,9,3,15,27
29249,New Zealand,2016.0,6,25,5,36
29250,New Zealand,1976.0,15,1,9,25
29251,New Zealand,1984.0,16,1,6,23
29252,New Zealand,2016.0,6,25,5,36
29253,New Zealand,2008.0,4,2,9,15
29254,New Zealand,2016.0,6,25,5,36
29255,New Zealand,2012.0,9,3,15,27
29256,New Zealand,2016.0,6,25,5,36
29257,New Zealand,2012.0,9,3,15,27
29258,New Zealand,2016.0,6,25,5,36
29259,New Zealand,2016.0,6,25,5,36
29260,New Zealand,2004.0,4,2,0,6
29261,New Zealand,1964.0,4,0,2,6
29262,New Zealand,1976.0,15,1,9,25
29263,New Zealand,1976.0,15,1,9,25
29264,New Zealand,1996.0,3,2,4,9
29265,New Zealand,1992.0,1,10,5,16
29266,New Zealand,2012.0,9,3,15,27
29267,New Zealand,1972.0,9,4,1,14
29268,New Zealand,1976.0,15,1,9,25
29269,New Zealand,1968.0,5,0,2,7
29270,New Zealand,1968.0,5,0,2,7
29271,New Zealand,1972.0,9,4,1,14
29272,New Zealand,1984.0,16,1,6,23
29273,New Zealand,1992.0,1,10,5,16
29274,Jest,1956.0,3,0,0,3
29275,New Zealand,1988.0,4,4,16,24
29276,New Zealand,1964.0,4,0,2,6
29277,New Zealand,1992.0,1,10,5,16
29278,New Zealand,2016.0,6,25,5,36
29279,New Zealand,1976.0,15,1,9,25
29280,New Zealand,1968.0,5,0,2,7
29281,New Zealand,1972.0,9,4,1,14
29282,New Zealand,1976.0,15,1,9,25
29283,New Zealand,1976.0,15,1,9,25
29284,New Zealand,1972.0,9,4,1,14
29285,New Zealand,2004.0,4,2,0,6
29286,New Zealand,2008.0,4,2,9,15
29287,New Zealand,2008.0,4,2,9,15
29288,New Zealand,2012.0,9,3,15,27
29289,New Zealand,2016.0,6,25,5,36
29290,New Zealand,1972.0,9,4,1,14
29291,New Zealand,1976.0,15,1,9,25
29292,New Zealand,1992.0,1,10,5,16
29293,New Zealand,2004.0,4,2,0,6
29294,New Zealand,2008.0,4,2,9,15
29295,New Zealand,2004.0,4,2,0,6
29296,New Zealand,2008.0,4,2,9,15
29297,New Zealand,1984.0,16,1,6,23
29298,New Zealand,1984.0,16,1,6,23
29299,New Zealand,1984.0,16,1,6,23
29300,New Zealand,1988.0,4,4,16,24
29301,New Zealand,1988.0,4,4,16,24
29302,New Zealand,2016.0,6,25,5,36
29303,New Zealand,2004.0,4,2,0,6
29304,New Zealand,2012.0,9,3,15,27
29305,New Zealand,2016.0,6,25,5,36
29306,New Zealand,2008.0,4,2,9,15
29307,New Zealand,2012.0,9,3,15,27
29308,New Zealand,1920.0,0,0,1,1
29309,New Zealand,2012.0,9,3,15,27
29310,New Zealand,1960.0,2,0,1,3
29311,New Zealand,1988.0,4,4,16,24
29312,New Zealand,1952.0,1,0,2,3
29313,New Zealand,1984.0,16,1,6,23
29314,New Zealand,1972.0,9,4,1,14
29315,New Zealand,1972.0,9,4,1,14
29316,New Zealand,1976.0,15,1,9,25
29317,New Zealand,1976.0,15,1,9,25
29318,New Zealand,1996.0,3,2,4,9
29319,New Zealand,1988.0,4,4,16,24
29320,New Zealand,2016.0,6,25,5,36
29321,New Zealand,1968.0,5,0,2,7
29322,New Zealand,1972.0,9,4,1,14
29323,New Zealand,1992.0,1,10,5,16
29324,New Zealand,1996.0,3,2,4,9
29325,New Zealand,2000.0,1,0,3,4
29326,New Zealand,1984.0,16,1,6,23
29327,New Zealand,1988.0,4,4,16,24
29328,New Zealand,1988.0,4,4,16,24
29329,New Zealand,1988.0,4,4,16,24
29330,New Zealand,1988.0,4,4,16,24
29331,New Zealand,2016.0,6,25,5,36
29332,New Zealand,1992.0,1,10,5,16
29333,New Zealand,1996.0,3,2,4,9
29334,New Zealand,1984.0,16,1,6,23
29335,"Osborne Swimming Club, Manchester",1900.0,1,0,0,1
29336,New Zealand,1992.0,1,10,5,16
29337,New Zealand,1996.0,3,2,4,9
29338,New Zealand,1996.0,3,2,4,9
29339,New Zealand,1936.0,1,0,0,1
29340,New Zealand,1984.0,16,1,6,23
29341,New Zealand,1984.0,16,1,6,23
29342,New Zealand,1984.0,16,1,6,23
29343,New Zealand,1988.0,4,4,16,24
29344,New Zealand,1988.0,4,4,16,24
29345,New Zealand,1988.0,4,4,16,24
29346,New Zealand,1960.0,2,0,1,3
29347,New Zealand,1976.0,15,1,9,25
29348,New Zealand,1976.0,15,1,9,25
29349,New Zealand,2016.0,6,25,5,36
29350,Jest,1956.0,3,0,0,3
29351,New Zealand,1976.0,15,1,9,25
29352,New Zealand,2016.0,6,25,5,36
29353,New Zealand,2016.0,6,25,5,36
29354,New Zealand,2016.0,6,25,5,36
29355,New Zealand,2000.0,1,0,3,4
29356,New Zealand,1976.0,15,1,9,25
29357,New Zealand,1976.0,15,1,9,25
29358,New Zealand,2016.0,6,25,5,36
29359,New Zealand,2016.0,6,25,5,36
29360,New Zealand,1972.0,9,4,1,14
29361,New Zealand,2016.0,6,25,5,36
29362,New Zealand,1992.0,1,10,5,16
29363,New Zealand,1992.0,1,10,5,16
29364,New Zealand,1928.0,1,0,0,1
29365,New Zealand,1988.0,4,4,16,24
29366,New Zealand,2012.0,9,3,15,27
29367,New Zealand,2016.0,6,25,5,36
29368,New Zealand,2016.0,6,25,5,36
29369,New Zealand,1992.0,1,10,5,16
29370,New Zealand,1996.0,3,2,4,9
29371,New Zealand,2012.0,9,3,15,27
29372,New Zealand,1984.0,16,1,6,23
29373,New Zealand,1984.0,16,1,6,23
29374,New Zealand,2012.0,9,3,15,27
29375,New Zealand,1976.0,15,1,9,25
29376,New Zealand,1976.0,15,1,9,25
29377,New Zealand,1976.0,15,1,9,25
29378,New Zealand,1988.0,4,4,16,24
29379,Pandora,1964.0,4,0,2,6
29380,New Zealand,1924.0,0,0,1,1
29381,New Zealand,1988.0,4,4,16,24
29382,New Zealand,2012.0,9,3,15,27
29383,New Zealand,2012.0,9,3,15,27
29384,New Zealand,2016.0,6,25,5,36
29385,New Zealand,1976.0,15,1,9,25
29386,New Zealand,1956.0,3,0,0,3
29387,New Zealand,2012.0,9,3,15,27
29388,New Zealand,1984.0,16,1,6,23
29389,New Zealand,1972.0,9,4,1,14
29390,New Zealand,1976.0,15,1,9,25
29391,New Zealand,2016.0,6,25,5,36
29392,New Zealand,2008.0,4,2,9,15
29393,New Zealand,2008.0,4,2,9,15
29394,New Zealand,2008.0,4,2,9,15
29395,New Zealand,2012.0,9,3,15,27
29396,New Zealand,1968.0,5,0,2,7
29397,New Zealand,2012.0,9,3,15,27
29398,New Zealand,2016.0,6,25,5,36
29399,New Zealand,1984.0,16,1,6,23
29400,New Zealand,1988.0,4,4,16,24
29401,New Zealand,2008.0,4,2,9,15
29402,New Zealand,2012.0,9,3,15,27
29403,New Zealand,1992.0,1,10,5,16
29404,New Zealand,1960.0,2,0,1,3
29405,New Zealand,1964.0,4,0,2,6
29406,New Zealand,1964.0,4,0,2,6
29407,New Zealand,1952.0,1,0,2,3
29408,New Zealand,1932.0,0,2,0,2
29409,New Zealand,1968.0,5,0,2,7
29410,New Zealand,1972.0,9,4,1,14
29411,New Zealand,2012.0,9,3,15,27
29412,New Zealand,1976.0,15,1,9,25
29413,New Zealand,1984.0,16,1,6,23
29414,New Zealand,1992.0,1,10,5,16
29415,New Zealand,1992.0,1,10,5,16
29416,New Zealand,1996.0,3,2,4,9
29417,New Zealand,1996.0,3,2,4,9
29418,New Zealand,2012.0,9,3,15,27
29419,New Zealand,2016.0,6,25,5,36
29420,New Zealand,1984.0,16,1,6,23
29421,New Zealand,1984.0,16,1,6,23
29422,New Zealand,1932.0,0,2,0,2
29423,New Zealand,1984.0,16,1,6,23
29424,New Zealand,1988.0,4,4,16,24
29425,New Zealand,1984.0,16,1,6,23
29426,New Zealand,1988.0,4,4,16,24
29427,New Zealand,1988.0,4,4,16,24
29428,New Zealand,1992.0,1,10,5,16
29429,New Zealand,2000.0,1,0,3,4
29430,New Zealand,2012.0,9,3,15,27
29431,New Zealand,1984.0,16,1,6,23
29432,New Zealand,1972.0,9,4,1,14
29433,New Zealand,1984.0,16,1,6,23
29434,New Zealand,1992.0,1,10,5,16
29435,New Zealand,2016.0,6,25,5,36
29436,New Zealand,2012.0,9,3,15,27
29437,New Zealand,2016.0,6,25,5,36
29438,New Zealand,2008.0,4,2,9,15
29439,New Zealand,2004.0,4,2,0,6
29440,New Zealand,2012.0,9,3,15,27
29441,New Zealand,2012.0,9,3,15,27
29442,New Zealand,1972.0,9,4,1,14
29443,New Zealand,1988.0,4,4,16,24
29444,New Zealand,2000.0,1,0,3,4
29445,New Zealand,1976.0,15,1,9,25
29446,New Zealand,2012.0,9,3,15,27
29447,New Zealand,2016.0,6,25,5,36
29448,New Zealand,2016.0,6,25,5,36
29449,Pandora,1964.0,4,0,2,6
29450,New Zealand,1988.0,4,4,16,24
29451,New Zealand,2016.0,6,25,5,36
29452,New Zealand,1952.0,1,0,2,3
29453,New Zealand,2008.0,4,2,9,15
29454,New Zealand,2016.0,6,25,5,36
29455,New Zealand,1972.0,9,4,1,14
29456,New Zealand,1976.0,15,1,9,25
29457,New Zealand,2016.0,6,25,5,36
29458,New Zealand,1988.0,4,4,16,24
29459,Germany,2002.0,26,23,12,61
29460,Germany,2002.0,26,23,12,61
29461,Germany,2006.0,23,25,6,54
29462,Germany,1936.0,97,73,61,231
29463,Germany,2012.0,45,27,22,94
29464,Germany,1936.0,97,73,61,231
29465,Germany-2,2010.0,15,24,15,54
29466,Germany,1960.0,38,37,23,98
29467,Germany,1964.0,25,48,53,126
29468,Germany,2004.0,41,45,63,149
29469,Germany,2016.0,49,43,67,159
29470,Germany-1,2000.0,31,23,64,118
29471,Mutafo,1964.0,25,48,53,126
29472,Germany,1964.0,25,48,53,126
29473,Germany,2012.0,45,27,22,94
29474,Germany,1932.0,10,26,21,57
29475,Germany,2008.0,42,16,41,99
29476,Germany,1992.0,95,74,67,236
29477,Germany,1928.0,21,15,46,82
29478,Favorite Hammonia-3,1900.0,14,20,11,45
29479,Frankfurt Club,1900.0,14,20,11,45
29480,Germany,2008.0,42,16,41,99
29481,Germany,2002.0,26,23,12,61
29482,Germany,2006.0,23,25,6,54
29483,Germany,2006.0,23,25,6,54
29484,Germany,2010.0,15,24,15,54
29485,Germany,2006.0,23,25,6,54
29486,Germany,2010.0,15,24,15,54
29487,Germany,1998.0,22,12,10,44
29488,Germany,1998.0,22,12,10,44
29489,Germany,2002.0,26,23,12,61
29490,Germany,2006.0,23,25,6,54
29491,Germany,1936.0,97,73,61,231
29492,Germany-1,2014.0,15,12,9,36
29493,Germany,2014.0,15,12,9,36
29494,Germany,1956.0,10,20,24,54
29495,Germany,1996.0,42,35,47,124
29496,Germany,2004.0,41,45,63,149
29497,Germany,2012.0,45,27,22,94
29498,Ludwigshafener Ruderverein,1912.0,11,19,23,53
29499,Germany,2004.0,41,45,63,149
29500,Germany,1906.0,14,10,6,30
29501,Germany,1936.0,97,73,61,231
29502,Germany,2012.0,45,27,22,94
29503,Germany,2012.0,45,27,22,94
29504,Germany,2016.0,49,43,67,159
29505,Germany,1992.0,95,74,67,236
29506,Germany,1996.0,42,35,47,124
29507,Germany,2000.0,31,23,64,118
29508,Germany,2004.0,41,45,63,149
29509,Germany,2012.0,45,27,22,94
29510,Germany,2004.0,41,45,63,149
29511,Germany,2004.0,41,45,63,149
29512,Germany,1906.0,14,10,6,30
29513,Germany,2000.0,31,23,64,118
29514,Germany,1928.0,21,15,46,82
29515,Germany,1936.0,97,73,61,231
29516,Germany,1936.0,97,73,61,231
29517,Germany-1,1936.0,97,73,61,231
29518,Germany,1994.0,18,10,12,40
29519,Germany,2008.0,42,16,41,99
29520,Germany,1992.0,95,74,67,236
29521,Germany,1992.0,95,74,67,236
29522,Germany,1992.0,95,74,67,236
29523,Germany,1996.0,42,35,47,124
29524,Germany,1932.0,10,26,21,57
29525,Germany,1992.0,95,74,67,236
29526,Germany,1936.0,97,73,61,231
29527,Germany,1956.0,10,20,24,54
29528,Germany,2012.0,45,27,22,94
29529,Germany,2016.0,49,43,67,159
29530,Germany,1960.0,38,37,23,98
29531,Germany,1964.0,25,48,53,126
29532,Germany,1964.0,25,48,53,126
29533,Berliner Ruderverein von 1876-2,1912.0,11,19,23,53
29534,Berliner Ruderverein von 1876-2,1912.0,11,19,23,53
29535,Germany,2000.0,31,23,64,118
29536,Germany,2000.0,31,23,64,118
29537,Germany,2016.0,49,43,67,159
29538,Germany,1936.0,97,73,61,231
29539,Germany,1952.0,8,16,28,52
29540,Germany,1912.0,11,19,23,53
29541,Germany,1912.0,11,19,23,53
29542,Germany,1992.0,95,74,67,236
29543,Germany,1996.0,42,35,47,124
29544,Germany,2000.0,31,23,64,118
29545,Germany,1964.0,25,48,53,126
29546,Germany,2000.0,31,23,64,118
29547,Germany,1936.0,97,73,61,231
29548,Germany,1932.0,10,26,21,57
29549,Germany,2016.0,49,43,67,159
29550,Germany,2002.0,26,23,12,61
29551,Germany,2002.0,26,23,12,61
29552,Germany,2006.0,23,25,6,54
29553,Germany,1992.0,95,74,67,236
29554,Germany,1992.0,95,74,67,236
29555,Germany,1936.0,97,73,61,231
29556,Germany-1,1960.0,38,37,23,98
29557,Germany-1,1964.0,25,48,53,126
29558,Germany,2004.0,41,45,63,149
29559,Germany,2004.0,41,45,63,149
29560,Germany,2000.0,31,23,64,118
29561,Germany,1992.0,95,74,67,236
29562,Germany,1992.0,95,74,67,236
29563,Germany,1992.0,95,74,67,236
29564,Germany-1,2004.0,41,45,63,149
29565,Germany,2000.0,31,23,64,118
29566,Germany,2004.0,41,45,63,149
29567,Germany,1996.0,42,35,47,124
29568,Germany,1936.0,97,73,61,231
29569,Germany,2010.0,15,24,15,54
29570,Germany,2010.0,15,24,15,54
29571,Germany,2010.0,15,24,15,54
29572,Germany,1992.0,95,74,67,236
29573,Germany,1996.0,42,35,47,124
29574,Germany,2000.0,31,23,64,118
29575,Germany,2016.0,49,43,67,159
29576,Germany,1992.0,95,74,67,236
29577,Germany,1994.0,18,10,12,40
29578,Germany,1998.0,22,12,10,44
29579,Germany,1992.0,95,74,67,236
29580,Germany-1,1992.0,95,74,67,236
29581,Germany-1,1994.0,18,10,12,40
29582,Germany-1,1998.0,22,12,10,44
29583,Germany,1956.0,10,20,24,54
29584,Germany,1964.0,25,48,53,126
29585,Germany,1908.0,4,11,6,21
29586,Germany,1912.0,11,19,23,53
29587,Germany,2008.0,42,16,41,99
29588,Germany,2016.0,49,43,67,159
29589,Germany,1936.0,97,73,61,231
29590,Germany,2016.0,49,43,67,159
29591,Germany,2016.0,49,43,67,159
29592,Germany,1928.0,21,15,46,82
29593,Germany,1932.0,10,26,21,57
29594,Germany,1928.0,21,15,46,82
29595,Germany,1936.0,97,73,61,231
29596,Frankfurt Club,1900.0,14,20,11,45
29597,Germany,1964.0,25,48,53,126
29598,Germany,1908.0,4,11,6,21
29599,Germany,1960.0,38,37,23,98
29600,Germany,1960.0,38,37,23,98
29601,Germany,2004.0,41,45,63,149
29602,Germany,2008.0,42,16,41,99
29603,Germany,1928.0,21,15,46,82
29604,Germany,2008.0,42,16,41,99
29605,Germany,2012.0,45,27,22,94
29606,Germania II,1936.0,97,73,61,231
29607,Wannsee,1936.0,97,73,61,231
29608,Germany,2000.0,31,23,64,118
29609,Germany,1960.0,38,37,23,98
29610,Germany,1964.0,25,48,53,126
29611,Germany,1928.0,21,15,46,82
29612,Germany,2000.0,31,23,64,118
29613,Germany,2004.0,41,45,63,149
29614,Germany,1936.0,97,73,61,231
29615,Germany,1992.0,95,74,67,236
29616,Germany,1992.0,95,74,67,236
29617,Germany,1992.0,95,74,67,236
29618,Germany,1992.0,95,74,67,236
29619,Germany,1996.0,42,35,47,124
29620,Germany,1996.0,42,35,47,124
29621,Germany,1992.0,95,74,67,236
29622,Germany,1928.0,21,15,46,82
29623,Germany,1896.0,25,5,2,32
29624,Germany,1896.0,25,5,2,32
29625,Germany,2002.0,26,23,12,61
29626,Germany,1932.0,10,26,21,57
29627,Germany,2006.0,23,25,6,54
29628,Germany,2014.0,15,12,9,36
29629,Germany,2004.0,41,45,63,149
29630,Germany,2014.0,15,12,9,36
29631,Germany,2004.0,41,45,63,149
29632,Germany,1964.0,25,48,53,126
29633,Germany,1964.0,25,48,53,126
29634,Germany,2008.0,42,16,41,99
29635,Germany,2012.0,45,27,22,94
29636,Germany,2016.0,49,43,67,159
29637,Germany,1936.0,97,73,61,231
29638,Germany,2004.0,41,45,63,149
29639,Germany,1964.0,25,48,53,126
29640,Germany,1992.0,95,74,67,236
29641,Germany,1932.0,10,26,21,57
29642,Germany,1936.0,97,73,61,231
29643,Germany,2000.0,31,23,64,118
29644,Germany,1956.0,10,20,24,54
29645,Germany,1906.0,14,10,6,30
29646,Germany,1992.0,95,74,67,236
29647,Germany,1992.0,95,74,67,236
29648,Germany,1996.0,42,35,47,124
29649,Germany,2000.0,31,23,64,118
29650,Germany,2004.0,41,45,63,149
29651,Germany,2008.0,42,16,41,99
29652,Germany,1992.0,95,74,67,236
29653,Germany,1964.0,25,48,53,126
29654,Germany,1904.0,4,5,7,16
29655,Germany,1904.0,4,5,7,16
29656,Germany,2000.0,31,23,64,118
29657,Germany,1936.0,97,73,61,231
29658,Germany,2016.0,49,43,67,159
29659,Germany-2,1994.0,18,10,12,40
29660,Germany,1936.0,97,73,61,231
29661,Germany,1932.0,10,26,21,57
29662,Germany,1908.0,4,11,6,21
29663,Germany,1908.0,4,11,6,21
29664,Germany,1912.0,11,19,23,53
29665,Germany,1992.0,95,74,67,236
29666,Germany,1960.0,38,37,23,98
29667,Germany,1936.0,97,73,61,231
29668,Germany,1992.0,95,74,67,236
29669,Germany,1932.0,10,26,21,57
29670,Germany,1936.0,97,73,61,231
29671,Germany,2012.0,45,27,22,94
29672,Germany,2016.0,49,43,67,159
29673,Germany,2016.0,49,43,67,159
29674,Germany,1956.0,10,20,24,54
29675,Germany,2008.0,42,16,41,99
29676,Germany,1996.0,42,35,47,124
29677,Germany,1956.0,10,20,24,54
29678,Germany-1,2012.0,45,27,22,94
29679,Germany,2008.0,42,16,41,99
29680,Germany,1936.0,97,73,61,231
29681,Germany,1964.0,25,48,53,126
29682,Germany,2008.0,42,16,41,99
29683,Germany,2012.0,45,27,22,94
29684,Germany,2016.0,49,43,67,159
29685,Germany,2016.0,49,43,67,159
29686,Berliner Ruderverein von 1876-2,1912.0,11,19,23,53
29687,Germany,1992.0,95,74,67,236
29688,Germany,1928.0,21,15,46,82
29689,Germany,1960.0,38,37,23,98
29690,Germany,1960.0,38,37,23,98
29691,Germany,1928.0,21,15,46,82
29692,Germany,1952.0,8,16,28,52
29693,Germany,1952.0,8,16,28,52
29694,Germany,1952.0,8,16,28,52
29695,Germany,1956.0,10,20,24,54
29696,Germany,1932.0,10,26,21,57
29697,Germany,1964.0,25,48,53,126
29698,Germany,1992.0,95,74,67,236
29699,Germany,1996.0,42,35,47,124
29700,Germany,1936.0,97,73,61,231
29701,Germany,1908.0,4,11,6,21
29702,Germany,1996.0,42,35,47,124
29703,Germany,2000.0,31,23,64,118
29704,Germany,2004.0,41,45,63,149
29705,Germany,2004.0,41,45,63,149
29706,Germany,2004.0,41,45,63,149
29707,Germany,1996.0,42,35,47,124
29708,Germany,1952.0,8,16,28,52
29709,Germany,1952.0,8,16,28,52
29710,Germany,2016.0,49,43,67,159
29711,Germany,1936.0,97,73,61,231
29712,Germany,1932.0,10,26,21,57
29713,Germany,2000.0,31,23,64,118
29714,Elvis Va,2008.0,42,16,41,99
29715,Favorite Hammonia-3,1900.0,14,20,11,45
29716,Germany,1996.0,42,35,47,124
29717,Germany,2004.0,41,45,63,149
29718,Germany,1928.0,21,15,46,82
29719,Germany,1936.0,97,73,61,231
29720,Germany,1936.0,97,73,61,231
29721,Germany,1906.0,14,10,6,30
29722,Germany,1906.0,14,10,6,30
29723,Germany,1906.0,14,10,6,30
29724,Germany,1906.0,14,10,6,30
29725,Germany,2016.0,49,43,67,159
29726,Germany,2008.0,42,16,41,99
29727,Germany,1960.0,38,37,23,98
29728,Germany,1964.0,25,48,53,126
29729,Germany,2004.0,41,45,63,149
29730,Germany,1928.0,21,15,46,82
29731,Germany,1932.0,10,26,21,57
29732,Germany,1928.0,21,15,46,82
29733,Germany,1936.0,97,73,61,231
29734,Germany,2004.0,41,45,63,149
29735,Germany,1960.0,38,37,23,98
29736,Germany,1936.0,97,73,61,231
29737,Germany-2,1994.0,18,10,12,40
29738,Germany,2016.0,49,43,67,159
29739,Germany,2004.0,41,45,63,149
29740,Germany,1936.0,97,73,61,231
29741,Germany,1912.0,11,19,23,53
29742,Germany,2012.0,45,27,22,94
29743,Berliner Ruderverein von 1876-2,1912.0,11,19,23,53
29744,Germany,1956.0,10,20,24,54
29745,Germany,1912.0,11,19,23,53
29746,Germany,2016.0,49,43,67,159
29747,Germany,1936.0,97,73,61,231
29748,Germany,2008.0,42,16,41,99
29749,Germany,1992.0,95,74,67,236
29750,Germany,1956.0,10,20,24,54
29751,Germany,1960.0,38,37,23,98
29752,Germany,1960.0,38,37,23,98
29753,Germany,1964.0,25,48,53,126
29754,Germany,2012.0,45,27,22,94
29755,Germany,2012.0,45,27,22,94
29756,Germany,2016.0,49,43,67,159
29757,Germany,2016.0,49,43,67,159
29758,Germany,1992.0,95,74,67,236
29759,Germany,1994.0,18,10,12,40
29760,Germany,1994.0,18,10,12,40
29761,Germany,1998.0,22,12,10,44
29762,Germany,1998.0,22,12,10,44
29763,Germany,1998.0,22,12,10,44
29764,Germany,2002.0,26,23,12,61
29765,Germany,2002.0,26,23,12,61
29766,Germany,2006.0,23,25,6,54
29767,Germany,2016.0,49,43,67,159
29768,Germany,1992.0,95,74,67,236
29769,Germany,1996.0,42,35,47,124
29770,Germany,2000.0,31,23,64,118
29771,Germany,2000.0,31,23,64,118
29772,Germany,2004.0,41,45,63,149
29773,Germany,2004.0,41,45,63,149
29774,Germany,1992.0,95,74,67,236
29775,Germany,2004.0,41,45,63,149
29776,Germany,1956.0,10,20,24,54
29777,Germany,1936.0,97,73,61,231
29778,Germany,1960.0,38,37,23,98
29779,Germany,1992.0,95,74,67,236
29780,Germany,2008.0,42,16,41,99
29781,Germany,1906.0,14,10,6,30
29782,Germany,1992.0,95,74,67,236
29783,Germany,1936.0,97,73,61,231
29784,Germany,2004.0,41,45,63,149
29785,Germany,2016.0,49,43,67,159
29786,Germany,1992.0,95,74,67,236
29787,Germany,2000.0,31,23,64,118
29788,Germany,1912.0,11,19,23,53
29789,Germany,1952.0,8,16,28,52
29790,Germany,1952.0,8,16,28,52
29791,Germany,2004.0,41,45,63,149
29792,Germany,1936.0,97,73,61,231
29793,Germany,2016.0,49,43,67,159
29794,Germany,1996.0,42,35,47,124
29795,Germany,2004.0,41,45,63,149
29796,Germany,1994.0,18,10,12,40
29797,Germany,1900.0,14,20,11,45
29798,Germany,1906.0,14,10,6,30
29799,Germany,2004.0,41,45,63,149
29800,Berliner Ruderclub,1908.0,4,11,6,21
29801,Germany,1932.0,10,26,21,57
29802,Germany,2000.0,31,23,64,118
29803,Germany,2008.0,42,16,41,99
29804,Germany,1932.0,10,26,21,57
29805,Germany,1936.0,97,73,61,231
29806,Germany,2010.0,15,24,15,54
29807,Germany,1960.0,38,37,23,98
29808,Germany-2,1992.0,95,74,67,236
29809,Germany,1936.0,97,73,61,231
29810,Germany,1936.0,97,73,61,231
29811,Germany,2000.0,31,23,64,118
29812,Germany-1,1996.0,42,35,47,124
29813,Germany,1992.0,95,74,67,236
29814,Germany,1932.0,10,26,21,57
29815,Germany,1936.0,97,73,61,231
29816,Germany,1992.0,95,74,67,236
29817,Germany,1936.0,97,73,61,231
29818,Germany,1908.0,4,11,6,21
29819,Germany,2004.0,41,45,63,149
29820,Germany,1936.0,97,73,61,231
29821,Germany,1936.0,97,73,61,231
29822,Germany,1932.0,10,26,21,57
29823,Germany-1,1994.0,18,10,12,40
29824,Germany-2,2002.0,26,23,12,61
29825,Germany,2004.0,41,45,63,149
29826,Germany,1964.0,25,48,53,126
29827,Germany,2008.0,42,16,41,99
29828,Germany,2012.0,45,27,22,94
29829,Germany,1928.0,21,15,46,82
29830,Germany,1928.0,21,15,46,82
29831,Germany,1964.0,25,48,53,126
29832,Germany,2008.0,42,16,41,99
29833,Germany,1906.0,14,10,6,30
29834,Germany,1992.0,95,74,67,236
29835,Germany,1994.0,18,10,12,40
29836,Germany-2,2002.0,26,23,12,61
29837,Germany,1992.0,95,74,67,236
29838,Germany,2004.0,41,45,63,149
29839,Germany,1994.0,18,10,12,40
29840,Germany,1998.0,22,12,10,44
29841,Germany,2002.0,26,23,12,61
29842,Germany,1964.0,25,48,53,126
29843,Germany,1936.0,97,73,61,231
29844,Germany,1964.0,25,48,53,126
29845,Germany,2000.0,31,23,64,118
29846,Germany,2004.0,41,45,63,149
29847,Germany,1912.0,11,19,23,53
29848,Germany-1,1952.0,8,16,28,52
29849,Germany-1,1952.0,8,16,28,52
29850,Germany,2016.0,49,43,67,159
29851,Germany,1928.0,21,15,46,82
29852,Germany,1992.0,95,74,67,236
29853,Ludwigshafener Ruder Verein-1,1900.0,14,20,11,45
29854,Germany,1992.0,95,74,67,236
29855,Germany,1956.0,10,20,24,54
29856,Germany,2014.0,15,12,9,36
29857,Germany,1992.0,95,74,67,236
29858,Germany,1992.0,95,74,67,236
29859,Germany,1996.0,42,35,47,124
29860,Ludwigshafener Ruder Verein-1,1900.0,14,20,11,45
29861,Ludwigshafener Ruderverein,1912.0,11,19,23,53
29862,Ludwigshafener Ruderverein,1912.0,11,19,23,53
29863,Germany,1992.0,95,74,67,236
29864,Germany,1996.0,42,35,47,124
29865,Germany,2000.0,31,23,64,118
29866,Germany,2000.0,31,23,64,118
29867,Germany,2004.0,41,45,63,149
29868,Germany,2004.0,41,45,63,149
29869,Germany,2002.0,26,23,12,61
29870,Germany,2006.0,23,25,6,54
29871,Germany,1992.0,95,74,67,236
29872,Germany,1992.0,95,74,67,236
29873,Germany,2008.0,42,16,41,99
29874,Germany,1992.0,95,74,67,236
29875,Germany,2008.0,42,16,41,99
29876,Germany,1994.0,18,10,12,40
29877,Germany,1994.0,18,10,12,40
29878,Germany,1998.0,22,12,10,44
29879,Germany,2002.0,26,23,12,61
29880,Germany,2002.0,26,23,12,61
29881,Germany,2006.0,23,25,6,54
29882,Germany,2006.0,23,25,6,54
29883,Germany,2006.0,23,25,6,54
29884,Germany,1992.0,95,74,67,236
29885,Germany,1992.0,95,74,67,236
29886,Germany,1996.0,42,35,47,124
29887,Germany,1996.0,42,35,47,124
29888,Germany,2000.0,31,23,64,118
29889,Germany,2000.0,31,23,64,118
29890,Germany,2004.0,41,45,63,149
29891,Germany,2004.0,41,45,63,149
29892,Germany,2000.0,31,23,64,118
29893,Germany,1996.0,42,35,47,124
29894,Germany,1996.0,42,35,47,124
29895,Germany,1896.0,25,5,2,32
29896,Germany,1896.0,25,5,2,32
29897,Germany,1896.0,25,5,2,32
29898,Germany,1896.0,25,5,2,32
29899,Germany,1896.0,25,5,2,32
29900,Germany,1896.0,25,5,2,32
29901,Germany,1932.0,10,26,21,57
29902,Germany,1936.0,97,73,61,231
29903,Germany,1932.0,10,26,21,57
29904,Germany-1,2006.0,23,25,6,54
29905,Germany-2,2010.0,15,24,15,54
29906,Germany,1928.0,21,15,46,82
29907,Germany,1932.0,10,26,21,57
29908,Germany,1992.0,95,74,67,236
29909,Germany,2012.0,45,27,22,94
29910,Germany,1992.0,95,74,67,236
29911,Germany,1928.0,21,15,46,82
29912,Germany,1964.0,25,48,53,126
29913,Germany,1992.0,95,74,67,236
29914,Germany,1928.0,21,15,46,82
29915,Germany,1928.0,21,15,46,82
29916,Germany,1996.0,42,35,47,124
29917,Germany,1996.0,42,35,47,124
29918,Germany,2000.0,31,23,64,118
29919,Germany,2010.0,15,24,15,54
29920,Germany,2014.0,15,12,9,36
29921,Germany,2014.0,15,12,9,36
29922,Germany,1964.0,25,48,53,126
29923,Germany,2014.0,15,12,9,36
29924,Germany,1936.0,97,73,61,231
29925,Germany,1936.0,97,73,61,231
29926,Germany,1936.0,97,73,61,231
29927,Germany,1936.0,97,73,61,231
29928,Germany,1936.0,97,73,61,231
29929,Germany,1936.0,97,73,61,231
29930,Germany,1928.0,21,15,46,82
29931,Germany,1912.0,11,19,23,53
29932,Germany,1992.0,95,74,67,236
29933,Germany,1998.0,22,12,10,44
29934,Germany,2002.0,26,23,12,61
29935,Germany,2006.0,23,25,6,54
29936,Germany,2006.0,23,25,6,54
29937,Germany,2010.0,15,24,15,54
29938,Germany,2004.0,41,45,63,149
29939,Germany,2008.0,42,16,41,99
29940,Germany,1908.0,4,11,6,21
29941,Germany,1936.0,97,73,61,231
29942,Germany,1936.0,97,73,61,231
29943,Germany,2012.0,45,27,22,94
29944,Germany,2012.0,45,27,22,94
29945,Germany,2016.0,49,43,67,159
29946,Germany,1964.0,25,48,53,126
29947,Germany,1960.0,38,37,23,98
29948,Germany,1964.0,25,48,53,126
29949,Germany,1964.0,25,48,53,126
29950,Germany,1992.0,95,74,67,236
29951,Germany,2000.0,31,23,64,118
29952,Germany,2004.0,41,45,63,149
29953,Germany,1992.0,95,74,67,236
29954,Germany,1964.0,25,48,53,126
29955,Germany,2008.0,42,16,41,99
29956,Germany,2012.0,45,27,22,94
29957,Germany,2016.0,49,43,67,159
29958,Germany,2004.0,41,45,63,149
29959,Germany,1956.0,10,20,24,54
29960,Germany,1932.0,10,26,21,57
29961,Germany,1936.0,97,73,61,231
29962,Germany,2000.0,31,23,64,118
29963,Germany,2006.0,23,25,6,54
29964,Germany,1992.0,95,74,67,236
29965,Germany,2002.0,26,23,12,61
29966,Germany,2004.0,41,45,63,149
29967,Germany,2008.0,42,16,41,99
29968,Germany,1928.0,21,15,46,82
29969,Germany,2010.0,15,24,15,54
29970,Germany,2014.0,15,12,9,36
29971,Germany,2014.0,15,12,9,36
29972,Germany,1964.0,25,48,53,126
29973,Germany,1964.0,25,48,53,126
29974,Germany,2000.0,31,23,64,118
29975,Germany,1952.0,8,16,28,52
29976,Germany,1936.0,97,73,61,231
29977,Germany,2016.0,49,43,67,159
29978,Germany,1936.0,97,73,61,231
29979,Germany,1936.0,97,73,61,231
29980,Germany,1998.0,22,12,10,44
29981,Germany,1998.0,22,12,10,44
29982,Germany,1936.0,97,73,61,231
29983,Germany,1936.0,97,73,61,231
29984,Germany,1956.0,10,20,24,54
29985,Germany,1960.0,38,37,23,98
29986,Germany,1912.0,11,19,23,53
29987,Germany,1960.0,38,37,23,98
29988,Germany,2004.0,41,45,63,149
29989,Germany,2008.0,42,16,41,99
29990,Germany,2008.0,42,16,41,99
29991,Germany,1936.0,97,73,61,231
29992,Germany,2016.0,49,43,67,159
29993,Germany,2006.0,23,25,6,54
29994,Germany,2006.0,23,25,6,54
29995,Germany,2006.0,23,25,6,54
29996,Germany,2010.0,15,24,15,54
29997,Germany,1964.0,25,48,53,126
29998,Germany,1956.0,10,20,24,54
29999,Germany,1992.0,95,74,67,236
30000,Germany,2016.0,49,43,67,159
30001,Germany,1960.0,38,37,23,98
30002,Germany,1896.0,25,5,2,32
30003,Germany,1912.0,11,19,23,53
30004,Germany,1912.0,11,19,23,53
30005,Germany,1912.0,11,19,23,53
30006,Germany,1996.0,42,35,47,124
30007,Germany,2016.0,49,43,67,159
30008,Germany,2008.0,42,16,41,99
30009,Germany,2016.0,49,43,67,159
30010,"Germania Ruder Club, Hamburg-2",1900.0,14,20,11,45
30011,"Germania Ruder Club, Hamburg-2",1900.0,14,20,11,45
30012,"Germania Ruder Club, Hamburg-2",1900.0,14,20,11,45
30013,Germany,2010.0,15,24,15,54
30014,Germany,2000.0,31,23,64,118
30015,Germany,2000.0,31,23,64,118
30016,Germany,2004.0,41,45,63,149
30017,Germany,2004.0,41,45,63,149
30018,Germany,1906.0,14,10,6,30
30019,Germany,1906.0,14,10,6,30
30020,Germany,1908.0,4,11,6,21
30021,Germany,2000.0,31,23,64,118
30022,Germany,1992.0,95,74,67,236
30023,Germany,2016.0,49,43,67,159
30024,Germany,2016.0,49,43,67,159
30025,Germany,1936.0,97,73,61,231
30026,Germany,1964.0,25,48,53,126
30027,Germany,1964.0,25,48,53,126
30028,Germany,1994.0,18,10,12,40
30029,Germany,2006.0,23,25,6,54
30030,Germany,2006.0,23,25,6,54
30031,Germany,2006.0,23,25,6,54
30032,Germany,2008.0,42,16,41,99
30033,Germany,2000.0,31,23,64,118
30034,Germany,1960.0,38,37,23,98
30035,Germany,1960.0,38,37,23,98
30036,Germany,2012.0,45,27,22,94
30037,Germany,1960.0,38,37,23,98
30038,Germany,2016.0,49,43,67,159
30039,Germany,2016.0,49,43,67,159
30040,Germany,1992.0,95,74,67,236
30041,Germany,1992.0,95,74,67,236
30042,Germany,1994.0,18,10,12,40
30043,Germany,1994.0,18,10,12,40
30044,Germany,1998.0,22,12,10,44
30045,Germany,2002.0,26,23,12,61
30046,Germany,2002.0,26,23,12,61
30047,Germany,2006.0,23,25,6,54
30048,Germany,2016.0,49,43,67,159
30049,Germany,2004.0,41,45,63,149
30050,Germany,1960.0,38,37,23,98
30051,Germany,1960.0,38,37,23,98
30052,Germany,1964.0,25,48,53,126
30053,Germany,1964.0,25,48,53,126
30054,Germany,1928.0,21,15,46,82
30055,Germany,1932.0,10,26,21,57
30056,Germany,1936.0,97,73,61,231
30057,Germany,1912.0,11,19,23,53
30058,Germany,2004.0,41,45,63,149
30059,Germany,1936.0,97,73,61,231
30060,Germany,1992.0,95,74,67,236
30061,Germany,1992.0,95,74,67,236
30062,Germany,1996.0,42,35,47,124
30063,Germany,1996.0,42,35,47,124
30064,Germany,1992.0,95,74,67,236
30065,Germany,1928.0,21,15,46,82
30066,Germany,1952.0,8,16,28,52
30067,Germany,1956.0,10,20,24,54
30068,Germany,2000.0,31,23,64,118
30069,Germany,1952.0,8,16,28,52
30070,Germany,1960.0,38,37,23,98
30071,Germany,1960.0,38,37,23,98
30072,Germany,2004.0,41,45,63,149
30073,Germany,2000.0,31,23,64,118
30074,Germany,1992.0,95,74,67,236
30075,Germany,1994.0,18,10,12,40
30076,Germany,1998.0,22,12,10,44
30077,Germany,2002.0,26,23,12,61
30078,Germany,1992.0,95,74,67,236
30079,Germany,2016.0,49,43,67,159
30080,Germany,1956.0,10,20,24,54
30081,Germany,1960.0,38,37,23,98
30082,Germany,1992.0,95,74,67,236
30083,Germany-1,2000.0,31,23,64,118
30084,Germany,1996.0,42,35,47,124
30085,Germany,2016.0,49,43,67,159
30086,Deutscher Schwimm Verband Berlin,1900.0,14,20,11,45
30087,Germany,1992.0,95,74,67,236
30088,Germany,1996.0,42,35,47,124
30089,Germany,2000.0,31,23,64,118
30090,Germany,1936.0,97,73,61,231
30091,Germany,1936.0,97,73,61,231
30092,Germany,2008.0,42,16,41,99
30093,Germany,2012.0,45,27,22,94
30094,Germany,2016.0,49,43,67,159
30095,Germany,1936.0,97,73,61,231
30096,Germany-2,1994.0,18,10,12,40
30097,Germany-2,1998.0,22,12,10,44
30098,Germany,2016.0,49,43,67,159
30099,Germany,1936.0,97,73,61,231
30100,Germany,2012.0,45,27,22,94
30101,Germany,2016.0,49,43,67,159
30102,Germany,1936.0,97,73,61,231
30103,Germany,1998.0,22,12,10,44
30104,Germany,2002.0,26,23,12,61
30105,Germany,2002.0,26,23,12,61
30106,Germany,1936.0,97,73,61,231
30107,Germany-1,1992.0,95,74,67,236
30108,Germany-1,1994.0,18,10,12,40
30109,Germany,1936.0,97,73,61,231
30110,Germany,1956.0,10,20,24,54
30111,Germany,1936.0,97,73,61,231
30112,Germany,2000.0,31,23,64,118
30113,Germany,2004.0,41,45,63,149
30114,Germany,2016.0,49,43,67,159
30115,Germany,2012.0,45,27,22,94
30116,Germany,1960.0,38,37,23,98
30117,Germany,2016.0,49,43,67,159
30118,Germany,1960.0,38,37,23,98
30119,Germany,1960.0,38,37,23,98
30120,Germany,1992.0,95,74,67,236
30121,Germany,1992.0,95,74,67,236
30122,Germany,1992.0,95,74,67,236
30123,Germany,1992.0,95,74,67,236
30124,Germany,1996.0,42,35,47,124
30125,Germany,1996.0,42,35,47,124
30126,Germany,1996.0,42,35,47,124
30127,Germany,1996.0,42,35,47,124
30128,Germany,1936.0,97,73,61,231
30129,Germany,1936.0,97,73,61,231
30130,Germany,2016.0,49,43,67,159
30131,Germany,2008.0,42,16,41,99
30132,Germany,2012.0,45,27,22,94
30133,Germany,2016.0,49,43,67,159
30134,Germany,2008.0,42,16,41,99
30135,Germany,2016.0,49,43,67,159
30136,Germany,1936.0,97,73,61,231
30137,Germany,1928.0,21,15,46,82
30138,Germany,2010.0,15,24,15,54
30139,Germany,2010.0,15,24,15,54
30140,Germany,1928.0,21,15,46,82
30141,Germany,1932.0,10,26,21,57
30142,Germany,1936.0,97,73,61,231
30143,Germany,2004.0,41,45,63,149
30144,Germany,2008.0,42,16,41,99
30145,Germany,2012.0,45,27,22,94
30146,Germany,1952.0,8,16,28,52
30147,Germany,2012.0,45,27,22,94
30148,Germany,2016.0,49,43,67,159
30149,Germany,1996.0,42,35,47,124
30150,Germany,1936.0,97,73,61,231
30151,Germany,1936.0,97,73,61,231
30152,Germany,1936.0,97,73,61,231
30153,Germany,1960.0,38,37,23,98
30154,Germany,1960.0,38,37,23,98
30155,Germany,2016.0,49,43,67,159
30156,Germany,1952.0,8,16,28,52
30157,Germany,1932.0,10,26,21,57
30158,Germany,1964.0,25,48,53,126
30159,Germany,1928.0,21,15,46,82
30160,Germany,1996.0,42,35,47,124
30161,Germany,2000.0,31,23,64,118
30162,Germany,1960.0,38,37,23,98
30163,Germany,1932.0,10,26,21,57
30164,Germany,1992.0,95,74,67,236
30165,Germany,2002.0,26,23,12,61
30166,Germany,2002.0,26,23,12,61
30167,Germany,2006.0,23,25,6,54
30168,Germany,2010.0,15,24,15,54
30169,Germany,2002.0,26,23,12,61
30170,Germany,1960.0,38,37,23,98
30171,Germany,2016.0,49,43,67,159
30172,Germany,1964.0,25,48,53,126
30173,Germany,1964.0,25,48,53,126
30174,Germany,2004.0,41,45,63,149
30175,Germany,1928.0,21,15,46,82
30176,Germany,1992.0,95,74,67,236
30177,Germany-1,2004.0,41,45,63,149
30178,Germany-1,1936.0,97,73,61,231
30179,Germany,1936.0,97,73,61,231
30180,Germany,2016.0,49,43,67,159
30181,Germany,1932.0,10,26,21,57
30182,Frankfurt Club,1900.0,14,20,11,45
30183,Germany,2014.0,15,12,9,36
30184,Germany,1936.0,97,73,61,231
30185,Germany-2,2002.0,26,23,12,61
30186,Germany,2016.0,49,43,67,159
30187,Germany-2,1928.0,21,15,46,82
30188,Germany,2002.0,26,23,12,61
30189,Germany,2006.0,23,25,6,54
30190,Germany,2006.0,23,25,6,54
30191,Germany,2006.0,23,25,6,54
30192,Germany,1964.0,25,48,53,126
30193,Germany,1964.0,25,48,53,126
30194,Germany,1992.0,95,74,67,236
30195,Germany,1928.0,21,15,46,82
30196,Germany-1,1994.0,18,10,12,40
30197,Germany,1936.0,97,73,61,231
30198,Germany,1992.0,95,74,67,236
30199,Germany,1960.0,38,37,23,98
30200,Germany,1964.0,25,48,53,126
30201,Germany,1896.0,25,5,2,32
30202,Germany,1896.0,25,5,2,32
30203,Germany,2000.0,31,23,64,118
30204,Germany,2004.0,41,45,63,149
30205,Germany,2008.0,42,16,41,99
30206,Germany,1928.0,21,15,46,82
30207,Germany,1964.0,25,48,53,126
30208,Germany,1928.0,21,15,46,82
30209,Germany,2002.0,26,23,12,61
30210,Germany,1932.0,10,26,21,57
30211,Germany,1992.0,95,74,67,236
30212,Germany,2012.0,45,27,22,94
30213,Germany,2016.0,49,43,67,159
30214,Germany,1936.0,97,73,61,231
30215,Germany,1908.0,4,11,6,21
30216,Germany,1904.0,4,5,7,16
30217,Germany,1904.0,4,5,7,16
30218,Germany,1906.0,14,10,6,30
30219,Germany,1992.0,95,74,67,236
30220,Germany,2000.0,31,23,64,118
30221,Germany,2010.0,15,24,15,54
30222,Germany,2010.0,15,24,15,54
30223,Germany,2014.0,15,12,9,36
30224,Germany,2014.0,15,12,9,36
30225,Germany,1996.0,42,35,47,124
30226,Germany,1896.0,25,5,2,32
30227,Germany,1896.0,25,5,2,32
30228,Germany,1964.0,25,48,53,126
30229,Frankfurt Club,1900.0,14,20,11,45
30230,Germany,2002.0,26,23,12,61
30231,Germany,1992.0,95,74,67,236
30232,Germany,1928.0,21,15,46,82
30233,Germany,1964.0,25,48,53,126
30234,Germany,2008.0,42,16,41,99
30235,Germany,2012.0,45,27,22,94
30236,Germany,2012.0,45,27,22,94
30237,Germany-1,2002.0,26,23,12,61
30238,Germany,1960.0,38,37,23,98
30239,Germany-1,2006.0,23,25,6,54
30240,Germany-1,1992.0,95,74,67,236
30241,Germany-1,1994.0,18,10,12,40
30242,Germany,1900.0,14,20,11,45
30243,Deutscher Schwimm Verband Berlin,1900.0,14,20,11,45
30244,Germany,1936.0,97,73,61,231
30245,Germany,1928.0,21,15,46,82
30246,Germany,2016.0,49,43,67,159
30247,Germany,1936.0,97,73,61,231
30248,Germany,1936.0,97,73,61,231
30249,Germany,1996.0,42,35,47,124
30250,Germany,1936.0,97,73,61,231
30251,Germany,1964.0,25,48,53,126
30252,Germany,1928.0,21,15,46,82
30253,Germania II,1936.0,97,73,61,231
30254,Germany,2010.0,15,24,15,54
30255,Germany,1964.0,25,48,53,126
30256,Germany-2,1928.0,21,15,46,82
30257,Germany-1,1932.0,10,26,21,57
30258,Germany,1908.0,4,11,6,21
30259,Germany,1960.0,38,37,23,98
30260,Germany,1936.0,97,73,61,231
30261,Germany,2006.0,23,25,6,54
30262,Germany,2010.0,15,24,15,54
30263,Germany,2014.0,15,12,9,36
30264,Germany,1996.0,42,35,47,124
30265,Germany,1992.0,95,74,67,236
30266,Germany,1992.0,95,74,67,236
30267,Germany,1992.0,95,74,67,236
30268,Germany,1996.0,42,35,47,124
30269,Germany,2000.0,31,23,64,118
30270,Germany,2008.0,42,16,41,99
30271,Germany,2016.0,49,43,67,159
30272,Germany,1936.0,97,73,61,231
30273,Germany,1936.0,97,73,61,231
30274,Germany,2004.0,41,45,63,149
30275,Germany,2008.0,42,16,41,99
30276,Germany,2012.0,45,27,22,94
30277,Germany,2004.0,41,45,63,149
30278,Germany,1928.0,21,15,46,82
30279,Germany,2016.0,49,43,67,159
30280,Germany,1932.0,10,26,21,57
30281,Germany,1936.0,97,73,61,231
30282,Germany,1936.0,97,73,61,231
30283,Germany,1936.0,97,73,61,231
30284,Germany,2016.0,49,43,67,159
30285,Germany,1964.0,25,48,53,126
30286,Germany,1932.0,10,26,21,57
30287,Germany,1996.0,42,35,47,124
30288,Germany,1994.0,18,10,12,40
30289,Germany,1998.0,22,12,10,44
30290,Germany-2,1998.0,22,12,10,44
30291,Germany,1992.0,95,74,67,236
30292,Germany,2016.0,49,43,67,159
30293,Germany,1936.0,97,73,61,231
30294,Germany,2004.0,41,45,63,149
30295,Germany,1964.0,25,48,53,126
30296,Germany,2016.0,49,43,67,159
30297,Germany,2012.0,45,27,22,94
30298,Germany,2016.0,49,43,67,159
30299,Germany,1932.0,10,26,21,57
30300,Germany,1932.0,10,26,21,57
30301,Germany,2000.0,31,23,64,118
30302,Germany,2004.0,41,45,63,149
30303,Germany,2012.0,45,27,22,94
30304,Germany,1936.0,97,73,61,231
30305,Germany,2012.0,45,27,22,94
30306,Germany,2012.0,45,27,22,94
30307,Germany,2016.0,49,43,67,159
30308,Germany,2016.0,49,43,67,159
30309,Germany,2016.0,49,43,67,159
30310,Germany,1992.0,95,74,67,236
30311,Germany,1928.0,21,15,46,82
30312,Germany,2004.0,41,45,63,149
30313,Macky VI,1960.0,38,37,23,98
30314,Germany,1928.0,21,15,46,82
30315,Germany,1936.0,97,73,61,231
30316,Germany,1960.0,38,37,23,98
30317,Germany,1936.0,97,73,61,231
30318,Germany,1906.0,14,10,6,30
30319,Germany,1936.0,97,73,61,231
30320,Germany,1932.0,10,26,21,57
30321,Germany,2016.0,49,43,67,159
30322,Germany,1936.0,97,73,61,231
30323,Germany,1964.0,25,48,53,126
30324,Germany,2014.0,15,12,9,36
30325,"Germania Ruder Club, Hamburg-2",1900.0,14,20,11,45
30326,Germany,1908.0,4,11,6,21
30327,Germany,1960.0,38,37,23,98
30328,Germany,1960.0,38,37,23,98
30329,Germany,1936.0,97,73,61,231
30330,Germany,1936.0,97,73,61,231
30331,Germany,1992.0,95,74,67,236
30332,Germany,1992.0,95,74,67,236
30333,Germany,2004.0,41,45,63,149
30334,Germany,1936.0,97,73,61,231
30335,Germany,1936.0,97,73,61,231
30336,Germany,1992.0,95,74,67,236
30337,Germany,1996.0,42,35,47,124
30338,Germany,1936.0,97,73,61,231
30339,Germany,2008.0,42,16,41,99
30340,Germany,2004.0,41,45,63,149
30341,Germany,1912.0,11,19,23,53
30342,Germany,1928.0,21,15,46,82
30343,Germany,1992.0,95,74,67,236
30344,Germany,2016.0,49,43,67,159
30345,Germany,2004.0,41,45,63,149
30346,Germany,2008.0,42,16,41,99
30347,Bonaparte,2008.0,42,16,41,99
30348,Germany,1928.0,21,15,46,82
30349,Germany,1936.0,97,73,61,231
30350,Germany,1952.0,8,16,28,52
30351,Germany,2016.0,49,43,67,159
30352,Germany,2016.0,49,43,67,159
30353,Germany,2004.0,41,45,63,149
30354,Germany,1964.0,25,48,53,126
30355,Germany,1992.0,95,74,67,236
30356,Germany,1992.0,95,74,67,236
30357,Germany,1996.0,42,35,47,124
30358,Germany,2000.0,31,23,64,118
30359,Germany,1936.0,97,73,61,231
30360,Germany,1996.0,42,35,47,124
30361,Germany-2,1928.0,21,15,46,82
30362,Germany-1,1932.0,10,26,21,57
30363,Germany-1,1960.0,38,37,23,98
30364,Germany-1,1964.0,25,48,53,126
30365,Germany,1960.0,38,37,23,98
30366,Germany,1996.0,42,35,47,124
30367,Germany,2002.0,26,23,12,61
30368,Germany,2006.0,23,25,6,54
30369,Germany,2010.0,15,24,15,54
30370,Germany,2014.0,15,12,9,36
30371,Germany,1992.0,95,74,67,236
30372,Germany,1996.0,42,35,47,124
30373,Germany,1996.0,42,35,47,124
30374,Germany,1996.0,42,35,47,124
30375,Germany,1992.0,95,74,67,236
30376,Germany,1992.0,95,74,67,236
30377,Germany,1992.0,95,74,67,236
30378,Germany,1994.0,18,10,12,40
30379,Germany,1996.0,42,35,47,124
30380,Germany,2004.0,41,45,63,149
30381,Germany,1996.0,42,35,47,124
30382,Germany,2008.0,42,16,41,99
30383,Germany,2012.0,45,27,22,94
30384,Germany,1964.0,25,48,53,126
30385,Germany,1964.0,25,48,53,126
30386,Germany,1964.0,25,48,53,126
30387,Germany,1964.0,25,48,53,126
30388,Germany,1952.0,8,16,28,52
30389,Germany,1952.0,8,16,28,52
30390,Germany,1992.0,95,74,67,236
30391,Germany,2008.0,42,16,41,99
30392,Germany,1956.0,10,20,24,54
30393,Germany,2004.0,41,45,63,149
30394,Germany,1996.0,42,35,47,124
30395,Germany,1928.0,21,15,46,82
30396,Germany,1960.0,38,37,23,98
30397,Germany,2008.0,42,16,41,99
30398,Germany,2012.0,45,27,22,94
30399,Germany,2016.0,49,43,67,159
30400,Germany,1964.0,25,48,53,126
30401,Germany,1936.0,97,73,61,231
30402,Germany,1936.0,97,73,61,231
30403,Germany,2000.0,31,23,64,118
30404,Germany,2016.0,49,43,67,159
30405,Germany,2008.0,42,16,41,99
30406,Germany,1952.0,8,16,28,52
30407,Germany,1992.0,95,74,67,236
30408,Germany,1936.0,97,73,61,231
30409,Germany,1956.0,10,20,24,54
30410,Germany,1960.0,38,37,23,98
30411,Germany,2006.0,23,25,6,54
30412,Germany,2014.0,15,12,9,36
30413,Germany,2000.0,31,23,64,118
30414,Germany,2000.0,31,23,64,118
30415,Germany,1964.0,25,48,53,126
30416,Germany,1992.0,95,74,67,236
30417,Germany,1912.0,11,19,23,53
30418,Germany,1936.0,97,73,61,231
30419,Germany,1960.0,38,37,23,98
30420,Germany,1964.0,25,48,53,126
30421,Germany,1956.0,10,20,24,54
30422,Germany,1960.0,38,37,23,98
30423,Germany,1960.0,38,37,23,98
30424,Germany,2000.0,31,23,64,118
30425,Germany,2000.0,31,23,64,118
30426,Germany,1932.0,10,26,21,57
30427,Germany,1964.0,25,48,53,126
30428,Germany,1992.0,95,74,67,236
30429,Germany,1996.0,42,35,47,124
30430,Germany,1932.0,10,26,21,57
30431,Germany,1912.0,11,19,23,53
30432,Germany,1912.0,11,19,23,53
30433,Germany,2008.0,42,16,41,99
30434,Germany,2012.0,45,27,22,94
30435,Germany,1964.0,25,48,53,126
30436,Favorite Hammonia-3,1900.0,14,20,11,45
30437,Germany,1928.0,21,15,46,82
30438,Germany,1928.0,21,15,46,82
30439,Germany,1932.0,10,26,21,57
30440,Germany,1936.0,97,73,61,231
30441,Germany,1936.0,97,73,61,231
30442,Germany,1964.0,25,48,53,126
30443,Germany,1928.0,21,15,46,82
30444,Germany,2000.0,31,23,64,118
30445,Germany,2000.0,31,23,64,118
30446,Germany,2008.0,42,16,41,99
30447,Germany,2000.0,31,23,64,118
30448,Germany,2000.0,31,23,64,118
30449,Germany,2004.0,41,45,63,149
30450,Germany,2008.0,42,16,41,99
30451,Germany,2016.0,49,43,67,159
30452,Germany,2016.0,49,43,67,159
30453,Germany,1906.0,14,10,6,30
30454,Germany,1996.0,42,35,47,124
30455,Germany,1936.0,97,73,61,231
30456,Germany,2014.0,15,12,9,36
30457,Germany,1960.0,38,37,23,98
30458,Germany-1,1992.0,95,74,67,236
30459,Germany-1,1994.0,18,10,12,40
30460,Germany-1,1998.0,22,12,10,44
30461,Germany,1998.0,22,12,10,44
30462,Germany,2002.0,26,23,12,61
30463,Germany,2006.0,23,25,6,54
30464,Germany,1936.0,97,73,61,231
30465,Germany,1928.0,21,15,46,82
30466,Germany,1936.0,97,73,61,231
30467,Germany-2,1928.0,21,15,46,82
30468,Germany,2012.0,45,27,22,94
30469,Germany,2004.0,41,45,63,149
30470,Germany,1936.0,97,73,61,231
30471,Frankfurt Club,1900.0,14,20,11,45
30472,Germany,1912.0,11,19,23,53
30473,Germany,2016.0,49,43,67,159
30474,Rostock,1936.0,97,73,61,231
30475,Ludwigshafener Ruder Verein-1,1900.0,14,20,11,45
30476,Germany,1936.0,97,73,61,231
30477,Germany,2016.0,49,43,67,159
30478,Germany,1936.0,97,73,61,231
30479,Germany,1960.0,38,37,23,98
30480,Germany,2000.0,31,23,64,118
30481,Germany,2004.0,41,45,63,149
30482,Germany,1936.0,97,73,61,231
30483,Germany,2016.0,49,43,67,159
30484,Germany,2012.0,45,27,22,94
30485,Germany,2016.0,49,43,67,159
30486,St. Louis Southwest Turnverein #2-3,1904.0,4,5,7,16
30487,Germany,1904.0,4,5,7,16
30488,Germany,1904.0,4,5,7,16
30489,Germany,1904.0,4,5,7,16
30490,Germany,2004.0,41,45,63,149
30491,Germany-1,1992.0,95,74,67,236
30492,Germany-2,2002.0,26,23,12,61
30493,Germany,1952.0,8,16,28,52
30494,Germany,2016.0,49,43,67,159
30495,Germany,1992.0,95,74,67,236
30496,Germany,1964.0,25,48,53,126
30497,Germany,1996.0,42,35,47,124
30498,Germany,2000.0,31,23,64,118
30499,Germany,2004.0,41,45,63,149
30500,Germany,2002.0,26,23,12,61
30501,Germany,2006.0,23,25,6,54
30502,Germany,2006.0,23,25,6,54
30503,Germany,2010.0,15,24,15,54
30504,Germany,2010.0,15,24,15,54
30505,Germany,2014.0,15,12,9,36
30506,Germany,1960.0,38,37,23,98
30507,Germany,1906.0,14,10,6,30
30508,Germany,2000.0,31,23,64,118
30509,Germany,1956.0,10,20,24,54
30510,Germany,1964.0,25,48,53,126
30511,Germany,1956.0,10,20,24,54
30512,Germany,1992.0,95,74,67,236
30513,Germany,2004.0,41,45,63,149
30514,Germany,2012.0,45,27,22,94
30515,Germany,1936.0,97,73,61,231
30516,Germany-2,2002.0,26,23,12,61
30517,Germany-1,2006.0,23,25,6,54
30518,Germany-1,2006.0,23,25,6,54
30519,Germany-1,2010.0,15,24,15,54
30520,Germany-1,2010.0,15,24,15,54
30521,Germany,2004.0,41,45,63,149
30522,Germany,2004.0,41,45,63,149
30523,Germany,1928.0,21,15,46,82
30524,Germany,1928.0,21,15,46,82
30525,Germany,1928.0,21,15,46,82
30526,Germany,1996.0,42,35,47,124
30527,Germany,1936.0,97,73,61,231
30528,Frankfurt Club,1900.0,14,20,11,45
30529,Germany,1960.0,38,37,23,98
30530,Germany-2,2002.0,26,23,12,61
30531,Germany-1,2006.0,23,25,6,54
30532,Germany-1,2006.0,23,25,6,54
30533,Germany-1,2010.0,15,24,15,54
30534,Germany-1,2010.0,15,24,15,54
30535,Germany,1960.0,38,37,23,98
30536,Germany,1992.0,95,74,67,236
30537,Germany,1996.0,42,35,47,124
30538,Germany,2012.0,45,27,22,94
30539,Germany-2,1992.0,95,74,67,236
30540,Germany-1,1998.0,22,12,10,44
30541,Germany-2,1998.0,22,12,10,44
30542,Germany-1,2002.0,26,23,12,61
30543,Germany,1960.0,38,37,23,98
30544,Germany,1936.0,97,73,61,231
30545,Germany,2004.0,41,45,63,149
30546,Frankfurt Club,1900.0,14,20,11,45
30547,Germany,1992.0,95,74,67,236
30548,Germany,2004.0,41,45,63,149
30549,Germany,2008.0,42,16,41,99
30550,Germany,2016.0,49,43,67,159
30551,Germany,1960.0,38,37,23,98
30552,Germany,1960.0,38,37,23,98
30553,Germany,2016.0,49,43,67,159
30554,Ludwigshafener Ruder Verein-1,1900.0,14,20,11,45
30555,Germany,1992.0,95,74,67,236
30556,Germany,1992.0,95,74,67,236
30557,Germany,2000.0,31,23,64,118
30558,Germany,2000.0,31,23,64,118
30559,Germany,2004.0,41,45,63,149
30560,Germany,1964.0,25,48,53,126
30561,Germany,1936.0,97,73,61,231
30562,Germany,1932.0,10,26,21,57
30563,Germany-2,2002.0,26,23,12,61
30564,Germany-2,2010.0,15,24,15,54
30565,Germany,2016.0,49,43,67,159
30566,Germany,1960.0,38,37,23,98
30567,Germany,2004.0,41,45,63,149
30568,Germany,2004.0,41,45,63,149
30569,Germany,2012.0,45,27,22,94
30570,Germany,1936.0,97,73,61,231
30571,Germany,2014.0,15,12,9,36
30572,Germany,2014.0,15,12,9,36
30573,Germany,1992.0,95,74,67,236
30574,Germany,1928.0,21,15,46,82
30575,Germany,2016.0,49,43,67,159
30576,Germany,2008.0,42,16,41,99
30577,Germany,2012.0,45,27,22,94
30578,Germany,2012.0,45,27,22,94
30579,Deutscher Schwimm Verband Berlin,1900.0,14,20,11,45
30580,Berliner Ruderverein von 1876-2,1912.0,11,19,23,53
30581,Germany,2016.0,49,43,67,159
30582,Germany,2016.0,49,43,67,159
30583,Germany,1912.0,11,19,23,53
30584,Germany,1964.0,25,48,53,126
30585,Germany,1964.0,25,48,53,126
30586,Germany,1964.0,25,48,53,126
30587,Germany,2000.0,31,23,64,118
30588,Germany,2000.0,31,23,64,118
30589,Germany,2004.0,41,45,63,149
30590,Germany,2008.0,42,16,41,99
30591,Germany,1964.0,25,48,53,126
30592,Germany,1928.0,21,15,46,82
30593,Germany,1956.0,10,20,24,54
30594,Germany,1956.0,10,20,24,54
30595,Germany,1936.0,97,73,61,231
30596,Germany,1964.0,25,48,53,126
30597,Germany,1960.0,38,37,23,98
30598,Germany,2010.0,15,24,15,54
30599,Germany,2014.0,15,12,9,36
30600,Germany,2014.0,15,12,9,36
30601,Germany-1,1992.0,95,74,67,236
30602,Germany,1936.0,97,73,61,231
30603,Germany,1964.0,25,48,53,126
30604,Germany,1936.0,97,73,61,231
30605,Germany,1936.0,97,73,61,231
30606,Germany,1936.0,97,73,61,231
30607,Germany,2016.0,49,43,67,159
30608,Mutafo,1964.0,25,48,53,126
30609,Germany,1960.0,38,37,23,98
30610,Germany,1964.0,25,48,53,126
30611,Germany,1912.0,11,19,23,53
30612,Germany,1994.0,18,10,12,40
30613,Germany,1994.0,18,10,12,40
30614,Germany,1998.0,22,12,10,44
30615,Germany,2002.0,26,23,12,61
30616,Germany,2002.0,26,23,12,61
30617,Germany,1956.0,10,20,24,54
30618,Germany,1996.0,42,35,47,124
30619,Frankfurt Club,1900.0,14,20,11,45
30620,Germany-1,2016.0,49,43,67,159
30621,Germany-1,1932.0,10,26,21,57
30622,Frankfurt Club,1900.0,14,20,11,45
30623,Germany,1952.0,8,16,28,52
30624,Deutscher Schwimm Verband Berlin,1900.0,14,20,11,45
30625,Germany,1996.0,42,35,47,124
30626,Germany,2008.0,42,16,41,99
30627,Germany,2012.0,45,27,22,94
30628,Germany,2004.0,41,45,63,149
30629,Germany,1956.0,10,20,24,54
30630,Germany,1956.0,10,20,24,54
30631,Germany,1956.0,10,20,24,54
30632,Germany,2000.0,31,23,64,118
30633,Germany,2004.0,41,45,63,149
30634,Germany,2008.0,42,16,41,99
30635,Germany,1912.0,11,19,23,53
30636,Germany,2000.0,31,23,64,118
30637,Germany,1964.0,25,48,53,126
30638,Germany,1960.0,38,37,23,98
30639,Germany,1936.0,97,73,61,231
30640,Germany,1932.0,10,26,21,57
30641,Germany,1936.0,97,73,61,231
30642,Germany,2016.0,49,43,67,159
30643,Ludwigshafener Ruderverein,1912.0,11,19,23,53
30644,Germany,1912.0,11,19,23,53
30645,Germany,1952.0,8,16,28,52
30646,Germany,1936.0,97,73,61,231
30647,Germany-2,1992.0,95,74,67,236
30648,Germany,1896.0,25,5,2,32
30649,Germany,1896.0,25,5,2,32
30650,Germany,1936.0,97,73,61,231
30651,Germany,1936.0,97,73,61,231
30652,Germany,1936.0,97,73,61,231
30653,Germany,1936.0,97,73,61,231
30654,Germany,1960.0,38,37,23,98
30655,Germany,2016.0,49,43,67,159
30656,Germany,1908.0,4,11,6,21
30657,Germany,2012.0,45,27,22,94
30658,Germany,2004.0,41,45,63,149
30659,Berliner Ruderverein von 1876-2,1912.0,11,19,23,53
30660,Germany,2010.0,15,24,15,54
30661,Germany,1936.0,97,73,61,231
30662,Germany,2016.0,49,43,67,159
30663,Germany,2016.0,49,43,67,159
30664,Germany,1992.0,95,74,67,236
30665,Germany,1928.0,21,15,46,82
30666,Germany,1936.0,97,73,61,231
30667,Germany,1992.0,95,74,67,236
30668,Germany,2004.0,41,45,63,149
30669,Germany,1960.0,38,37,23,98
30670,Germany,1992.0,95,74,67,236
30671,Germany-1,1932.0,10,26,21,57
30672,Germany,1936.0,97,73,61,231
30673,Germany,2000.0,31,23,64,118
30674,Germany,2008.0,42,16,41,99
30675,Germany,1992.0,95,74,67,236
30676,Germany,1936.0,97,73,61,231
30677,Germany,1936.0,97,73,61,231
30678,Germany,2012.0,45,27,22,94
30679,Mutafo,1964.0,25,48,53,126
30680,Germany,1996.0,42,35,47,124
30681,Germany,2000.0,31,23,64,118
30682,Germany,1936.0,97,73,61,231
30683,Germany,1936.0,97,73,61,231
30684,Germany,1960.0,38,37,23,98
30685,Germany,1964.0,25,48,53,126
30686,Germany,1992.0,95,74,67,236
30687,Germany,1992.0,95,74,67,236
30688,Germany,1992.0,95,74,67,236
30689,Germany,2000.0,31,23,64,118
30690,Germany,1964.0,25,48,53,126
30691,Germany,2016.0,49,43,67,159
30692,Germany,1936.0,97,73,61,231
30693,Germany,1932.0,10,26,21,57
30694,Germany,2016.0,49,43,67,159
30695,Germany,2004.0,41,45,63,149
30696,Germany,1992.0,95,74,67,236
30697,Germany,1992.0,95,74,67,236
30698,Germany,1956.0,10,20,24,54
30699,Germany,1936.0,97,73,61,231
30700,Germany,2000.0,31,23,64,118
30701,Germany,2004.0,41,45,63,149
30702,Germany,1992.0,95,74,67,236
30703,Germany,1992.0,95,74,67,236
30704,Germany,1992.0,95,74,67,236
30705,Germany,1994.0,18,10,12,40
30706,Germany,2008.0,42,16,41,99
30707,Germany,2016.0,49,43,67,159
30708,Germany,1998.0,22,12,10,44
30709,Germany,1928.0,21,15,46,82
30710,Germania II,1936.0,97,73,61,231
30711,Germany,1936.0,97,73,61,231
30712,Favorite Hammonia-3,1900.0,14,20,11,45
30713,Germany,2010.0,15,24,15,54
30714,Germany,1996.0,42,35,47,124
30715,Germany,2008.0,42,16,41,99
30716,Favorite Hammonia-3,1900.0,14,20,11,45
30717,Germany,1996.0,42,35,47,124
30718,Germany,2000.0,31,23,64,118
30719,Germany,1928.0,21,15,46,82
30720,Macky VI,1960.0,38,37,23,98
30721,Germany,1928.0,21,15,46,82
30722,Germany,2000.0,31,23,64,118
30723,Frankfurt Club,1900.0,14,20,11,45
30724,Germany,1928.0,21,15,46,82
30725,Germany,1906.0,14,10,6,30
30726,Germany,1998.0,22,12,10,44
30727,Germany,2016.0,49,43,67,159
30728,Germany,1992.0,95,74,67,236
30729,Germany,2012.0,45,27,22,94
30730,Germany,2004.0,41,45,63,149
30731,Germany,2016.0,49,43,67,159
30732,Germany,2008.0,42,16,41,99
30733,Germany,2012.0,45,27,22,94
30734,Germany,2004.0,41,45,63,149
30735,Germany,1992.0,95,74,67,236
30736,Germany,1936.0,97,73,61,231
30737,Germany,2016.0,49,43,67,159
30738,Germany,2000.0,31,23,64,118
30739,Germany,1992.0,95,74,67,236
30740,Germany,2016.0,49,43,67,159
30741,Germany,1936.0,97,73,61,231
30742,Germany-1,1992.0,95,74,67,236
30743,Germany,1992.0,95,74,67,236
30744,Germany-2,1928.0,21,15,46,82
30745,Gustel X,1952.0,8,16,28,52
30746,Aschenbrodel,1900.0,14,20,11,45
30747,Aschenbrodel,1900.0,14,20,11,45
30748,Germany,1960.0,38,37,23,98
30749,Germany,1964.0,25,48,53,126
30750,Germany,1992.0,95,74,67,236
30751,Germany,2004.0,41,45,63,149
30752,Germany,1992.0,95,74,67,236
30753,Germany,1896.0,25,5,2,32
30754,Germany,1896.0,25,5,2,32
30755,Germany,1992.0,95,74,67,236
30756,Germany,1928.0,21,15,46,82
30757,Germany,1932.0,10,26,21,57
30758,Germany,1928.0,21,15,46,82
30759,Germany,2010.0,15,24,15,54
30760,Germany,1908.0,4,11,6,21
30761,Germany,1908.0,4,11,6,21
30762,Germany,1992.0,95,74,67,236
30763,Germany,2010.0,15,24,15,54
30764,Germany,2010.0,15,24,15,54
30765,Germany,2010.0,15,24,15,54
30766,Germany,1964.0,25,48,53,126
30767,Germany,2008.0,42,16,41,99
30768,Germany,2012.0,45,27,22,94
30769,Germany,2012.0,45,27,22,94
30770,Germany,1996.0,42,35,47,124
30771,Germany,2000.0,31,23,64,118
30772,Germany-1,1952.0,8,16,28,52
30773,Germany,1952.0,8,16,28,52
30774,Germany,1998.0,22,12,10,44
30775,Germany,2002.0,26,23,12,61
30776,Germany,1992.0,95,74,67,236
30777,Germany,1992.0,95,74,67,236
30778,Germany,1992.0,95,74,67,236
30779,Germany,1994.0,18,10,12,40
30780,Germany,1994.0,18,10,12,40
30781,Germany,1998.0,22,12,10,44
30782,Germany,1998.0,22,12,10,44
30783,Germany,1998.0,22,12,10,44
30784,Germany,2000.0,31,23,64,118
30785,Germany,2004.0,41,45,63,149
30786,Germany,2004.0,41,45,63,149
30787,Germany,2008.0,42,16,41,99
30788,Germany,1964.0,25,48,53,126
30789,Germany,1952.0,8,16,28,52
30790,Germany,2004.0,41,45,63,149
30791,Germany,1956.0,10,20,24,54
30792,Germany,1956.0,10,20,24,54
30793,Germany,1964.0,25,48,53,126
30794,Germany,1992.0,95,74,67,236
30795,Germany,1992.0,95,74,67,236
30796,Gustel X,1952.0,8,16,28,52
30797,Germany,1936.0,97,73,61,231
30798,Germany,2008.0,42,16,41,99
30799,Germany,2012.0,45,27,22,94
30800,Germany,1960.0,38,37,23,98
30801,Germany,2016.0,49,43,67,159
30802,Germany,2004.0,41,45,63,149
30803,Germany,1964.0,25,48,53,126
30804,Germany,1928.0,21,15,46,82
30805,Germany,2008.0,42,16,41,99
30806,Germany,1936.0,97,73,61,231
30807,Germany,2016.0,49,43,67,159
30808,Germany,2004.0,41,45,63,149
30809,Germany,2006.0,23,25,6,54
30810,Germany,2004.0,41,45,63,149
30811,Germany,2008.0,42,16,41,99
30812,Germany,2012.0,45,27,22,94
30813,Germany,1936.0,97,73,61,231
30814,Germany,2016.0,49,43,67,159
30815,Germany,2016.0,49,43,67,159
30816,Germany,2008.0,42,16,41,99
30817,Germany-1,1952.0,8,16,28,52
30818,Germany,1952.0,8,16,28,52
30819,Germany,1992.0,95,74,67,236
30820,Germany,1992.0,95,74,67,236
30821,Germany,1996.0,42,35,47,124
30822,Germany,1996.0,42,35,47,124
30823,Germany,2016.0,49,43,67,159
30824,Germany,2012.0,45,27,22,94
30825,Germany,1912.0,11,19,23,53
30826,Germany,2002.0,26,23,12,61
30827,Germany,2006.0,23,25,6,54
30828,Germany,2008.0,42,16,41,99
30829,Germany,2012.0,45,27,22,94
30830,Germany,2012.0,45,27,22,94
30831,Germany,2016.0,49,43,67,159
30832,Germany,1960.0,38,37,23,98
30833,Germany,1964.0,25,48,53,126
30834,Germany,1906.0,14,10,6,30
30835,Germany,1992.0,95,74,67,236
30836,Germany,1992.0,95,74,67,236
30837,Germany,1992.0,95,74,67,236
30838,Germany,1994.0,18,10,12,40
30839,Germany,1994.0,18,10,12,40
30840,Germany,1998.0,22,12,10,44
30841,Germany,1998.0,22,12,10,44
30842,Germany,2002.0,26,23,12,61
30843,Germany,2002.0,26,23,12,61
30844,Germany,2006.0,23,25,6,54
30845,Germany,2006.0,23,25,6,54
30846,Germany,1960.0,38,37,23,98
30847,Germany,2008.0,42,16,41,99
30848,Germany,2008.0,42,16,41,99
30849,Germany,2014.0,15,12,9,36
30850,Germany,2016.0,49,43,67,159
30851,Germany,1960.0,38,37,23,98
30852,Germany,1964.0,25,48,53,126
30853,Germany,1992.0,95,74,67,236
30854,Germany,2008.0,42,16,41,99
30855,Germany,2016.0,49,43,67,159
30856,Germany,1992.0,95,74,67,236
30857,Germany,1936.0,97,73,61,231
30858,Germany,2012.0,45,27,22,94
30859,Aschenbrodel,1900.0,14,20,11,45
30860,Aschenbrodel,1900.0,14,20,11,45
30861,Germany,1992.0,95,74,67,236
30862,Germany,1992.0,95,74,67,236
30863,Germany,2004.0,41,45,63,149
30864,Germany,1952.0,8,16,28,52
30865,Germany,2016.0,49,43,67,159
30866,Germany,1992.0,95,74,67,236
30867,Germany,1906.0,14,10,6,30
30868,Germany,2004.0,41,45,63,149
30869,Germany,1936.0,97,73,61,231
30870,Germany,1996.0,42,35,47,124
30871,Germany,2000.0,31,23,64,118
30872,Germany,2016.0,49,43,67,159
30873,Germany,1992.0,95,74,67,236
30874,Germany,1996.0,42,35,47,124
30875,Germany,1936.0,97,73,61,231
30876,Germany,1928.0,21,15,46,82
30877,Germany,1964.0,25,48,53,126
30878,Germany,1964.0,25,48,53,126
30879,Germany,2016.0,49,43,67,159
30880,Germany,2004.0,41,45,63,149
30881,Germany,1956.0,10,20,24,54
30882,Germany,2004.0,41,45,63,149
30883,Germany,2008.0,42,16,41,99
30884,Germany,1936.0,97,73,61,231
30885,Germany,2004.0,41,45,63,149
30886,Germany,2000.0,31,23,64,118
30887,Germany,1936.0,97,73,61,231
30888,Germany,1936.0,97,73,61,231
30889,Germany,1936.0,97,73,61,231
30890,Germany,1952.0,8,16,28,52
30891,Germany,1956.0,10,20,24,54
30892,Germany,2016.0,49,43,67,159
30893,Frankfurt Club,1900.0,14,20,11,45
30894,Germany,1992.0,95,74,67,236
30895,Germany,1992.0,95,74,67,236
30896,Germany,1996.0,42,35,47,124
30897,Germany,1996.0,42,35,47,124
30898,Germany,1952.0,8,16,28,52
30899,Germany,1912.0,11,19,23,53
30900,Germany,1996.0,42,35,47,124
30901,Germany,2000.0,31,23,64,118
30902,Germany,2004.0,41,45,63,149
30903,Germany,2008.0,42,16,41,99
30904,Germany,1928.0,21,15,46,82
30905,Germany-1,2002.0,26,23,12,61
30906,Germany-1,2006.0,23,25,6,54
30907,Germany,2016.0,49,43,67,159
30908,Germany,1992.0,95,74,67,236
30909,Germany-1,2006.0,23,25,6,54
30910,Germany-1,2010.0,15,24,15,54
30911,Germany,1992.0,95,74,67,236
30912,Germany,1992.0,95,74,67,236
30913,Germany,1992.0,95,74,67,236
30914,Germany,1996.0,42,35,47,124
30915,Germany,1936.0,97,73,61,231
30916,Germany,1992.0,95,74,67,236
30917,Germany,2012.0,45,27,22,94
30918,Germany,1936.0,97,73,61,231
30919,Germany,1928.0,21,15,46,82
30920,Germany,1928.0,21,15,46,82
30921,Germany,1932.0,10,26,21,57
30922,Germany,1928.0,21,15,46,82
30923,Germany,1932.0,10,26,21,57
30924,Germany,1928.0,21,15,46,82
30925,Germany,1964.0,25,48,53,126
30926,Germany,1956.0,10,20,24,54
30927,Germany,2004.0,41,45,63,149
30928,Germany,2004.0,41,45,63,149
30929,Germany,2000.0,31,23,64,118
30930,Germany,2004.0,41,45,63,149
30931,Germany,2008.0,42,16,41,99
30932,Germany,2016.0,49,43,67,159
30933,Germany,1904.0,4,5,7,16
30934,Germany,1904.0,4,5,7,16
30935,Germany,1904.0,4,5,7,16
30936,Germany,1906.0,14,10,6,30
30937,Germany,2010.0,15,24,15,54
30938,Germany,2014.0,15,12,9,36
30939,Germany-1,2012.0,45,27,22,94
30940,Germany,1960.0,38,37,23,98
30941,Germany,1992.0,95,74,67,236
30942,Berliner Ruderverein von 1876-2,1912.0,11,19,23,53
30943,Germany,1952.0,8,16,28,52
30944,Germany,1956.0,10,20,24,54
30945,Germany,2016.0,49,43,67,159
30946,Germany,1992.0,95,74,67,236
30947,Germany,2004.0,41,45,63,149
30948,Germany,1992.0,95,74,67,236
30949,Germany,1996.0,42,35,47,124
30950,Germany,2012.0,45,27,22,94
30951,Germany,2016.0,49,43,67,159
30952,Germany,2004.0,41,45,63,149
30953,Germany,1936.0,97,73,61,231
30954,Germany,2008.0,42,16,41,99
30955,Germany,1964.0,25,48,53,126
30956,Germany,2008.0,42,16,41,99
30957,Germany,2016.0,49,43,67,159
30958,Germany,1992.0,95,74,67,236
30959,Frankfurt Club,1900.0,14,20,11,45
30960,Germany,1908.0,4,11,6,21
30961,Germany,2016.0,49,43,67,159
30962,Germany,2016.0,49,43,67,159
30963,Germany,1992.0,95,74,67,236
30964,Germany,1960.0,38,37,23,98
30965,Germany,1998.0,22,12,10,44
30966,Germany-2,2002.0,26,23,12,61
30967,Germany-2,2010.0,15,24,15,54
30968,Germany,1960.0,38,37,23,98
30969,Germany,2016.0,49,43,67,159
30970,Germany,1992.0,95,74,67,236
30971,Germany,1992.0,95,74,67,236
30972,Germany,1964.0,25,48,53,126
30973,Germany,1992.0,95,74,67,236
30974,Germany,1992.0,95,74,67,236
30975,Germany,1996.0,42,35,47,124
30976,Germany,2012.0,45,27,22,94
30977,Germany,1956.0,10,20,24,54
30978,Germany,1936.0,97,73,61,231
30979,Germany,1996.0,42,35,47,124
30980,Germany,2000.0,31,23,64,118
30981,Germany,1992.0,95,74,67,236
30982,Germany,1928.0,21,15,46,82
30983,Germany,1960.0,38,37,23,98
30984,Germany,2014.0,15,12,9,36
30985,Germany,2014.0,15,12,9,36
30986,Germany,2004.0,41,45,63,149
30987,Germany,1906.0,14,10,6,30
30988,Germany,1964.0,25,48,53,126
30989,Germany,2004.0,41,45,63,149
30990,Germany-1,2010.0,15,24,15,54
30991,Germany,1996.0,42,35,47,124
30992,Germany,2016.0,49,43,67,159
30993,Germany,1936.0,97,73,61,231
30994,Germany,2008.0,42,16,41,99
30995,Germany,2008.0,42,16,41,99
30996,Germany,1932.0,10,26,21,57
30997,Germany,1906.0,14,10,6,30
30998,Germany,1906.0,14,10,6,30
30999,Germany,2006.0,23,25,6,54
31000,Germany,1936.0,97,73,61,231
31001,Germany,1956.0,10,20,24,54
31002,Germany,1912.0,11,19,23,53
31003,Germany,1992.0,95,74,67,236
31004,Germany,1996.0,42,35,47,124
31005,Germany,1992.0,95,74,67,236
31006,Germany,1964.0,25,48,53,126
31007,Germany,1896.0,25,5,2,32
31008,Germany,1896.0,25,5,2,32
31009,Germany,1952.0,8,16,28,52
31010,Germany,1956.0,10,20,24,54
31011,Germany,2016.0,49,43,67,159
31012,Germany,1992.0,95,74,67,236
31013,Germany,2000.0,31,23,64,118
31014,Germany,2004.0,41,45,63,149
31015,Germany,1936.0,97,73,61,231
31016,Germany,1996.0,42,35,47,124
31017,Germany,1992.0,95,74,67,236
31018,Germany-2,1992.0,95,74,67,236
31019,Germany,2016.0,49,43,67,159
31020,Germany,1960.0,38,37,23,98
31021,Germany,1996.0,42,35,47,124
31022,Germany,1936.0,97,73,61,231
31023,Berliner Ruderverein von 1876-2,1912.0,11,19,23,53
31024,Germany,2000.0,31,23,64,118
31025,Germany,2004.0,41,45,63,149
31026,Favorite Hammonia-3,1900.0,14,20,11,45
31027,Germany,1996.0,42,35,47,124
31028,Germany,2000.0,31,23,64,118
31029,Germany,2004.0,41,45,63,149
31030,Germany,2010.0,15,24,15,54
31031,Germany,2014.0,15,12,9,36
31032,Germany,1996.0,42,35,47,124
31033,Germany,2002.0,26,23,12,61
31034,Germany,2002.0,26,23,12,61
31035,Germany,2006.0,23,25,6,54
31036,Germany,2010.0,15,24,15,54
31037,Germany,2010.0,15,24,15,54
31038,Germany,1992.0,95,74,67,236
31039,Germany,2000.0,31,23,64,118
31040,Germany,2000.0,31,23,64,118
31041,Germany,2004.0,41,45,63,149
31042,Germany,2004.0,41,45,63,149
31043,Germany,1952.0,8,16,28,52
31044,Germany,1952.0,8,16,28,52
31045,Germany,2012.0,45,27,22,94
31046,Germany,2016.0,49,43,67,159
31047,Germany-1,2010.0,15,24,15,54
31048,Germany-1,2014.0,15,12,9,36
31049,Germany,1952.0,8,16,28,52
31050,Germany,1936.0,97,73,61,231
31051,Germany,1936.0,97,73,61,231
31052,Germany,2000.0,31,23,64,118
31053,Germany,1928.0,21,15,46,82
31054,Germany,2004.0,41,45,63,149
31055,Germany,1996.0,42,35,47,124
31056,Germany,2004.0,41,45,63,149
31057,Germany,2016.0,49,43,67,159
31058,Germania II,1936.0,97,73,61,231
31059,Germany,1992.0,95,74,67,236
31060,Germany,2004.0,41,45,63,149
31061,Germany,2014.0,15,12,9,36
31062,Germany,1994.0,18,10,12,40
31063,Germany,1960.0,38,37,23,98
31064,Germany,1960.0,38,37,23,98
31065,Germany,1936.0,97,73,61,231
31066,Germany,1952.0,8,16,28,52
31067,Germany,1956.0,10,20,24,54
31068,Germany,1956.0,10,20,24,54
31069,Germany,1906.0,14,10,6,30
31070,Germany,2008.0,42,16,41,99
31071,Germany,1932.0,10,26,21,57
31072,Germany,2002.0,26,23,12,61
31073,Germany,2002.0,26,23,12,61
31074,Germany,2006.0,23,25,6,54
31075,Germany,1936.0,97,73,61,231
31076,Germany,1932.0,10,26,21,57
31077,Germany,1960.0,38,37,23,98
31078,Germany,1964.0,25,48,53,126
31079,Germany,2004.0,41,45,63,149
31080,Germany,1932.0,10,26,21,57
31081,Germany,2016.0,49,43,67,159
31082,Germany,1936.0,97,73,61,231
31083,Germany,2004.0,41,45,63,149
31084,Germany,1960.0,38,37,23,98
31085,Germany,1928.0,21,15,46,82
31086,Germany,2012.0,45,27,22,94
31087,Germany,2016.0,49,43,67,159
31088,Germany,1992.0,95,74,67,236
31089,Germany,2000.0,31,23,64,118
31090,Frankfurt Club,1900.0,14,20,11,45
31091,Germany,1992.0,95,74,67,236
31092,Germany,1936.0,97,73,61,231
31093,Germany,1998.0,22,12,10,44
31094,Germany,2002.0,26,23,12,61
31095,Germany,2010.0,15,24,15,54
31096,Germany,1936.0,97,73,61,231
31097,Germany,2012.0,45,27,22,94
31098,Germany,2016.0,49,43,67,159
31099,Germany,1936.0,97,73,61,231
31100,Germany,1906.0,14,10,6,30
31101,Germany,1906.0,14,10,6,30
31102,Germany,1906.0,14,10,6,30
31103,Germany-1,2006.0,23,25,6,54
31104,Germany,1964.0,25,48,53,126
31105,Germany,1960.0,38,37,23,98
31106,Germany,1996.0,42,35,47,124
31107,Germany,1912.0,11,19,23,53
31108,Germany,1906.0,14,10,6,30
31109,Germany,2008.0,42,16,41,99
31110,Germany,2012.0,45,27,22,94
31111,Germany,2016.0,49,43,67,159
31112,Germany,2012.0,45,27,22,94
31113,Germany,1928.0,21,15,46,82
31114,Germany,1992.0,95,74,67,236
31115,Germany,1964.0,25,48,53,126
31116,Germany,1964.0,25,48,53,126
31117,Germany,2016.0,49,43,67,159
31118,Germany,1964.0,25,48,53,126
31119,Germany,1960.0,38,37,23,98
31120,Germany,1932.0,10,26,21,57
31121,Germany,1996.0,42,35,47,124
31122,Germany,2000.0,31,23,64,118
31123,Germany,1896.0,25,5,2,32
31124,Germany,1896.0,25,5,2,32
31125,Germany,1896.0,25,5,2,32
31126,Germany,1896.0,25,5,2,32
31127,Germany,1896.0,25,5,2,32
31128,Germany,1896.0,25,5,2,32
31129,Germany,2016.0,49,43,67,159
31130,Germany,1992.0,95,74,67,236
31131,Germany,2004.0,41,45,63,149
31132,Germany,1964.0,25,48,53,126
31133,Germany,1964.0,25,48,53,126
31134,Germany,1964.0,25,48,53,126
31135,Germany,1964.0,25,48,53,126
31136,Germany,1932.0,10,26,21,57
31137,Germany,1936.0,97,73,61,231
31138,Germany,2012.0,45,27,22,94
31139,Germany,2016.0,49,43,67,159
31140,Germany,1996.0,42,35,47,124
31141,Germany,2000.0,31,23,64,118
31142,Germany,2000.0,31,23,64,118
31143,Germany,1992.0,95,74,67,236
31144,Germany,1996.0,42,35,47,124
31145,Germany,2004.0,41,45,63,149
31146,Germany,2008.0,42,16,41,99
31147,Germany,1956.0,10,20,24,54
31148,Germany,1960.0,38,37,23,98
31149,Germany,1936.0,97,73,61,231
31150,Germany,2004.0,41,45,63,149
31151,Germany,2016.0,49,43,67,159
31152,Germany,2000.0,31,23,64,118
31153,Germany,1964.0,25,48,53,126
31154,Germany,1996.0,42,35,47,124
31155,Germany,1932.0,10,26,21,57
31156,Germany,2004.0,41,45,63,149
31157,Germany,2012.0,45,27,22,94
31158,Germany,1936.0,97,73,61,231
31159,Germany,1936.0,97,73,61,231
31160,Germany,1936.0,97,73,61,231
31161,Germany,1936.0,97,73,61,231
31162,Germany,1936.0,97,73,61,231
31163,Germany,1952.0,8,16,28,52
31164,Germany,1936.0,97,73,61,231
31165,Germany,1936.0,97,73,61,231
31166,Germany,1964.0,25,48,53,126
31167,Germany,1992.0,95,74,67,236
31168,Germany,1994.0,18,10,12,40
31169,Germany,1998.0,22,12,10,44
31170,Germany,1998.0,22,12,10,44
31171,Germany,1998.0,22,12,10,44
31172,Germany,2016.0,49,43,67,159
31173,Germany,1998.0,22,12,10,44
31174,Germany,2002.0,26,23,12,61
31175,Germany-1,1996.0,42,35,47,124
31176,Germany,1992.0,95,74,67,236
31177,Germany,2016.0,49,43,67,159
31178,Germany,1936.0,97,73,61,231
31179,Germany,1992.0,95,74,67,236
31180,Germany,1960.0,38,37,23,98
31181,Germany,1936.0,97,73,61,231
31182,Germany,1960.0,38,37,23,98
31183,Germany,2000.0,31,23,64,118
31184,Germany,1928.0,21,15,46,82
31185,Germany,1932.0,10,26,21,57
31186,Germany,1996.0,42,35,47,124
31187,Germany,2008.0,42,16,41,99
31188,Germany,1936.0,97,73,61,231
31189,Germany,2016.0,49,43,67,159
31190,Germany,1936.0,97,73,61,231
31191,Germany,1952.0,8,16,28,52
31192,Germany,1952.0,8,16,28,52
31193,Germany,2002.0,26,23,12,61
31194,Germany,2006.0,23,25,6,54
31195,Germany,1936.0,97,73,61,231
31196,Germany,1996.0,42,35,47,124
31197,Germany,2000.0,31,23,64,118
31198,Germany,1992.0,95,74,67,236
31199,Germany,1992.0,95,74,67,236
31200,Germany,1936.0,97,73,61,231
31201,Germany,1928.0,21,15,46,82
31202,Germany,1932.0,10,26,21,57
31203,Germany,1996.0,42,35,47,124
31204,Germany,2004.0,41,45,63,149
31205,Germany,2008.0,42,16,41,99
31206,Germany,2012.0,45,27,22,94
31207,Germany,1932.0,10,26,21,57
31208,Germany,2016.0,49,43,67,159
31209,Germany,1960.0,38,37,23,98
31210,Germany,1936.0,97,73,61,231
31211,Germany,2012.0,45,27,22,94
31212,Germany,1936.0,97,73,61,231
31213,Berliner Ruderclub,1908.0,4,11,6,21
31214,Germany,1936.0,97,73,61,231
31215,Germany,2016.0,49,43,67,159
31216,Germany,2000.0,31,23,64,118
31217,Germany,2008.0,42,16,41,99
31218,Germany,2008.0,42,16,41,99
31219,Germany,1936.0,97,73,61,231
31220,Germany,1960.0,38,37,23,98
31221,Germany,2000.0,31,23,64,118
31222,Germany,2004.0,41,45,63,149
31223,Germany,2008.0,42,16,41,99
31224,Germany,2012.0,45,27,22,94
31225,Germany,2016.0,49,43,67,159
31226,Germany,2004.0,41,45,63,149
31227,Germany,1992.0,95,74,67,236
31228,Germany,1996.0,42,35,47,124
31229,Germany,2008.0,42,16,41,99
31230,Germany,1952.0,8,16,28,52
31231,Germany,1992.0,95,74,67,236
31232,Germany,1992.0,95,74,67,236
31233,Germany,1992.0,95,74,67,236
31234,Germany,2004.0,41,45,63,149
31235,Germany,1936.0,97,73,61,231
31236,Germany-1,1998.0,22,12,10,44
31237,Germany,1992.0,95,74,67,236
31238,Germany,1912.0,11,19,23,53
31239,Germany,1936.0,97,73,61,231
31240,Germany,1936.0,97,73,61,231
31241,Germany,2004.0,41,45,63,149
31242,Germany,1964.0,25,48,53,126
31243,Frankfurt Club,1900.0,14,20,11,45
31244,Germany,1936.0,97,73,61,231
31245,Germany,1952.0,8,16,28,52
31246,Germany,1936.0,97,73,61,231
31247,Germany,2012.0,45,27,22,94
31248,Germany,1928.0,21,15,46,82
31249,Germany,2012.0,45,27,22,94
31250,Germany,1928.0,21,15,46,82
31251,Germany,1928.0,21,15,46,82
31252,Germany,1932.0,10,26,21,57
31253,Germany,1992.0,95,74,67,236
31254,Germany,1936.0,97,73,61,231
31255,Germany,1964.0,25,48,53,126
31256,Germany,1992.0,95,74,67,236
31257,Germany,1996.0,42,35,47,124
31258,Germany,2004.0,41,45,63,149
31259,Germany,2016.0,49,43,67,159
31260,Germany,1932.0,10,26,21,57
31261,Germany,1936.0,97,73,61,231
31262,Germany,1936.0,97,73,61,231
31263,Germany,1956.0,10,20,24,54
31264,Germany,1956.0,10,20,24,54
31265,Germany,2016.0,49,43,67,159
31266,Germany,2008.0,42,16,41,99
31267,Germany,1936.0,97,73,61,231
31268,Germany-2,1994.0,18,10,12,40
31269,Germany,1992.0,95,74,67,236
31270,Germany-1,2010.0,15,24,15,54
31271,Germany-1,2014.0,15,12,9,36
31272,Germany,2010.0,15,24,15,54
31273,Germany,2004.0,41,45,63,149
31274,Germany,2012.0,45,27,22,94
31275,Germany,2010.0,15,24,15,54
31276,Germany,2010.0,15,24,15,54
31277,Germany,1956.0,10,20,24,54
31278,Germany,2016.0,49,43,67,159
31279,Germany,1992.0,95,74,67,236
31280,Germany,1992.0,95,74,67,236
31281,Germany,1992.0,95,74,67,236
31282,Germany,1936.0,97,73,61,231
31283,Germany,2000.0,31,23,64,118
31284,Germany,2000.0,31,23,64,118
31285,Germany,1992.0,95,74,67,236
31286,Germany,1996.0,42,35,47,124
31287,Germany,1964.0,25,48,53,126
31288,Germany,1960.0,38,37,23,98
31289,Germany,1996.0,42,35,47,124
31290,Germany,1952.0,8,16,28,52
31291,Germany,1952.0,8,16,28,52
31292,Germany,1956.0,10,20,24,54
31293,Germany,1960.0,38,37,23,98
31294,Germany,2008.0,42,16,41,99
31295,Germany,2012.0,45,27,22,94
31296,Germany,2016.0,49,43,67,159
31297,Germany,2012.0,45,27,22,94
31298,Germany,2000.0,31,23,64,118
31299,Germany,1994.0,18,10,12,40
31300,Germany,1994.0,18,10,12,40
31301,Germany,1998.0,22,12,10,44
31302,Germany,1960.0,38,37,23,98
31303,Germany,1964.0,25,48,53,126
31304,Germany,1936.0,97,73,61,231
31305,Germany,1992.0,95,74,67,236
31306,Germany,2008.0,42,16,41,99
31307,Germany,2012.0,45,27,22,94
31308,Gustel X,1952.0,8,16,28,52
31309,Germany,1998.0,22,12,10,44
31310,"Germania Ruder Club, Hamburg-2",1900.0,14,20,11,45
31311,Germany,1936.0,97,73,61,231
31312,Germany,1996.0,42,35,47,124
31313,Germany,2016.0,49,43,67,159
31314,Germany,2012.0,45,27,22,94
31315,Great Britain/Germany,1896.0,25,5,2,32
31316,Germany,1992.0,95,74,67,236
31317,Germany,1996.0,42,35,47,124
31318,Germany,1908.0,4,11,6,21
31319,Germany,1992.0,95,74,67,236
31320,Germany,1996.0,42,35,47,124
31321,Germany,1996.0,42,35,47,124
31322,Germany,2016.0,49,43,67,159
31323,Germany,2010.0,15,24,15,54
31324,Germany,1956.0,10,20,24,54
31325,Germany,2002.0,26,23,12,61
31326,Germany,2010.0,15,24,15,54
31327,Germany,1956.0,10,20,24,54
31328,Germany,2000.0,31,23,64,118
31329,Germany,2000.0,31,23,64,118
31330,Germany,2000.0,31,23,64,118
31331,Germany,2004.0,41,45,63,149
31332,Germany,1996.0,42,35,47,124
31333,Germany,1952.0,8,16,28,52
31334,Germany,1952.0,8,16,28,52
31335,Germany,1964.0,25,48,53,126
31336,Germany,2016.0,49,43,67,159
31337,Germany,1992.0,95,74,67,236
31338,Germany,1992.0,95,74,67,236
31339,Germany,1964.0,25,48,53,126
31340,Germany,1996.0,42,35,47,124
31341,Germany,1960.0,38,37,23,98
31342,Germany,1992.0,95,74,67,236
31343,Germany,2000.0,31,23,64,118
31344,Germany,1992.0,95,74,67,236
31345,Germany,1992.0,95,74,67,236
31346,Germany,1992.0,95,74,67,236
31347,Germany,1992.0,95,74,67,236
31348,Germany,1996.0,42,35,47,124
31349,Germany,1996.0,42,35,47,124
31350,Germany,1996.0,42,35,47,124
31351,Germany,2000.0,31,23,64,118
31352,Germany,2004.0,41,45,63,149
31353,Germany,2004.0,41,45,63,149
31354,Germany,1936.0,97,73,61,231
31355,Germany,2016.0,49,43,67,159
31356,Germany,2016.0,49,43,67,159
31357,Berliner Ruderverein von 1876-2,1912.0,11,19,23,53
31358,Germany,1996.0,42,35,47,124
31359,Germany,2000.0,31,23,64,118
31360,Germany,1964.0,25,48,53,126
31361,Germany,2012.0,45,27,22,94
31362,Germany,2016.0,49,43,67,159
31363,Germany,2016.0,49,43,67,159
31364,Germany,2014.0,15,12,9,36
31365,Germany,1936.0,97,73,61,231
31366,Germany,1936.0,97,73,61,231
31367,Germany,2002.0,26,23,12,61
31368,Germany,2002.0,26,23,12,61
31369,Germany,2002.0,26,23,12,61
31370,Germany,2006.0,23,25,6,54
31371,Germany,1996.0,42,35,47,124
31372,Germany,1996.0,42,35,47,124
31373,Germany,1996.0,42,35,47,124
31374,Germany,1992.0,95,74,67,236
31375,Germany,1996.0,42,35,47,124
31376,Germany,2000.0,31,23,64,118
31377,Germany,1936.0,97,73,61,231
31378,Germany,1936.0,97,73,61,231
31379,Germany,1936.0,97,73,61,231
31380,Germany,1936.0,97,73,61,231
31381,Germany,1936.0,97,73,61,231
31382,Germany,1964.0,25,48,53,126
31383,Germany,1964.0,25,48,53,126
31384,Germany,1992.0,95,74,67,236
31385,Germany,1936.0,97,73,61,231
31386,Germany,2004.0,41,45,63,149
31387,Germany,1912.0,11,19,23,53
31388,Germania II,1936.0,97,73,61,231
31389,Macky VI,1960.0,38,37,23,98
31390,Germany,1992.0,95,74,67,236
31391,Germany,1908.0,4,11,6,21
31392,Germany,1956.0,10,20,24,54
31393,Germany,1960.0,38,37,23,98
31394,Germany,1964.0,25,48,53,126
31395,Germany,1912.0,11,19,23,53
31396,Germany,1912.0,11,19,23,53
31397,Germany,1928.0,21,15,46,82
31398,Germany,1912.0,11,19,23,53
31399,Germany,1912.0,11,19,23,53
31400,Germany,1952.0,8,16,28,52
31401,Germany,1936.0,97,73,61,231
31402,Germany,1912.0,11,19,23,53
31403,Germany,1912.0,11,19,23,53
31404,Germany,1912.0,11,19,23,53
31405,Germany,1912.0,11,19,23,53
31406,Germany,1936.0,97,73,61,231
31407,Germany,1936.0,97,73,61,231
31408,Germany,1912.0,11,19,23,53
31409,Germany,2000.0,31,23,64,118
31410,Germania II,1936.0,97,73,61,231
31411,Germany,1936.0,97,73,61,231
31412,Germany,1906.0,14,10,6,30
31413,Germany,1952.0,8,16,28,52
31414,Germany,1956.0,10,20,24,54
31415,Germany,1992.0,95,74,67,236
31416,Germany,2000.0,31,23,64,118
31417,Germany,2000.0,31,23,64,118
31418,Germany,2004.0,41,45,63,149
31419,Germany,2008.0,42,16,41,99
31420,Germany,2008.0,42,16,41,99
31421,Germany,2012.0,45,27,22,94
31422,Germany,1996.0,42,35,47,124
31423,Germany,2000.0,31,23,64,118
31424,Germany,1936.0,97,73,61,231
31425,Germany,1964.0,25,48,53,126
31426,Germany,2004.0,41,45,63,149
31427,Germany-1,2016.0,49,43,67,159
31428,Germany,1964.0,25,48,53,126
31429,Germany,1996.0,42,35,47,124
31430,Germany,2004.0,41,45,63,149
31431,Germany,1964.0,25,48,53,126
31432,Germany,1906.0,14,10,6,30
31433,Germany,1908.0,4,11,6,21
31434,Germany,1992.0,95,74,67,236
31435,Germany,2010.0,15,24,15,54
31436,Germany,2014.0,15,12,9,36
31437,Germany,1996.0,42,35,47,124
31438,Germany,1936.0,97,73,61,231
31439,Germany,1992.0,95,74,67,236
31440,Germany,1992.0,95,74,67,236
31441,Germany,1994.0,18,10,12,40
31442,Germany,1994.0,18,10,12,40
31443,Germany,2008.0,42,16,41,99
31444,Germany,2000.0,31,23,64,118
31445,Germany,2012.0,45,27,22,94
31446,Germany,2012.0,45,27,22,94
31447,Germany,2016.0,49,43,67,159
31448,Germany,2016.0,49,43,67,159
31449,Germany,1996.0,42,35,47,124
31450,Germany,1964.0,25,48,53,126
31451,Germany,1904.0,4,5,7,16
31452,Germany,1904.0,4,5,7,16
31453,Germany,1992.0,95,74,67,236
31454,Germany,1996.0,42,35,47,124
31455,Germany,2000.0,31,23,64,118
31456,Germany,1992.0,95,74,67,236
31457,Germany,1992.0,95,74,67,236
31458,Germany,1992.0,95,74,67,236
31459,Germany,1996.0,42,35,47,124
31460,Germany,1992.0,95,74,67,236
31461,Germany,1964.0,25,48,53,126
31462,Germany,1992.0,95,74,67,236
31463,Germany,1896.0,25,5,2,32
31464,Germany,1896.0,25,5,2,32
31465,Germany,1896.0,25,5,2,32
31466,Germany,1896.0,25,5,2,32
31467,Germany,1896.0,25,5,2,32
31468,Germany,1896.0,25,5,2,32
31469,Germany,2008.0,42,16,41,99
31470,Germany,2012.0,45,27,22,94
31471,Germany,2016.0,49,43,67,159
31472,Germany,1904.0,4,5,7,16
31473,Germany,1992.0,95,74,67,236
31474,Germany,1928.0,21,15,46,82
31475,Germany,1960.0,38,37,23,98
31476,Germany,1936.0,97,73,61,231
31477,Germany,1964.0,25,48,53,126
31478,Wannsee,1936.0,97,73,61,231
31479,Aschenbrodel,1900.0,14,20,11,45
31480,Aschenbrodel,1900.0,14,20,11,45
31481,Germany,1992.0,95,74,67,236
31482,Germany,2004.0,41,45,63,149
31483,Germany,2008.0,42,16,41,99
31484,Germany,1994.0,18,10,12,40
31485,Germany,1994.0,18,10,12,40
31486,Germany,2016.0,49,43,67,159
31487,Germany,1992.0,95,74,67,236
31488,Germany,1996.0,42,35,47,124
31489,Germany,2000.0,31,23,64,118
31490,Germany,2014.0,15,12,9,36
31491,Germany,2004.0,41,45,63,149
31492,Germany,2012.0,45,27,22,94
31493,Germany,2016.0,49,43,67,159
31494,Germany,2012.0,45,27,22,94
31495,Germany,2016.0,49,43,67,159
31496,Frankfurt Club,1900.0,14,20,11,45
31497,Germany-1,2014.0,15,12,9,36
31498,Germany,2014.0,15,12,9,36
31499,Germany,1960.0,38,37,23,98
31500,Germany,1964.0,25,48,53,126
31501,Germany,1964.0,25,48,53,126
31502,Germany,1952.0,8,16,28,52
31503,Germany,1956.0,10,20,24,54
31504,Germany,1992.0,95,74,67,236
31505,Germany,1992.0,95,74,67,236
31506,Germany,1992.0,95,74,67,236
31507,Germany,1996.0,42,35,47,124
31508,Germany,1996.0,42,35,47,124
31509,Germany,2000.0,31,23,64,118
31510,Germany,2000.0,31,23,64,118
31511,Germany,2008.0,42,16,41,99
31512,Satchmo,2008.0,42,16,41,99
31513,Germany,2016.0,49,43,67,159
31514,Germany,2016.0,49,43,67,159
31515,Germany,2008.0,42,16,41,99
31516,Germany,2012.0,45,27,22,94
31517,Germany,2004.0,41,45,63,149
31518,Germany,2008.0,42,16,41,99
31519,Germany,2012.0,45,27,22,94
31520,Germany,2012.0,45,27,22,94
31521,Germany,2012.0,45,27,22,94
31522,Germany,2016.0,49,43,67,159
31523,Germany,1992.0,95,74,67,236
31524,Germany,1936.0,97,73,61,231
31525,Germany,1956.0,10,20,24,54
31526,Germany,2016.0,49,43,67,159
31527,Germany,1964.0,25,48,53,126
31528,Germany,1964.0,25,48,53,126
31529,Germany,1964.0,25,48,53,126
31530,Germany,2000.0,31,23,64,118
31531,Germany,2016.0,49,43,67,159
31532,Germany,2000.0,31,23,64,118
31533,Germany,2004.0,41,45,63,149
31534,Germany,2008.0,42,16,41,99
31535,Aschenbrodel,1900.0,14,20,11,45
31536,Aschenbrodel,1900.0,14,20,11,45
31537,Germany,1992.0,95,74,67,236
31538,Germany,2002.0,26,23,12,61
31539,Germany,2002.0,26,23,12,61
31540,Germany,2002.0,26,23,12,61
31541,Germany,2006.0,23,25,6,54
31542,Germany,2006.0,23,25,6,54
31543,Germany,2006.0,23,25,6,54
31544,Germany,2010.0,15,24,15,54
31545,Germany,2012.0,45,27,22,94
31546,Ludwigshafener Ruder Verein-1,1900.0,14,20,11,45
31547,Ludwigshafener Ruderverein,1912.0,11,19,23,53
31548,Germany,1992.0,95,74,67,236
31549,Germany,1996.0,42,35,47,124
31550,Germany,2000.0,31,23,64,118
31551,Germany,2004.0,41,45,63,149
31552,Germany,1956.0,10,20,24,54
31553,Germany,1956.0,10,20,24,54
31554,Germany,1960.0,38,37,23,98
31555,Germany,1964.0,25,48,53,126
31556,Germany,1936.0,97,73,61,231
31557,Germany,1996.0,42,35,47,124
31558,Germany,2008.0,42,16,41,99
31559,Germany,2004.0,41,45,63,149
31560,Germany,2008.0,42,16,41,99
31561,Germany,2012.0,45,27,22,94
31562,Germany,1936.0,97,73,61,231
31563,Germany,1992.0,95,74,67,236
31564,Germany,2010.0,15,24,15,54
31565,Germany,2016.0,49,43,67,159
31566,Germany,2004.0,41,45,63,149
31567,Germany,2004.0,41,45,63,149
31568,Germany,1928.0,21,15,46,82
31569,Germany,1992.0,95,74,67,236
31570,Germany,1928.0,21,15,46,82
31571,Germany,1932.0,10,26,21,57
31572,Germany,1928.0,21,15,46,82
31573,Germany-1,1998.0,22,12,10,44
31574,Germany,2004.0,41,45,63,149
31575,Germany,2000.0,31,23,64,118
31576,Germany-1,2006.0,23,25,6,54
31577,Germany,2004.0,41,45,63,149
31578,Germany,2008.0,42,16,41,99
31579,Germany,2008.0,42,16,41,99
31580,Germany,1996.0,42,35,47,124
31581,Germany,1992.0,95,74,67,236
31582,Germany,1996.0,42,35,47,124
31583,Germany,2000.0,31,23,64,118
31584,Germany,2004.0,41,45,63,149
31585,Germany,1904.0,4,5,7,16
31586,Germany,1904.0,4,5,7,16
31587,Germany,1960.0,38,37,23,98
31588,Germany,1928.0,21,15,46,82
31589,Germany,1936.0,97,73,61,231
31590,Germany,1964.0,25,48,53,126
31591,Germany,1964.0,25,48,53,126
31592,Germany,1996.0,42,35,47,124
31593,Germany,1992.0,95,74,67,236
31594,Germany,2004.0,41,45,63,149
31595,Germany,2004.0,41,45,63,149
31596,Germany,2008.0,42,16,41,99
31597,Germany,2012.0,45,27,22,94
31598,Germany,2010.0,15,24,15,54
31599,Germany,2008.0,42,16,41,99
31600,Germany,2012.0,45,27,22,94
31601,Germany,1998.0,22,12,10,44
31602,Germany,1956.0,10,20,24,54
31603,Germany,1960.0,38,37,23,98
31604,Germany,1960.0,38,37,23,98
31605,Germany,2004.0,41,45,63,149
31606,Germany,1960.0,38,37,23,98
31607,Germany,1992.0,95,74,67,236
31608,Germany,1996.0,42,35,47,124
31609,Germany,1952.0,8,16,28,52
31610,Germany,1932.0,10,26,21,57
31611,Germany,1992.0,95,74,67,236
31612,Germany,1996.0,42,35,47,124
31613,Germany,1996.0,42,35,47,124
31614,Germany,1964.0,25,48,53,126
31615,Germany-1,1992.0,95,74,67,236
31616,Germany-1,1998.0,22,12,10,44
31617,Germany-2,1998.0,22,12,10,44
31618,Germany-1,2002.0,26,23,12,61
31619,Germany,1992.0,95,74,67,236
31620,Germany,1908.0,4,11,6,21
31621,Germany,1912.0,11,19,23,53
31622,Germany,2004.0,41,45,63,149
31623,Germany,2016.0,49,43,67,159
31624,Argentina,2008.0,20,0,31,51
31625,Argentina,2008.0,20,0,31,51
31626,Argentina,2000.0,0,17,3,20
31627,Argentina,2004.0,28,0,21,49
31628,Argentina,2008.0,20,0,31,51
31629,Argentina,1996.0,0,19,1,20
31630,Argentina,2000.0,0,17,3,20
31631,Argentina,1936.0,5,2,4,11
31632,Argentina,1928.0,3,18,5,26
31633,Argentina,2000.0,0,17,3,20
31634,Argentina,2004.0,28,0,21,49
31635,Argentina,2000.0,0,17,3,20
31636,Argentina,2004.0,28,0,21,49
31637,Argentina,1928.0,3,18,5,26
31638,Argentina,1996.0,0,19,1,20
31639,Argentina,2004.0,28,0,21,49
31640,Argentina,2000.0,0,17,3,20
31641,Argentina,2004.0,28,0,21,49
31642,Argentina,2008.0,20,0,31,51
31643,Argentina,2012.0,1,15,3,19
31644,Argentina,1932.0,3,1,0,4
31645,Argentina,2008.0,20,0,31,51
31646,Argentina,2004.0,28,0,21,49
31647,Argentina,2008.0,20,0,31,51
31648,Argentina,2012.0,1,15,3,19
31649,Argentina,1996.0,0,19,1,20
31650,Argentina,1928.0,3,18,5,26
31651,Argentina,1928.0,3,18,5,26
31652,Argentina,1996.0,0,19,1,20
31653,Argentina,2016.0,21,1,0,22
31654,Argentina,1924.0,5,3,2,10
31655,Argentina,2008.0,20,0,31,51
31656,Argentina,2004.0,28,0,21,49
31657,Argentina,2004.0,28,0,21,49
31658,Argentina,2008.0,20,0,31,51
31659,Argentina,1948.0,3,7,1,11
31660,Argentina,2012.0,1,15,3,19
31661,Argentina,1928.0,3,18,5,26
31662,Tango,1960.0,0,3,1,4
31663,Argentina,2016.0,21,1,0,22
31664,Argentina,1928.0,3,18,5,26
31665,Argentina,1936.0,5,2,4,11
31666,Argentina,1952.0,2,2,2,6
31667,Argentina,2016.0,21,1,0,22
31668,Argentina,1928.0,3,18,5,26
31669,Argentina,1936.0,5,2,4,11
31670,Argentina,1988.0,0,1,12,13
31671,Argentina,2012.0,1,15,3,19
31672,Argentina,1996.0,0,19,1,20
31673,Argentina,1936.0,5,2,4,11
31674,Argentina,1996.0,0,19,1,20
31675,Argentina,1996.0,0,19,1,20
31676,Argentina,1928.0,3,18,5,26
31677,Argentina,1948.0,3,7,1,11
31678,Argentina,1988.0,0,1,12,13
31679,Argentina,2004.0,28,0,21,49
31680,Argentina,1988.0,0,1,12,13
31681,Argentina,2000.0,0,17,3,20
31682,Argentina,1924.0,5,3,2,10
31683,Argentina,1996.0,0,19,1,20
31684,Argentina,2012.0,1,15,3,19
31685,Argentina,1988.0,0,1,12,13
31686,Argentina,1936.0,5,2,4,11
31687,Argentina,2008.0,20,0,31,51
31688,Argentina,2004.0,28,0,21,49
31689,Argentina,2012.0,1,15,3,19
31690,Argentina,2000.0,0,17,3,20
31691,Argentina,2012.0,1,15,3,19
31692,Argentina,1988.0,0,1,12,13
31693,Argentina,2012.0,1,15,3,19
31694,Argentina,2016.0,21,1,0,22
31695,Tango,1960.0,0,3,1,4
31696,Argentina,2004.0,28,0,21,49
31697,Argentina,2008.0,20,0,31,51
31698,Argentina,2004.0,28,0,21,49
31699,Argentina,1996.0,0,19,1,20
31700,Argentina,1968.0,0,0,2,2
31701,Argentina,1972.0,0,1,0,1
31702,Argentina,2004.0,28,0,21,49
31703,Argentina,2008.0,20,0,31,51
31704,Argentina,1928.0,3,18,5,26
31705,Argentina,1948.0,3,7,1,11
31706,Argentina,1988.0,0,1,12,13
31707,Argentina,1936.0,5,2,4,11
31708,Argentina,1996.0,0,19,1,20
31709,Argentina,2000.0,0,17,3,20
31710,Argentina,2004.0,28,0,21,49
31711,Argentina,2008.0,20,0,31,51
31712,Argentina,1928.0,3,18,5,26
31713,Argentina,2008.0,20,0,31,51
31714,Argentina,2004.0,28,0,21,49
31715,Argentina,2000.0,0,17,3,20
31716,Argentina,1928.0,3,18,5,26
31717,Argentina,1992.0,0,0,2,2
31718,Argentina,2008.0,20,0,31,51
31719,Argentina,1928.0,3,18,5,26
31720,Argentina,1996.0,0,19,1,20
31721,Argentina,2000.0,0,17,3,20
31722,Argentina,2008.0,20,0,31,51
31723,Argentina,2000.0,0,17,3,20
31724,Argentina,2004.0,28,0,21,49
31725,Argentina,2008.0,20,0,31,51
31726,Argentina,1936.0,5,2,4,11
31727,Argentina,2016.0,21,1,0,22
31728,Argentina,2004.0,28,0,21,49
31729,Argentina,2008.0,20,0,31,51
31730,Argentina,2004.0,28,0,21,49
31731,Argentina,2004.0,28,0,21,49
31732,Argentina,2004.0,28,0,21,49
31733,Argentina,2008.0,20,0,31,51
31734,Argentina,2004.0,28,0,21,49
31735,Argentina,2008.0,20,0,31,51
31736,Argentina,1952.0,2,2,2,6
31737,Argentina,1952.0,2,2,2,6
31738,Argentina,1968.0,0,0,2,2
31739,Argentina,2004.0,28,0,21,49
31740,Argentina,2008.0,20,0,31,51
31741,Argentina,2008.0,20,0,31,51
31742,Argentina,2004.0,28,0,21,49
31743,Argentina,2008.0,20,0,31,51
31744,Argentina,2012.0,1,15,3,19
31745,Argentina,2004.0,28,0,21,49
31746,Argentina,2000.0,0,17,3,20
31747,Argentina,2004.0,28,0,21,49
31748,Argentina,2008.0,20,0,31,51
31749,Argentina,1952.0,2,2,2,6
31750,Argentina,2004.0,28,0,21,49
31751,Djinn,1948.0,3,7,1,11
31752,Argentina,2016.0,21,1,0,22
31753,Argentina,2016.0,21,1,0,22
31754,Argentina,1948.0,3,7,1,11
31755,Argentina,2008.0,20,0,31,51
31756,Argentina,2008.0,20,0,31,51
31757,Argentina,1988.0,0,1,12,13
31758,Argentina,1924.0,5,3,2,10
31759,Argentina,1928.0,3,18,5,26
31760,Argentina,2004.0,28,0,21,49
31761,Argentina,2008.0,20,0,31,51
31762,Argentina,2016.0,21,1,0,22
31763,Argentina,1928.0,3,18,5,26
31764,Argentina,1960.0,0,3,1,4
31765,Argentina,2008.0,20,0,31,51
31766,Argentina,1996.0,0,19,1,20
31767,Argentina,1996.0,0,19,1,20
31768,Argentina,2016.0,21,1,0,22
31769,Argentina,1932.0,3,1,0,4
31770,Argentina,1936.0,5,2,4,11
31771,Argentina,1928.0,3,18,5,26
31772,Argentina,1928.0,3,18,5,26
31773,Argentina,2008.0,20,0,31,51
31774,Argentina,2012.0,1,15,3,19
31775,Argentina,2004.0,28,0,21,49
31776,Argentina,2012.0,1,15,3,19
31777,Argentina,2000.0,0,17,3,20
31778,Argentina,2000.0,0,17,3,20
31779,Argentina,2004.0,28,0,21,49
31780,Argentina,2008.0,20,0,31,51
31781,Argentina,1988.0,0,1,12,13
31782,Argentina,2004.0,28,0,21,49
31783,Argentina,2008.0,20,0,31,51
31784,Argentina,2000.0,0,17,3,20
31785,Argentina,2016.0,21,1,0,22
31786,Argentina,2016.0,21,1,0,22
31787,Argentina,1928.0,3,18,5,26
31788,Argentina,2004.0,28,0,21,49
31789,Argentina,1924.0,5,3,2,10
31790,Argentina,2016.0,21,1,0,22
31791,Argentina,2012.0,1,15,3,19
31792,Argentina,2008.0,20,0,31,51
31793,Argentina,1924.0,5,3,2,10
31794,Argentina,1992.0,0,0,2,2
31795,Argentina,2004.0,28,0,21,49
31796,Argentina,1928.0,3,18,5,26
31797,Argentina,2008.0,20,0,31,51
31798,Argentina,1996.0,0,19,1,20
31799,Argentina,1964.0,0,1,0,1
31800,Argentina,2012.0,1,15,3,19
31801,Argentina,1924.0,5,3,2,10
31802,Argentina,1924.0,5,3,2,10
31803,Argentina,2004.0,28,0,21,49
31804,Argentina,2008.0,20,0,31,51
31805,Argentina,2004.0,28,0,21,49
31806,Argentina,2008.0,20,0,31,51
31807,Argentina,2000.0,0,17,3,20
31808,Argentina,2004.0,28,0,21,49
31809,Argentina,1928.0,3,18,5,26
31810,Argentina,1928.0,3,18,5,26
31811,Argentina,1996.0,0,19,1,20
31812,Argentina,2016.0,21,1,0,22
31813,Argentina,1952.0,2,2,2,6
31814,Argentina,1924.0,5,3,2,10
31815,Argentina,2016.0,21,1,0,22
31816,Argentina,2008.0,20,0,31,51
31817,Argentina,2008.0,20,0,31,51
31818,Argentina,2016.0,21,1,0,22
31819,Argentina,1928.0,3,18,5,26
31820,Argentina,1996.0,0,19,1,20
31821,Argentina,2016.0,21,1,0,22
31822,Argentina,1928.0,3,18,5,26
31823,Argentina,1928.0,3,18,5,26
31824,Argentina,1948.0,3,7,1,11
31825,Argentina,2008.0,20,0,31,51
31826,Argentina,1996.0,0,19,1,20
31827,Argentina,1936.0,5,2,4,11
31828,Argentina,2008.0,20,0,31,51
31829,Argentina,1924.0,5,3,2,10
31830,Argentina,2008.0,20,0,31,51
31831,Argentina,1924.0,5,3,2,10
31832,Argentina,2008.0,20,0,31,51
31833,Argentina,1988.0,0,1,12,13
31834,Argentina,2008.0,20,0,31,51
31835,Argentina,2012.0,1,15,3,19
31836,Argentina,1936.0,5,2,4,11
31837,Argentina,2016.0,21,1,0,22
31838,Argentina,2016.0,21,1,0,22
31839,Argentina,2000.0,0,17,3,20
31840,Argentina,2008.0,20,0,31,51
31841,Djinn,1948.0,3,7,1,11
31842,Argentina,1932.0,3,1,0,4
31843,Argentina,1928.0,3,18,5,26
31844,Argentina,2004.0,28,0,21,49
31845,Argentina,2012.0,1,15,3,19
31846,Djinn,1948.0,3,7,1,11
31847,Argentina,2000.0,0,17,3,20
31848,Argentina,2004.0,28,0,21,49
31849,Argentina,2008.0,20,0,31,51
31850,Argentina,2004.0,28,0,21,49
31851,Argentina,2016.0,21,1,0,22
31852,Argentina,2008.0,20,0,31,51
31853,Argentina,2004.0,28,0,21,49
31854,Argentina,2008.0,20,0,31,51
31855,Argentina,1988.0,0,1,12,13
31856,Argentina,2016.0,21,1,0,22
31857,Tango,1960.0,0,3,1,4
31858,Argentina,2004.0,28,0,21,49
31859,Argentina,2012.0,1,15,3,19
31860,Argentina,2004.0,28,0,21,49
31861,Argentina,2012.0,1,15,3,19
31862,Argentina,2004.0,28,0,21,49
31863,Argentina,2008.0,20,0,31,51
31864,Argentina,2004.0,28,0,21,49
31865,Argentina,1952.0,2,2,2,6
31866,Argentina,1956.0,0,1,1,2
31867,Argentina,1996.0,0,19,1,20
31868,Djinn,1948.0,3,7,1,11
31869,Djinn,1948.0,3,7,1,11
31870,Argentina,1996.0,0,19,1,20
31871,Argentina,1948.0,3,7,1,11
31872,Argentina,2008.0,20,0,31,51
31873,Argentina,2012.0,1,15,3,19
31874,Argentina,2012.0,1,15,3,19
31875,Argentina,2000.0,0,17,3,20
31876,Argentina,2004.0,28,0,21,49
31877,Argentina,2004.0,28,0,21,49
31878,Argentina,2008.0,20,0,31,51
31879,Argentina,2004.0,28,0,21,49
31880,Argentina,1928.0,3,18,5,26
31881,Argentina,2004.0,28,0,21,49
31882,Argentina,1988.0,0,1,12,13
31883,Argentina,2008.0,20,0,31,51
31884,Argentina,2016.0,21,1,0,22
31885,Argentina,1936.0,5,2,4,11
31886,Argentina,2016.0,21,1,0,22
31887,Argentina,2000.0,0,17,3,20
31888,Argentina,2004.0,28,0,21,49
31889,Argentina,2008.0,20,0,31,51
31890,Argentina,1988.0,0,1,12,13
31891,Argentina,2004.0,28,0,21,49
31892,Argentina,1932.0,3,1,0,4
31893,Argentina,2008.0,20,0,31,51
31894,Argentina,1956.0,0,1,1,2
31895,Argentina,1996.0,0,19,1,20
31896,Argentina,1928.0,3,18,5,26
31897,Argentina,1988.0,0,1,12,13
31898,Cuba,2008.0,2,34,11,47
31899,Cuba,2000.0,18,35,12,65
31900,Cuba,1980.0,8,7,5,20
31901,Cuba,1992.0,42,13,14,69
31902,Cuba,1992.0,42,13,14,69
31903,Cuba,1996.0,37,8,10,55
31904,Cuba,2000.0,18,35,12,65
31905,Cuba,1976.0,6,4,14,24
31906,Cuba,1980.0,8,7,5,20
31907,Cuba,1972.0,3,1,18,22
31908,Cuba,2012.0,5,3,6,14
31909,Cuba,2016.0,5,2,4,11
31910,Cuba,2004.0,32,8,22,62
31911,Cuba,2000.0,18,35,12,65
31912,Cuba,2004.0,32,8,22,62
31913,Cuba,2008.0,2,34,11,47
31914,Cuba,2016.0,5,2,4,11
31915,Cuba,1992.0,42,13,14,69
31916,Cuba,1996.0,37,8,10,55
31917,Cuba,2000.0,18,35,12,65
31918,Cuba,1980.0,8,7,5,20
31919,Cuba,1992.0,42,13,14,69
31920,Cuba,2000.0,18,35,12,65
31921,Cuba,2004.0,32,8,22,62
31922,Cuba,2008.0,2,34,11,47
31923,Cuba,2008.0,2,34,11,47
31924,Cuba,2004.0,32,8,22,62
31925,Cuba,2004.0,32,8,22,62
31926,Cuba,2008.0,2,34,11,47
31927,Cuba,1992.0,42,13,14,69
31928,Cuba,1996.0,37,8,10,55
31929,Cuba,2000.0,18,35,12,65
31930,Cuba,2000.0,18,35,12,65
31931,Cuba,2004.0,32,8,22,62
31932,Cuba,1996.0,37,8,10,55
31933,Cuba,2008.0,2,34,11,47
31934,Cuba,2012.0,5,3,6,14
31935,Cuba,2004.0,32,8,22,62
31936,Cuba,1992.0,42,13,14,69
31937,Cuba,1980.0,8,7,5,20
31938,Cuba,2016.0,5,2,4,11
31939,Cuba,2004.0,32,8,22,62
31940,Cuba,2008.0,2,34,11,47
31941,Cuba,2016.0,5,2,4,11
31942,Cuba,1992.0,42,13,14,69
31943,Cuba,1972.0,3,1,18,22
31944,Cuba,2004.0,32,8,22,62
31945,Cuba,1996.0,37,8,10,55
31946,Cuba,2000.0,18,35,12,65
31947,Cuba,2012.0,5,3,6,14
31948,Cuba,2008.0,2,34,11,47
31949,Cuba,1972.0,3,1,18,22
31950,Cuba,1972.0,3,1,18,22
31951,Cuba,2004.0,32,8,22,62
31952,Cuba,1992.0,42,13,14,69
31953,Cuba,1996.0,37,8,10,55
31954,Cuba,1992.0,42,13,14,69
31955,Cuba,1976.0,6,4,14,24
31956,Cuba,1980.0,8,7,5,20
31957,Cuba,2008.0,2,34,11,47
31958,Cuba,1980.0,8,7,5,20
31959,Cuba,2000.0,18,35,12,65
31960,Cuba,2004.0,32,8,22,62
31961,Cuba,2008.0,2,34,11,47
31962,Cuba,2000.0,18,35,12,65
31963,Cuba,1972.0,3,1,18,22
31964,Cuba,2004.0,32,8,22,62
31965,Cuba,1972.0,3,1,18,22
31966,Cuba,1972.0,3,1,18,22
31967,Cuba,1968.0,0,10,0,10
31968,Cuba,1980.0,8,7,5,20
31969,Cuba,1996.0,37,8,10,55
31970,Cuba,2000.0,18,35,12,65
31971,Cuba,1972.0,3,1,18,22
31972,Cuba,2008.0,2,34,11,47
31973,Cuba,1992.0,42,13,14,69
31974,Cuba,1996.0,37,8,10,55
31975,Cuba,2000.0,18,35,12,65
31976,Cuba,2004.0,32,8,22,62
31977,Cuba,2008.0,2,34,11,47
31978,Cuba,2004.0,32,8,22,62
31979,Kurush II,1948.0,0,2,0,2
31980,Kurush II,1948.0,0,2,0,2
31981,Cuba,1992.0,42,13,14,69
31982,Cuba,1980.0,8,7,5,20
31983,Cuba,2008.0,2,34,11,47
31984,Cuba,2012.0,5,3,6,14
31985,Cuba,1992.0,42,13,14,69
31986,Cuba,1904.0,5,0,0,5
31987,Cuba,1904.0,5,0,0,5
31988,Cuba,1992.0,42,13,14,69
31989,Cuba,1972.0,3,1,18,22
31990,Cuba,2000.0,18,35,12,65
31991,Cuba,1976.0,6,4,14,24
31992,Cuba,1996.0,37,8,10,55
31993,Cuba,2008.0,2,34,11,47
31994,Cuba,1968.0,0,10,0,10
31995,Cuba,1972.0,3,1,18,22
31996,Cuba,2004.0,32,8,22,62
31997,Cuba,2008.0,2,34,11,47
31998,Cuba,1992.0,42,13,14,69
31999,Cuba,1996.0,37,8,10,55
32000,Cuba,1996.0,37,8,10,55
32001,Cuba,1996.0,37,8,10,55
32002,Cuba,2000.0,18,35,12,65
32003,Cuba,2004.0,32,8,22,62
32004,Cuba,1992.0,42,13,14,69
32005,Cuba,1980.0,8,7,5,20
32006,Cuba,1976.0,6,4,14,24
32007,Cuba,1964.0,0,1,0,1
32008,Cuba,1968.0,0,10,0,10
32009,Cuba,1900.0,1,1,0,2
32010,Cuba,1900.0,1,1,0,2
32011,Cuba,1904.0,5,0,0,5
32012,Cuba,1904.0,5,0,0,5
32013,Cuba,1904.0,5,0,0,5
32014,Cuba,2000.0,18,35,12,65
32015,Cuba,1996.0,37,8,10,55
32016,Cuba,2004.0,32,8,22,62
32017,Cuba,2004.0,32,8,22,62
32018,Cuba,1968.0,0,10,0,10
32019,Cuba,1976.0,6,4,14,24
32020,Cuba,2000.0,18,35,12,65
32021,Cuba,2004.0,32,8,22,62
32022,Cuba,1992.0,42,13,14,69
32023,Cuba,2000.0,18,35,12,65
32024,Cuba,1992.0,42,13,14,69
32025,Cuba,1996.0,37,8,10,55
32026,Cuba,1976.0,6,4,14,24
32027,Cuba,2000.0,18,35,12,65
32028,Cuba,1992.0,42,13,14,69
32029,Cuba,1996.0,37,8,10,55
32030,Cuba,1980.0,8,7,5,20
32031,Cuba,2000.0,18,35,12,65
32032,Cuba,2012.0,5,3,6,14
32033,Cuba,1992.0,42,13,14,69
32034,Cuba,1996.0,37,8,10,55
32035,Cuba,2000.0,18,35,12,65
32036,Cuba,2004.0,32,8,22,62
32037,Cuba,2004.0,32,8,22,62
32038,Cuba,2008.0,2,34,11,47
32039,Cuba,1992.0,42,13,14,69
32040,Cuba,2008.0,2,34,11,47
32041,Cuba,1992.0,42,13,14,69
32042,Cuba,2004.0,32,8,22,62
32043,Cuba,2008.0,2,34,11,47
32044,Cuba,1992.0,42,13,14,69
32045,Cuba,1992.0,42,13,14,69
32046,Cuba,1996.0,37,8,10,55
32047,Cuba,2000.0,18,35,12,65
32048,Cuba,1992.0,42,13,14,69
32049,Cuba,1996.0,37,8,10,55
32050,Cuba,2008.0,2,34,11,47
32051,Cuba,1992.0,42,13,14,69
32052,Cuba,1996.0,37,8,10,55
32053,Cuba,1992.0,42,13,14,69
32054,Cuba,1996.0,37,8,10,55
32055,Cuba,1976.0,6,4,14,24
32056,Cuba,1992.0,42,13,14,69
32057,Cuba,1992.0,42,13,14,69
32058,Cuba,2008.0,2,34,11,47
32059,Cuba,1980.0,8,7,5,20
32060,Cuba,1992.0,42,13,14,69
32061,Cuba,1996.0,37,8,10,55
32062,Cuba,1976.0,6,4,14,24
32063,Cuba,1980.0,8,7,5,20
32064,Cuba,1992.0,42,13,14,69
32065,Cuba,1972.0,3,1,18,22
32066,Cuba,1972.0,3,1,18,22
32067,Cuba,1980.0,8,7,5,20
32068,Cuba,2000.0,18,35,12,65
32069,Cuba,2008.0,2,34,11,47
32070,Cuba,2012.0,5,3,6,14
32071,Cuba,1996.0,37,8,10,55
32072,Cuba,1992.0,42,13,14,69
32073,Cuba,1992.0,42,13,14,69
32074,Cuba,1996.0,37,8,10,55
32075,Cuba,2004.0,32,8,22,62
32076,Cuba,1976.0,6,4,14,24
32077,Cuba,1976.0,6,4,14,24
32078,Cuba,2000.0,18,35,12,65
32079,Cuba,2004.0,32,8,22,62
32080,Cuba,1992.0,42,13,14,69
32081,Cuba,1996.0,37,8,10,55
32082,Cuba,2000.0,18,35,12,65
32083,Cuba,2016.0,5,2,4,11
32084,Cuba,2008.0,2,34,11,47
32085,Cuba,2004.0,32,8,22,62
32086,Cuba,2004.0,32,8,22,62
32087,Cuba,2008.0,2,34,11,47
32088,Cuba,1992.0,42,13,14,69
32089,Cuba,1976.0,6,4,14,24
32090,Cuba,1992.0,42,13,14,69
32091,Cuba,1996.0,37,8,10,55
32092,Cuba,1992.0,42,13,14,69
32093,Cuba,1996.0,37,8,10,55
32094,Cuba,2000.0,18,35,12,65
32095,Cuba,2004.0,32,8,22,62
32096,Cuba,2008.0,2,34,11,47
32097,Cuba,1992.0,42,13,14,69
32098,Cuba,2008.0,2,34,11,47
32099,Cuba,1980.0,8,7,5,20
32100,Cuba,1992.0,42,13,14,69
32101,Cuba,1996.0,37,8,10,55
32102,Cuba,2000.0,18,35,12,65
32103,Cuba,2016.0,5,2,4,11
32104,Cuba,2012.0,5,3,6,14
32105,Cuba,2004.0,32,8,22,62
32106,Cuba,2008.0,2,34,11,47
32107,Cuba,2012.0,5,3,6,14
32108,Cuba,2016.0,5,2,4,11
32109,Cuba,2000.0,18,35,12,65
32110,Cuba,2016.0,5,2,4,11
32111,Cuba,1992.0,42,13,14,69
32112,Cuba,1996.0,37,8,10,55
32113,Cuba,2000.0,18,35,12,65
32114,Cuba,1996.0,37,8,10,55
32115,Cuba,1996.0,37,8,10,55
32116,Cuba,2000.0,18,35,12,65
32117,Cuba,2004.0,32,8,22,62
32118,Cuba,2004.0,32,8,22,62
32119,Cuba,2000.0,18,35,12,65
32120,Cuba,2008.0,2,34,11,47
32121,Cuba,1996.0,37,8,10,55
32122,Cuba,2000.0,18,35,12,65
32123,Cuba,1992.0,42,13,14,69
32124,Cuba,1992.0,42,13,14,69
32125,Cuba,1996.0,37,8,10,55
32126,Cuba,2000.0,18,35,12,65
32127,Cuba,1976.0,6,4,14,24
32128,Cuba,1992.0,42,13,14,69
32129,Cuba,1980.0,8,7,5,20
32130,Cuba,1976.0,6,4,14,24
32131,Cuba,2004.0,32,8,22,62
32132,Cuba,2008.0,2,34,11,47
32133,Cuba,1992.0,42,13,14,69
32134,Cuba,1976.0,6,4,14,24
32135,Cuba,1976.0,6,4,14,24
32136,Cuba,2004.0,32,8,22,62
32137,Cuba,1972.0,3,1,18,22
32138,Cuba,2000.0,18,35,12,65
32139,Cuba,2000.0,18,35,12,65
32140,Cuba,2000.0,18,35,12,65
32141,Cuba,2000.0,18,35,12,65
32142,Cuba,2000.0,18,35,12,65
32143,Cuba,2004.0,32,8,22,62
32144,Cuba,2000.0,18,35,12,65
32145,Cuba,2008.0,2,34,11,47
32146,Cuba,1996.0,37,8,10,55
32147,Cuba,1992.0,42,13,14,69
32148,Cuba,2000.0,18,35,12,65
32149,Cuba,2004.0,32,8,22,62
32150,Cuba,1992.0,42,13,14,69
32151,Cuba,1992.0,42,13,14,69
32152,Cuba,2004.0,32,8,22,62
32153,Cuba,2008.0,2,34,11,47
32154,Cuba,1996.0,37,8,10,55
32155,Cuba,1968.0,0,10,0,10
32156,Cuba,2004.0,32,8,22,62
32157,Cuba,2004.0,32,8,22,62
32158,Cuba,1968.0,0,10,0,10
32159,Cuba,2004.0,32,8,22,62
32160,Cuba,2008.0,2,34,11,47
32161,Cuba,1992.0,42,13,14,69
32162,Cuba,2004.0,32,8,22,62
32163,Cuba,2008.0,2,34,11,47
32164,Cuba,1980.0,8,7,5,20
32165,Cuba,2004.0,32,8,22,62
32166,Cuba,2008.0,2,34,11,47
32167,Cuba,1996.0,37,8,10,55
32168,Cuba,2008.0,2,34,11,47
32169,Cuba,2008.0,2,34,11,47
32170,Cuba,2012.0,5,3,6,14
32171,Cuba,2016.0,5,2,4,11
32172,Cuba,1992.0,42,13,14,69
32173,Cuba,2004.0,32,8,22,62
32174,Cuba,1992.0,42,13,14,69
32175,Cuba,1996.0,37,8,10,55
32176,Cuba,2000.0,18,35,12,65
32177,Cuba,1992.0,42,13,14,69
32178,Cuba,1996.0,37,8,10,55
32179,Cuba,2004.0,32,8,22,62
32180,Cuba,2008.0,2,34,11,47
32181,Cuba,1996.0,37,8,10,55
32182,Cuba,2004.0,32,8,22,62
32183,Cuba,2008.0,2,34,11,47
32184,Cuba,2000.0,18,35,12,65
32185,Cuba,2000.0,18,35,12,65
32186,Cuba,2008.0,2,34,11,47
32187,Cuba,2000.0,18,35,12,65
32188,Cuba,1972.0,3,1,18,22
32189,Cuba,1992.0,42,13,14,69
32190,Cuba,2000.0,18,35,12,65
32191,Cuba,1976.0,6,4,14,24
32192,Cuba,2000.0,18,35,12,65
32193,Cuba,2004.0,32,8,22,62
32194,Cuba,2008.0,2,34,11,47
32195,Cuba,2000.0,18,35,12,65
32196,Cuba,2000.0,18,35,12,65
32197,Cuba,1992.0,42,13,14,69
32198,Cuba,2012.0,5,3,6,14
32199,Cuba,1968.0,0,10,0,10
32200,Cuba,1996.0,37,8,10,55
32201,Cuba,2004.0,32,8,22,62
32202,Cuba,1992.0,42,13,14,69
32203,Cuba,1992.0,42,13,14,69
32204,Cuba,1996.0,37,8,10,55
32205,Cuba,2004.0,32,8,22,62
32206,Cuba,2004.0,32,8,22,62
32207,Cuba,1968.0,0,10,0,10
32208,Cuba,2012.0,5,3,6,14
32209,Cuba,2016.0,5,2,4,11
32210,Cuba,1980.0,8,7,5,20
32211,Cuba,1968.0,0,10,0,10
32212,Cuba,1992.0,42,13,14,69
32213,Cuba,1992.0,42,13,14,69
32214,Cuba,2000.0,18,35,12,65
32215,Cuba,2004.0,32,8,22,62
32216,Cuba,2000.0,18,35,12,65
32217,Cuba,2008.0,2,34,11,47
32218,Cuba,1972.0,3,1,18,22
32219,Cuba,2000.0,18,35,12,65
32220,Cuba,1976.0,6,4,14,24
32221,Cuba,1972.0,3,1,18,22
32222,Cuba,1992.0,42,13,14,69
32223,Cuba,1996.0,37,8,10,55
32224,Cuba,1976.0,6,4,14,24
32225,Cuba,1980.0,8,7,5,20
32226,Cuba,2004.0,32,8,22,62
32227,Cuba,2008.0,2,34,11,47
32228,Cuba,2000.0,18,35,12,65
32229,Cuba,2000.0,18,35,12,65
32230,Cuba,2004.0,32,8,22,62
32231,Cuba,1980.0,8,7,5,20
32232,Cuba,1968.0,0,10,0,10
32233,Cuba,1972.0,3,1,18,22
32234,Cuba,1996.0,37,8,10,55
32235,Cuba,2000.0,18,35,12,65
32236,Cuba,1996.0,37,8,10,55
32237,Cuba,2000.0,18,35,12,65
32238,Cuba,1996.0,37,8,10,55
32239,Cuba,2000.0,18,35,12,65
32240,Cuba,2004.0,32,8,22,62
32241,Cuba,1976.0,6,4,14,24
32242,Cuba,2008.0,2,34,11,47
32243,Cuba,2004.0,32,8,22,62
32244,Cuba,2008.0,2,34,11,47
32245,Cuba,2004.0,32,8,22,62
32246,Cuba,1992.0,42,13,14,69
32247,Cuba,1976.0,6,4,14,24
32248,Cuba,1976.0,6,4,14,24
32249,Cuba,1992.0,42,13,14,69
32250,Cuba,1996.0,37,8,10,55
32251,Cuba,2004.0,32,8,22,62
32252,Cuba,2016.0,5,2,4,11
32253,Cuba,1992.0,42,13,14,69
32254,Cuba,1996.0,37,8,10,55
32255,Cuba,2000.0,18,35,12,65
32256,Cuba,1996.0,37,8,10,55
32257,Cuba,2000.0,18,35,12,65
32258,Cuba,2004.0,32,8,22,62
32259,Cuba,2012.0,5,3,6,14
32260,Cuba,1992.0,42,13,14,69
32261,Cuba,2004.0,32,8,22,62
32262,Cuba,1976.0,6,4,14,24
32263,Cuba,1992.0,42,13,14,69
32264,Cuba,2000.0,18,35,12,65
32265,Cuba,1972.0,3,1,18,22
32266,Cuba,1972.0,3,1,18,22
32267,Cuba,1976.0,6,4,14,24
32268,Cuba,1980.0,8,7,5,20
32269,Cuba,2008.0,2,34,11,47
32270,Cuba,2012.0,5,3,6,14
32271,Cuba,2004.0,32,8,22,62
32272,Cuba,2004.0,32,8,22,62
32273,Cuba,1992.0,42,13,14,69
32274,Cuba,2012.0,5,3,6,14
32275,Cuba,1992.0,42,13,14,69
32276,Cuba,1996.0,37,8,10,55
32277,Cuba,2000.0,18,35,12,65
32278,Cuba,1996.0,37,8,10,55
32279,Cuba,2000.0,18,35,12,65
32280,Cuba,1996.0,37,8,10,55
32281,Cuba,2008.0,2,34,11,47
32282,Cuba,1992.0,42,13,14,69
32283,Cuba,1996.0,37,8,10,55
32284,Cuba,2000.0,18,35,12,65
32285,Cuba,1972.0,3,1,18,22
32286,Cuba,2004.0,32,8,22,62
32287,Cuba,2008.0,2,34,11,47
32288,Cuba,1992.0,42,13,14,69
32289,Cuba,2004.0,32,8,22,62
32290,Cuba,1972.0,3,1,18,22
32291,Cuba,1992.0,42,13,14,69
32292,Cuba,2000.0,18,35,12,65
32293,Cuba,1992.0,42,13,14,69
32294,Cuba,1996.0,37,8,10,55
32295,Cuba,1972.0,3,1,18,22
32296,Cuba,2004.0,32,8,22,62
32297,Cuba,2000.0,18,35,12,65
32298,Cuba,2004.0,32,8,22,62
32299,Cuba,2008.0,2,34,11,47
32300,Cuba,2000.0,18,35,12,65
32301,Cuba,1996.0,37,8,10,55
32302,Cuba,2000.0,18,35,12,65
32303,Cuba,1996.0,37,8,10,55
32304,Cuba,1976.0,6,4,14,24
32305,Cuba,1992.0,42,13,14,69
32306,Cuba,1996.0,37,8,10,55
32307,Uruguay,1952.0,0,0,14,14
32308,Uruguay,1924.0,14,0,0,14
32309,Uruguay,1928.0,17,0,0,17
32310,Uruguay,1924.0,14,0,0,14
32311,Uruguay,1928.0,17,0,0,17
32312,Uruguay,1928.0,17,0,0,17
32313,Uruguay,1952.0,0,0,14,14
32314,Uruguay,1956.0,0,0,12,12
32315,Uruguay,1952.0,0,0,14,14
32316,Uruguay,1928.0,17,0,0,17
32317,Uruguay,1928.0,17,0,0,17
32318,Uruguay,1928.0,17,0,0,17
32319,Uruguay,1928.0,17,0,0,17
32320,Uruguay,1924.0,14,0,0,14
32321,Uruguay,1928.0,17,0,0,17
32322,Uruguay,1956.0,0,0,12,12
32323,Uruguay,1952.0,0,0,14,14
32324,Uruguay,1956.0,0,0,12,12
32325,Uruguay,1952.0,0,0,14,14
32326,Uruguay,1956.0,0,0,12,12
32327,Uruguay,1952.0,0,0,14,14
32328,Uruguay,1956.0,0,0,12,12
32329,Uruguay,1932.0,0,0,1,1
32330,Uruguay,1928.0,17,0,0,17
32331,Uruguay,1928.0,17,0,0,17
32332,Uruguay,1952.0,0,0,14,14
32333,Uruguay,1956.0,0,0,12,12
32334,Uruguay,1928.0,17,0,0,17
32335,Uruguay,1924.0,14,0,0,14
32336,Uruguay,1956.0,0,0,12,12
32337,Uruguay,1948.0,0,1,2,3
32338,Uruguay,1952.0,0,0,14,14
32339,Uruguay,1952.0,0,0,14,14
32340,Uruguay,1952.0,0,0,14,14
32341,Uruguay,1956.0,0,0,12,12
32342,Uruguay,1924.0,14,0,0,14
32343,Uruguay,1928.0,17,0,0,17
32344,Uruguay,1956.0,0,0,12,12
32345,Uruguay,1956.0,0,0,12,12
32346,Uruguay,1924.0,14,0,0,14
32347,Uruguay,1928.0,17,0,0,17
32348,Uruguay,1924.0,14,0,0,14
32349,Uruguay,1956.0,0,0,12,12
32350,Uruguay,1952.0,0,0,14,14
32351,Uruguay,1924.0,14,0,0,14
32352,Uruguay,1928.0,17,0,0,17
32353,Uruguay,1928.0,17,0,0,17
32354,Uruguay,1948.0,0,1,2,3
32355,Uruguay,1948.0,0,1,2,3
32356,Uruguay,1952.0,0,0,14,14
32357,Uruguay,1964.0,0,0,1,1
32358,Uruguay,1924.0,14,0,0,14
32359,Uruguay,1952.0,0,0,14,14
32360,Uruguay,1956.0,0,0,12,12
32361,Uruguay,1924.0,14,0,0,14
32362,Uruguay,1928.0,17,0,0,17
32363,Uruguay,1952.0,0,0,14,14
32364,Uruguay,1924.0,14,0,0,14
32365,Uruguay,1924.0,14,0,0,14
32366,Uruguay,1928.0,17,0,0,17
32367,Uruguay,1924.0,14,0,0,14
32368,Uruguay,2000.0,0,1,0,1
32369,Uruguay,1924.0,14,0,0,14
32370,Poland,1980.0,3,25,22,50
32371,Poland,1992.0,5,22,19,46
32372,Poland,1960.0,4,12,16,32
32373,Poland,1972.0,28,8,11,47
32374,Poland,1968.0,5,2,30,37
32375,Poland,2008.0,6,13,1,20
32376,Poland,1976.0,18,29,26,73
32377,Poland,1948.0,1,0,1,2
32378,Poland,1952.0,1,2,1,4
32379,Poland,1928.0,2,3,15,20
32380,Poland,1928.0,2,3,15,20
32381,Poland,1968.0,5,2,30,37
32382,Poland,1964.0,10,13,23,46
32383,Poland,1992.0,5,22,19,46
32384,Poland,2000.0,7,10,7,24
32385,Poland,1968.0,5,2,30,37
32386,Poland,1972.0,28,8,11,47
32387,Poland,1992.0,5,22,19,46
32388,Poland,1964.0,10,13,23,46
32389,Poland,1968.0,5,2,30,37
32390,Poland,1976.0,18,29,26,73
32391,Poland,1972.0,28,8,11,47
32392,Poland,1960.0,4,12,16,32
32393,Poland,1976.0,18,29,26,73
32394,Poland,2008.0,6,13,1,20
32395,Poland,1992.0,5,22,19,46
32396,Poland,2000.0,7,10,7,24
32397,Poland,1980.0,3,25,22,50
32398,Poland,1928.0,2,3,15,20
32399,Poland,2000.0,7,10,7,24
32400,Poland,2008.0,6,13,1,20
32401,Poland,1972.0,28,8,11,47
32402,Poland,1976.0,18,29,26,73
32403,Poland,1980.0,3,25,22,50
32404,Poland,1960.0,4,12,16,32
32405,Poland,2012.0,2,2,8,12
32406,Poland,2012.0,2,2,8,12
32407,Poland,1976.0,18,29,26,73
32408,Poland,1932.0,3,4,14,21
32409,Poland,1932.0,3,4,14,21
32410,Poland,2014.0,4,4,3,11
32411,Poland,2014.0,4,4,3,11
32412,Poland,1992.0,5,22,19,46
32413,Poland,1928.0,2,3,15,20
32414,Poland,1992.0,5,22,19,46
32415,Poland,1976.0,18,29,26,73
32416,Poland,1932.0,3,4,14,21
32417,Poland,1968.0,5,2,30,37
32418,Poland,1968.0,5,2,30,37
32419,Poland,1980.0,3,25,22,50
32420,Poland,1952.0,1,2,1,4
32421,Poland,2016.0,3,3,10,16
32422,Poland,1980.0,3,25,22,50
32423,Poland,1960.0,4,12,16,32
32424,Poland,1964.0,10,13,23,46
32425,Poland,1964.0,10,13,23,46
32426,Poland,1976.0,18,29,26,73
32427,Poland,1992.0,5,22,19,46
32428,Poland,1972.0,28,8,11,47
32429,Poland,1976.0,18,29,26,73
32430,Poland,1996.0,7,8,7,22
32431,Poland,1964.0,10,13,23,46
32432,Poland,1968.0,5,2,30,37
32433,Poland,1976.0,18,29,26,73
32434,Poland,2014.0,4,4,3,11
32435,Poland,1976.0,18,29,26,73
32436,Poland,1980.0,3,25,22,50
32437,Poland,1992.0,5,22,19,46
32438,Poland,1972.0,28,8,11,47
32439,Poland,1980.0,3,25,22,50
32440,Poland,1972.0,28,8,11,47
32441,Poland,1976.0,18,29,26,73
32442,Poland,1980.0,3,25,22,50
32443,Poland,1932.0,3,4,14,21
32444,Poland,1988.0,2,9,10,21
32445,Poland,1988.0,2,9,10,21
32446,Poland,1980.0,3,25,22,50
32447,Poland,1968.0,5,2,30,37
32448,Poland,1928.0,2,3,15,20
32449,Poland,1960.0,4,12,16,32
32450,Poland,1964.0,10,13,23,46
32451,Poland,1980.0,3,25,22,50
32452,Poland,1988.0,2,9,10,21
32453,Poland,1988.0,2,9,10,21
32454,Poland,1992.0,5,22,19,46
32455,Poland,1996.0,7,8,7,22
32456,Poland,1996.0,7,8,7,22
32457,Poland,1964.0,10,13,23,46
32458,Poland,1972.0,28,8,11,47
32459,Poland,1964.0,10,13,23,46
32460,Poland,1964.0,10,13,23,46
32461,Poland,1968.0,5,2,30,37
32462,Poland,1992.0,5,22,19,46
32463,Poland,1928.0,2,3,15,20
32464,Poland,1932.0,3,4,14,21
32465,Poland,2012.0,2,2,8,12
32466,Poland,2016.0,3,3,10,16
32467,Poland,1972.0,28,8,11,47
32468,Poland,1956.0,1,9,10,20
32469,Poland,1976.0,18,29,26,73
32470,Poland,1976.0,18,29,26,73
32471,Poland,1992.0,5,22,19,46
32472,Poland,1988.0,2,9,10,21
32473,Poland,1976.0,18,29,26,73
32474,Poland,1972.0,28,8,11,47
32475,Poland,1964.0,10,13,23,46
32476,Poland,1968.0,5,2,30,37
32477,Poland,1972.0,28,8,11,47
32478,Poland,1976.0,18,29,26,73
32479,Poland,1972.0,28,8,11,47
32480,Poland,1976.0,18,29,26,73
32481,Poland,1992.0,5,22,19,46
32482,Poland,1968.0,5,2,30,37
32483,Poland,1988.0,2,9,10,21
32484,Poland,1976.0,18,29,26,73
32485,Poland,1976.0,18,29,26,73
32486,Poland,2000.0,7,10,7,24
32487,Poland,2004.0,4,2,6,12
32488,Poland,1964.0,10,13,23,46
32489,Poland,1968.0,5,2,30,37
32490,Poland,1964.0,10,13,23,46
32491,Poland,1972.0,28,8,11,47
32492,Poland,1928.0,2,3,15,20
32493,Poland,1988.0,2,9,10,21
32494,Poland,1980.0,3,25,22,50
32495,Poland,1956.0,1,9,10,20
32496,Poland,1980.0,3,25,22,50
32497,Poland,1964.0,10,13,23,46
32498,Poland,1968.0,5,2,30,37
32499,Poland,2012.0,2,2,8,12
32500,Poland,1928.0,2,3,15,20
32501,Poland,1992.0,5,22,19,46
32502,Poland,1976.0,18,29,26,73
32503,Poland,1988.0,2,9,10,21
32504,Poland,1992.0,5,22,19,46
32505,Poland,2000.0,7,10,7,24
32506,Poland,2004.0,4,2,6,12
32507,Poland,2004.0,4,2,6,12
32508,Poland,2004.0,4,2,6,12
32509,Poland,2008.0,6,13,1,20
32510,Poland,1960.0,4,12,16,32
32511,Poland,1952.0,1,2,1,4
32512,Poland,1960.0,4,12,16,32
32513,Poland,1992.0,5,22,19,46
32514,Poland,1972.0,28,8,11,47
32515,Poland,1972.0,28,8,11,47
32516,Poland,1960.0,4,12,16,32
32517,Poland,1936.0,0,6,6,12
32518,Poland,1976.0,18,29,26,73
32519,Poland,1976.0,18,29,26,73
32520,Poland,1960.0,4,12,16,32
32521,Poland,1964.0,10,13,23,46
32522,Poland,1972.0,28,8,11,47
32523,Poland,1936.0,0,6,6,12
32524,Poland,1976.0,18,29,26,73
32525,Poland,1980.0,3,25,22,50
32526,Poland,1968.0,5,2,30,37
32527,Poland,1992.0,5,22,19,46
32528,Poland,1996.0,7,8,7,22
32529,Poland,1996.0,7,8,7,22
32530,Poland,1976.0,18,29,26,73
32531,Poland,1932.0,3,4,14,21
32532,Poland,1936.0,0,6,6,12
32533,Poland,1992.0,5,22,19,46
32534,Poland,1964.0,10,13,23,46
32535,Poland,1964.0,10,13,23,46
32536,Poland,1972.0,28,8,11,47
32537,Poland,1976.0,18,29,26,73
32538,Poland,2016.0,3,3,10,16
32539,Poland,1992.0,5,22,19,46
32540,Poland,1932.0,3,4,14,21
32541,Poland,1952.0,1,2,1,4
32542,Poland,1960.0,4,12,16,32
32543,Poland,1972.0,28,8,11,47
32544,Poland,2008.0,6,13,1,20
32545,Poland,1972.0,28,8,11,47
32546,Poland,1932.0,3,4,14,21
32547,Poland,1928.0,2,3,15,20
32548,Poland,1964.0,10,13,23,46
32549,Poland,2008.0,6,13,1,20
32550,Poland,1996.0,7,8,7,22
32551,Poland,2000.0,7,10,7,24
32552,Poland,2000.0,7,10,7,24
32553,Poland,2004.0,4,2,6,12
32554,Poland,1980.0,3,25,22,50
32555,Poland,1980.0,3,25,22,50
32556,Poland,1976.0,18,29,26,73
32557,Poland,1972.0,28,8,11,47
32558,Poland,1956.0,1,9,10,20
32559,Poland,1992.0,5,22,19,46
32560,Poland,2000.0,7,10,7,24
32561,Poland,1980.0,3,25,22,50
32562,Poland,1980.0,3,25,22,50
32563,Poland,2006.0,0,1,1,2
32564,Poland,2010.0,1,3,4,8
32565,Poland,2010.0,1,3,4,8
32566,Poland,2010.0,1,3,4,8
32567,Poland,2014.0,4,4,3,11
32568,Poland,1992.0,5,22,19,46
32569,Poland,1980.0,3,25,22,50
32570,Poland,1980.0,3,25,22,50
32571,Poland,1972.0,28,8,11,47
32572,Poland,1980.0,3,25,22,50
32573,Poland,1992.0,5,22,19,46
32574,Poland,2000.0,7,10,7,24
32575,Poland,2008.0,6,13,1,20
32576,Poland-1,2000.0,7,10,7,24
32577,Poland,1972.0,28,8,11,47
32578,Poland,1924.0,0,4,1,5
32579,Poland,1964.0,10,13,23,46
32580,Poland,1968.0,5,2,30,37
32581,Poland,1956.0,1,9,10,20
32582,Poland,1960.0,4,12,16,32
32583,Poland,1992.0,5,22,19,46
32584,Poland,1996.0,7,8,7,22
32585,Poland,1960.0,4,12,16,32
32586,Poland,1992.0,5,22,19,46
32587,Poland,1980.0,3,25,22,50
32588,Poland,2000.0,7,10,7,24
32589,Poland,2004.0,4,2,6,12
32590,Poland,1976.0,18,29,26,73
32591,Poland,1964.0,10,13,23,46
32592,Poland,1968.0,5,2,30,37
32593,Poland,1936.0,0,6,6,12
32594,Poland,1992.0,5,22,19,46
32595,Poland,1932.0,3,4,14,21
32596,Poland,1956.0,1,9,10,20
32597,Poland,1960.0,4,12,16,32
32598,Poland,1996.0,7,8,7,22
32599,Poland,2004.0,4,2,6,12
32600,Poland,1936.0,0,6,6,12
32601,Poland,1972.0,28,8,11,47
32602,Poland,1976.0,18,29,26,73
32603,Poland,1980.0,3,25,22,50
32604,Poland,1924.0,0,4,1,5
32605,Poland,1980.0,3,25,22,50
32606,Poland,1928.0,2,3,15,20
32607,Poland,1972.0,28,8,11,47
32608,Poland,1976.0,18,29,26,73
32609,Poland,1992.0,5,22,19,46
32610,Poland,1992.0,5,22,19,46
32611,Poland,1976.0,18,29,26,73
32612,Poland,1924.0,0,4,1,5
32613,Poland,1988.0,2,9,10,21
32614,Poland,1988.0,2,9,10,21
32615,Poland,1964.0,10,13,23,46
32616,Poland,1968.0,5,2,30,37
32617,Poland,1988.0,2,9,10,21
32618,Poland,1992.0,5,22,19,46
32619,Poland,1936.0,0,6,6,12
32620,Poland,1960.0,4,12,16,32
32621,Poland,1988.0,2,9,10,21
32622,Poland,2016.0,3,3,10,16
32623,Poland,1980.0,3,25,22,50
32624,Poland,1980.0,3,25,22,50
32625,Poland,1972.0,28,8,11,47
32626,Poland,1976.0,18,29,26,73
32627,Poland,1980.0,3,25,22,50
32628,Poland,1972.0,28,8,11,47
32629,Poland,1968.0,5,2,30,37
32630,Poland,1972.0,28,8,11,47
32631,Poland,1932.0,3,4,14,21
32632,Poland,1976.0,18,29,26,73
32633,Poland,2016.0,3,3,10,16
32634,Poland,2008.0,6,13,1,20
32635,Poland,2012.0,2,2,8,12
32636,Poland,2016.0,3,3,10,16
32637,Poland,1992.0,5,22,19,46
32638,Poland,1976.0,18,29,26,73
32639,Poland,1980.0,3,25,22,50
32640,Poland,1964.0,10,13,23,46
32641,Poland,1996.0,7,8,7,22
32642,Poland,1964.0,10,13,23,46
32643,Poland,1968.0,5,2,30,37
32644,Poland,1972.0,28,8,11,47
32645,Poland,1972.0,28,8,11,47
32646,Poland,1976.0,18,29,26,73
32647,Poland,1996.0,7,8,7,22
32648,Poland,1996.0,7,8,7,22
32649,Poland,2000.0,7,10,7,24
32650,Poland,2008.0,6,13,1,20
32651,Poland,2016.0,3,3,10,16
32652,Poland,1928.0,2,3,15,20
32653,Poland,2002.0,0,1,1,2
32654,Poland,2002.0,0,1,1,2
32655,Poland,2010.0,1,3,4,8
32656,Poland,2010.0,1,3,4,8
32657,Poland,1976.0,18,29,26,73
32658,Poland,2012.0,2,2,8,12
32659,Poland,2016.0,3,3,10,16
32660,Poland,2012.0,2,2,8,12
32661,Poland,1992.0,5,22,19,46
32662,Poland,1932.0,3,4,14,21
32663,Poland,2008.0,6,13,1,20
32664,Poland,2012.0,2,2,8,12
32665,Poland,2016.0,3,3,10,16
32666,Poland,2008.0,6,13,1,20
32667,Poland,1976.0,18,29,26,73
32668,Poland,2000.0,7,10,7,24
32669,Poland,1976.0,18,29,26,73
32670,Poland,2012.0,2,2,8,12
32671,Poland,2016.0,3,3,10,16
32672,Poland,1996.0,7,8,7,22
32673,Poland,1956.0,1,9,10,20
32674,Poland,2014.0,4,4,3,11
32675,Poland,1968.0,5,2,30,37
32676,Poland,1968.0,5,2,30,37
32677,Poland,2012.0,2,2,8,12
32678,Poland,2016.0,3,3,10,16
32679,Poland,1980.0,3,25,22,50
32680,Poland,1964.0,10,13,23,46
32681,Poland,1956.0,1,9,10,20
32682,Poland,1996.0,7,8,7,22
32683,Poland,1976.0,18,29,26,73
32684,Poland,1976.0,18,29,26,73
32685,Poland,2016.0,3,3,10,16
32686,Poland,1960.0,4,12,16,32
32687,Poland,1964.0,10,13,23,46
32688,Poland,1976.0,18,29,26,73
32689,Poland,1964.0,10,13,23,46
32690,Poland,1968.0,5,2,30,37
32691,Poland,1988.0,2,9,10,21
32692,Poland,1976.0,18,29,26,73
32693,Poland,1928.0,2,3,15,20
32694,Poland,1972.0,28,8,11,47
32695,Poland,1936.0,0,6,6,12
32696,Poland,1968.0,5,2,30,37
32697,Poland,1968.0,5,2,30,37
32698,Poland,1972.0,28,8,11,47
32699,Poland,1960.0,4,12,16,32
32700,Poland,1964.0,10,13,23,46
32701,Poland,1928.0,2,3,15,20
32702,Poland,1932.0,3,4,14,21
32703,Poland,1936.0,0,6,6,12
32704,Poland,1992.0,5,22,19,46
32705,Poland,1996.0,7,8,7,22
32706,Poland,1964.0,10,13,23,46
32707,Poland,1968.0,5,2,30,37
32708,Poland,2000.0,7,10,7,24
32709,Poland,2004.0,4,2,6,12
32710,Poland,2008.0,6,13,1,20
32711,Poland,2008.0,6,13,1,20
32712,Poland,1956.0,1,9,10,20
32713,Poland,1980.0,3,25,22,50
32714,Poland,1988.0,2,9,10,21
32715,Poland,1956.0,1,9,10,20
32716,Poland,1956.0,1,9,10,20
32717,Poland,1960.0,4,12,16,32
32718,Poland,1964.0,10,13,23,46
32719,Poland,1968.0,5,2,30,37
32720,Poland,2008.0,6,13,1,20
32721,Poland,1960.0,4,12,16,32
32722,Poland,1988.0,2,9,10,21
32723,Poland,1956.0,1,9,10,20
32724,Poland,1960.0,4,12,16,32
32725,Poland,1964.0,10,13,23,46
32726,Poland,1976.0,18,29,26,73
32727,Poland,1956.0,1,9,10,20
32728,Poland,1960.0,4,12,16,32
32729,Poland,1964.0,10,13,23,46
32730,Poland,1960.0,4,12,16,32
32731,Poland,1972.0,28,8,11,47
32732,Poland,1976.0,18,29,26,73
32733,Poland,1968.0,5,2,30,37
32734,Poland,1976.0,18,29,26,73
32735,Poland,1976.0,18,29,26,73
32736,Poland,1956.0,1,9,10,20
32737,Poland,2008.0,6,13,1,20
32738,Poland,1960.0,4,12,16,32
32739,Poland,1964.0,10,13,23,46
32740,Poland,1980.0,3,25,22,50
32741,Poland,1996.0,7,8,7,22
32742,Poland,2004.0,4,2,6,12
32743,Poland,1976.0,18,29,26,73
32744,Poland,1964.0,10,13,23,46
32745,Poland,1972.0,28,8,11,47
32746,Poland,1976.0,18,29,26,73
32747,Poland,1960.0,4,12,16,32
32748,Poland,1964.0,10,13,23,46
32749,Poland,1976.0,18,29,26,73
32750,Poland,1980.0,3,25,22,50
32751,Poland,1976.0,18,29,26,73
32752,Poland,2000.0,7,10,7,24
32753,Poland,1976.0,18,29,26,73
32754,Poland,1980.0,3,25,22,50
32755,Poland,1996.0,7,8,7,22
32756,Poland,1976.0,18,29,26,73
32757,Poland,1980.0,3,25,22,50
32758,Poland,1928.0,2,3,15,20
32759,Poland,1932.0,3,4,14,21
32760,Poland,1960.0,4,12,16,32
32761,Poland,2000.0,7,10,7,24
32762,Poland,1980.0,3,25,22,50
32763,Poland,1956.0,1,9,10,20
32764,Poland,1992.0,5,22,19,46
32765,Poland,1992.0,5,22,19,46
32766,Poland,2006.0,0,1,1,2
32767,Poland,1928.0,2,3,15,20
32768,Poland,2000.0,7,10,7,24
32769,Poland,1932.0,3,4,14,21
32770,Poland,1932.0,3,4,14,21
32771,Poland,1976.0,18,29,26,73
32772,Poland,1964.0,10,13,23,46
32773,Poland,1968.0,5,2,30,37
32774,Poland,1980.0,3,25,22,50
32775,Poland,1976.0,18,29,26,73
32776,Poland,1992.0,5,22,19,46
32777,Poland,1992.0,5,22,19,46
32778,Poland,1968.0,5,2,30,37
32779,Poland,1932.0,3,4,14,21
32780,Poland,1932.0,3,4,14,21
32781,Poland,1964.0,10,13,23,46
32782,Poland,1976.0,18,29,26,73
32783,Poland,1980.0,3,25,22,50
32784,Poland,1972.0,28,8,11,47
32785,Poland,1956.0,1,9,10,20
32786,Poland,1992.0,5,22,19,46
32787,Poland,1996.0,7,8,7,22
32788,Poland,2000.0,7,10,7,24
32789,Poland,2004.0,4,2,6,12
32790,Poland,1976.0,18,29,26,73
32791,Poland,2016.0,3,3,10,16
32792,Poland,1980.0,3,25,22,50
32793,Poland,1992.0,5,22,19,46
32794,Poland-1,2000.0,7,10,7,24
32795,Poland,1924.0,0,4,1,5
32796,Poland,1980.0,3,25,22,50
32797,Poland,1976.0,18,29,26,73
32798,Poland,1980.0,3,25,22,50
32799,Poland,1992.0,5,22,19,46
32800,Poland,2014.0,4,4,3,11
32801,Poland,2014.0,4,4,3,11
32802,Poland,1992.0,5,22,19,46
32803,Poland,1980.0,3,25,22,50
32804,Poland,1980.0,3,25,22,50
32805,Poland,1932.0,3,4,14,21
32806,Poland,1992.0,5,22,19,46
32807,Poland,1980.0,3,25,22,50
32808,Poland,2000.0,7,10,7,24
32809,Poland,2004.0,4,2,6,12
32810,Poland,1980.0,3,25,22,50
32811,Poland,1992.0,5,22,19,46
32812,Poland,1988.0,2,9,10,21
32813,Poland,1976.0,18,29,26,73
32814,Poland,1996.0,7,8,7,22
32815,Poland,1972.0,28,8,11,47
32816,Poland,1976.0,18,29,26,73
32817,Poland,1980.0,3,25,22,50
32818,Poland,1956.0,1,9,10,20
32819,Poland,1964.0,10,13,23,46
32820,Poland,1968.0,5,2,30,37
32821,Poland,1964.0,10,13,23,46
32822,Poland,1964.0,10,13,23,46
32823,Poland,1964.0,10,13,23,46
32824,Poland,1968.0,5,2,30,37
32825,Poland,1968.0,5,2,30,37
32826,Poland,1972.0,28,8,11,47
32827,Poland,1976.0,18,29,26,73
32828,Poland,1960.0,4,12,16,32
32829,Poland,1964.0,10,13,23,46
32830,Poland,1928.0,2,3,15,20
32831,Poland,1972.0,28,8,11,47
32832,Poland,1976.0,18,29,26,73
32833,Poland,1972.0,28,8,11,47
32834,Poland,1992.0,5,22,19,46
32835,Poland,1972.0,28,8,11,47
32836,Poland,1976.0,18,29,26,73
32837,Poland,1972.0,28,8,11,47
32838,Poland,1972.0,28,8,11,47
32839,Poland,1972.0,28,8,11,47
32840,Poland,1976.0,18,29,26,73
32841,Poland,2014.0,4,4,3,11
32842,Poland,1976.0,18,29,26,73
32843,Poland,1972.0,28,8,11,47
32844,Poland,1924.0,0,4,1,5
32845,Poland,1976.0,18,29,26,73
32846,Poland,1980.0,3,25,22,50
32847,Poland,1976.0,18,29,26,73
32848,Poland,1992.0,5,22,19,46
32849,Poland,1988.0,2,9,10,21
32850,Poland,1992.0,5,22,19,46
32851,Poland,1996.0,7,8,7,22
32852,Poland,1968.0,5,2,30,37
32853,Poland,1928.0,2,3,15,20
32854,Poland,1960.0,4,12,16,32
32855,Poland,1948.0,1,0,1,2
32856,Poland,1932.0,3,4,14,21
32857,Poland,1936.0,0,6,6,12
32858,Poland,1936.0,0,6,6,12
32859,Poland,1928.0,2,3,15,20
32860,Poland,1932.0,3,4,14,21
32861,Poland,1936.0,0,6,6,12
32862,Poland,1960.0,4,12,16,32
32863,Poland,1964.0,10,13,23,46
32864,Poland,1932.0,3,4,14,21
32865,Poland,1936.0,0,6,6,12
32866,Poland,2016.0,3,3,10,16
32867,Poland,1992.0,5,22,19,46
32868,Poland,1960.0,4,12,16,32
32869,Poland,2008.0,6,13,1,20
32870,Poland,1976.0,18,29,26,73
32871,Poland,1992.0,5,22,19,46
32872,Poland,1976.0,18,29,26,73
32873,Poland,1968.0,5,2,30,37
32874,Poland,1976.0,18,29,26,73
32875,Poland,2008.0,6,13,1,20
32876,Poland,1928.0,2,3,15,20
32877,Poland,2008.0,6,13,1,20
32878,Poland,1956.0,1,9,10,20
32879,Poland,2000.0,7,10,7,24
32880,Poland,2012.0,2,2,8,12
32881,Poland,2016.0,3,3,10,16
32882,Poland,2008.0,6,13,1,20
32883,Poland,2016.0,3,3,10,16
32884,Poland,2010.0,1,3,4,8
32885,Poland,2014.0,4,4,3,11
32886,Poland,1976.0,18,29,26,73
32887,Poland,1988.0,2,9,10,21
32888,Poland,1976.0,18,29,26,73
32889,Poland,2000.0,7,10,7,24
32890,Poland,1996.0,7,8,7,22
32891,Poland,1980.0,3,25,22,50
32892,Poland,1964.0,10,13,23,46
32893,Poland,1968.0,5,2,30,37
32894,Poland,1972.0,28,8,11,47
32895,Poland,1972.0,28,8,11,47
32896,Poland,2010.0,1,3,4,8
32897,Poland,2014.0,4,4,3,11
32898,Poland,1992.0,5,22,19,46
32899,Poland,2000.0,7,10,7,24
32900,Poland,2004.0,4,2,6,12
32901,Poland,1988.0,2,9,10,21
32902,Poland,1996.0,7,8,7,22
32903,Poland,1976.0,18,29,26,73
32904,Poland,1980.0,3,25,22,50
32905,Poland,1980.0,3,25,22,50
32906,Poland,1928.0,2,3,15,20
32907,Poland,1956.0,1,9,10,20
32908,Poland,1960.0,4,12,16,32
32909,Poland,1964.0,10,13,23,46
32910,Poland,1972.0,28,8,11,47
32911,Poland,1968.0,5,2,30,37
32912,Poland,1972.0,28,8,11,47
32913,Poland,1988.0,2,9,10,21
32914,Poland,1976.0,18,29,26,73
32915,Poland,1988.0,2,9,10,21
32916,Poland,1996.0,7,8,7,22
32917,Poland,2008.0,6,13,1,20
32918,Poland,2012.0,2,2,8,12
32919,Poland,1964.0,10,13,23,46
32920,Poland,1956.0,1,9,10,20
32921,Poland,1964.0,10,13,23,46
32922,Poland,1968.0,5,2,30,37
32923,Poland,1960.0,4,12,16,32
32924,Poland,1976.0,18,29,26,73
32925,Poland,1960.0,4,12,16,32
32926,Poland,2000.0,7,10,7,24
32927,Poland,2010.0,1,3,4,8
32928,Poland,2014.0,4,4,3,11
32929,Poland,1976.0,18,29,26,73
32930,Poland,1956.0,1,9,10,20
32931,Poland,1960.0,4,12,16,32
32932,Poland,1964.0,10,13,23,46
32933,Poland,1980.0,3,25,22,50
32934,Poland,1980.0,3,25,22,50
32935,Czechoslovakia,1976.0,2,23,9,34
32936,Czechoslovakia,1964.0,5,37,29,71
32937,Czechoslovakia,1952.0,11,4,10,25
32938,Czechoslovakia,1976.0,2,23,9,34
32939,Czechoslovakia,1992.0,4,3,28,35
32940,Czechoslovakia,1936.0,5,12,1,18
32941,Czechoslovakia,1992.0,4,3,28,35
32942,Czechoslovakia,1976.0,2,23,9,34
32943,Czechoslovakia,1976.0,2,23,9,34
32944,Czechoslovakia,1972.0,3,21,25,49
32945,Czechoslovakia,1988.0,3,5,8,16
32946,Czechoslovakia,1984.0,0,24,4,28
32947,Czechoslovakia,1988.0,3,5,8,16
32948,Czechoslovakia,1972.0,3,21,25,49
32949,Czechoslovakia,1980.0,17,18,17,52
32950,Czechoslovakia,1980.0,17,18,17,52
32951,Czechoslovakia,1952.0,11,4,10,25
32952,Czechoslovakia,1952.0,11,4,10,25
32953,Czechoslovakia,1956.0,1,5,1,7
32954,Czechoslovakia,1960.0,4,8,11,23
32955,Czechoslovakia,1960.0,4,8,11,23
32956,Czechoslovakia,1948.0,14,20,3,37
32957,Czechoslovakia,1992.0,4,3,28,35
32958,Czechoslovakia,1964.0,5,37,29,71
32959,Czechoslovakia,1972.0,3,21,25,49
32960,Czechoslovakia,1936.0,5,12,1,18
32961,Czechoslovakia,1948.0,14,20,3,37
32962,Czechoslovakia,1952.0,11,4,10,25
32963,Czechoslovakia,1976.0,2,23,9,34
32964,Czechoslovakia,1948.0,14,20,3,37
32965,Czechoslovakia,1964.0,5,37,29,71
32966,Czechoslovakia,1980.0,17,18,17,52
32967,Czechoslovakia,1928.0,2,12,3,17
32968,Czechoslovakia,1984.0,0,24,4,28
32969,Czechoslovakia,1948.0,14,20,3,37
32970,Czechoslovakia,1960.0,4,8,11,23
32971,Czechoslovakia,1964.0,5,37,29,71
32972,Czechoslovakia,1964.0,5,37,29,71
32973,Czechoslovakia,1964.0,5,37,29,71
32974,Czechoslovakia,1964.0,5,37,29,71
32975,Czechoslovakia,1968.0,8,26,16,50
32976,Czechoslovakia,1968.0,8,26,16,50
32977,Czechoslovakia,1968.0,8,26,16,50
32978,Czechoslovakia,1968.0,8,26,16,50
32979,Czechoslovakia,1968.0,8,26,16,50
32980,Czechoslovakia,1968.0,8,26,16,50
32981,Czechoslovakia,1964.0,5,37,29,71
32982,Czechoslovakia,1980.0,17,18,17,52
32983,Czechoslovakia,1984.0,0,24,4,28
32984,Czechoslovakia,1964.0,5,37,29,71
32985,Czechoslovakia,1968.0,8,26,16,50
32986,Czechoslovakia,1972.0,3,21,25,49
32987,Czechoslovakia,1980.0,17,18,17,52
32988,Czechoslovakia,1952.0,11,4,10,25
32989,Czechoslovakia,1976.0,2,23,9,34
32990,Czechoslovakia,1984.0,0,24,4,28
32991,Czechoslovakia,1992.0,4,3,28,35
32992,Czechoslovakia,1984.0,0,24,4,28
32993,Czechoslovakia,1976.0,2,23,9,34
32994,Czechoslovakia,1964.0,5,37,29,71
32995,Czechoslovakia,1964.0,5,37,29,71
32996,Czechoslovakia,1964.0,5,37,29,71
32997,Czechoslovakia,1964.0,5,37,29,71
32998,Czechoslovakia,1968.0,8,26,16,50
32999,Czechoslovakia,1972.0,3,21,25,49
33000,Czechoslovakia,1936.0,5,12,1,18
33001,Czechoslovakia,1960.0,4,8,11,23
33002,Czechoslovakia,1936.0,5,12,1,18
33003,Czechoslovakia,1964.0,5,37,29,71
33004,Czechoslovakia,1952.0,11,4,10,25
33005,Czechoslovakia,1932.0,1,3,2,6
33006,Czechoslovakia,1948.0,14,20,3,37
33007,Czechoslovakia,1968.0,8,26,16,50
33008,Czechoslovakia,1972.0,3,21,25,49
33009,Czechoslovakia,1924.0,1,4,5,10
33010,Czechoslovakia,1976.0,2,23,9,34
33011,Czechoslovakia,1964.0,5,37,29,71
33012,Czechoslovakia,1968.0,8,26,16,50
33013,Czechoslovakia,1972.0,3,21,25,49
33014,Czechoslovakia,1976.0,2,23,9,34
33015,Czechoslovakia,1928.0,2,12,3,17
33016,Czechoslovakia,1972.0,3,21,25,49
33017,Czechoslovakia,1972.0,3,21,25,49
33018,Czechoslovakia,1976.0,2,23,9,34
33019,Czechoslovakia,1956.0,1,5,1,7
33020,Czechoslovakia,1936.0,5,12,1,18
33021,Czechoslovakia,1956.0,1,5,1,7
33022,Czechoslovakia,1956.0,1,5,1,7
33023,Czechoslovakia,1980.0,17,18,17,52
33024,Czechoslovakia,1928.0,2,12,3,17
33025,Czechoslovakia,1964.0,5,37,29,71
33026,Czechoslovakia,1992.0,4,3,28,35
33027,Czechoslovakia,1964.0,5,37,29,71
33028,Czechoslovakia,1968.0,8,26,16,50
33029,Czechoslovakia,1964.0,5,37,29,71
33030,Czechoslovakia,1968.0,8,26,16,50
33031,Czechoslovakia,1964.0,5,37,29,71
33032,Czechoslovakia,1968.0,8,26,16,50
33033,Czechoslovakia,1992.0,4,3,28,35
33034,Czechoslovakia,1972.0,3,21,25,49
33035,Czechoslovakia,1948.0,14,20,3,37
33036,Czechoslovakia,1980.0,17,18,17,52
33037,Czechoslovakia,1920.0,0,0,10,10
33038,Czechoslovakia,1968.0,8,26,16,50
33039,Czechoslovakia,1948.0,14,20,3,37
33040,Czechoslovakia,1952.0,11,4,10,25
33041,Czechoslovakia,1968.0,8,26,16,50
33042,Czechoslovakia,1976.0,2,23,9,34
33043,Czechoslovakia,1936.0,5,12,1,18
33044,Czechoslovakia,1928.0,2,12,3,17
33045,Czechoslovakia,1972.0,3,21,25,49
33046,Czechoslovakia,1976.0,2,23,9,34
33047,Czechoslovakia,1964.0,5,37,29,71
33048,Czechoslovakia,1972.0,3,21,25,49
33049,Czechoslovakia,1976.0,2,23,9,34
33050,Czechoslovakia,1948.0,14,20,3,37
33051,Czechoslovakia,1952.0,11,4,10,25
33052,Czechoslovakia,1972.0,3,21,25,49
33053,Czechoslovakia,1964.0,5,37,29,71
33054,Czechoslovakia,1968.0,8,26,16,50
33055,Czechoslovakia,1972.0,3,21,25,49
33056,Czechoslovakia,1976.0,2,23,9,34
33057,Czechoslovakia,1948.0,14,20,3,37
33058,Czechoslovakia,1984.0,0,24,4,28
33059,Czechoslovakia,1992.0,4,3,28,35
33060,Czechoslovakia,1968.0,8,26,16,50
33061,Czechoslovakia,1972.0,3,21,25,49
33062,Czechoslovakia,1956.0,1,5,1,7
33063,Czechoslovakia,1968.0,8,26,16,50
33064,Czechoslovakia,1992.0,4,3,28,35
33065,Czechoslovakia,1984.0,0,24,4,28
33066,Czechoslovakia,1992.0,4,3,28,35
33067,Czechoslovakia,1936.0,5,12,1,18
33068,Czechoslovakia,1980.0,17,18,17,52
33069,Czechoslovakia,1980.0,17,18,17,52
33070,Czechoslovakia,1968.0,8,26,16,50
33071,Czechoslovakia,1936.0,5,12,1,18
33072,Czechoslovakia,1964.0,5,37,29,71
33073,Czechoslovakia,1952.0,11,4,10,25
33074,Czechoslovakia,1960.0,4,8,11,23
33075,Czechoslovakia,1992.0,4,3,28,35
33076,Czechoslovakia,1972.0,3,21,25,49
33077,Czechoslovakia,1960.0,4,8,11,23
33078,Czechoslovakia,1964.0,5,37,29,71
33079,Czechoslovakia,1948.0,14,20,3,37
33080,Czechoslovakia,1972.0,3,21,25,49
33081,Czechoslovakia,1992.0,4,3,28,35
33082,Czechoslovakia,1980.0,17,18,17,52
33083,Czechoslovakia,1984.0,0,24,4,28
33084,Czechoslovakia,1984.0,0,24,4,28
33085,Czechoslovakia,1992.0,4,3,28,35
33086,Czechoslovakia,1952.0,11,4,10,25
33087,Czechoslovakia,1952.0,11,4,10,25
33088,Czechoslovakia,1960.0,4,8,11,23
33089,Czechoslovakia,1964.0,5,37,29,71
33090,Czechoslovakia,1968.0,8,26,16,50
33091,Czechoslovakia,1984.0,0,24,4,28
33092,Czechoslovakia,1992.0,4,3,28,35
33093,Czechoslovakia,1980.0,17,18,17,52
33094,Czechoslovakia,1976.0,2,23,9,34
33095,Czechoslovakia,1980.0,17,18,17,52
33096,Czechoslovakia,1936.0,5,12,1,18
33097,Czechoslovakia,1992.0,4,3,28,35
33098,Czechoslovakia,1972.0,3,21,25,49
33099,Czechoslovakia,1964.0,5,37,29,71
33100,Czechoslovakia,1968.0,8,26,16,50
33101,Czechoslovakia,1936.0,5,12,1,18
33102,Czechoslovakia,1980.0,17,18,17,52
33103,Czechoslovakia,1972.0,3,21,25,49
33104,Czechoslovakia,1968.0,8,26,16,50
33105,Czechoslovakia,1964.0,5,37,29,71
33106,Czechoslovakia,1964.0,5,37,29,71
33107,Czechoslovakia,1948.0,14,20,3,37
33108,Czechoslovakia,1968.0,8,26,16,50
33109,Czechoslovakia,1972.0,3,21,25,49
33110,Czechoslovakia,1980.0,17,18,17,52
33111,Czechoslovakia,1972.0,3,21,25,49
33112,Czechoslovakia,1980.0,17,18,17,52
33113,Czechoslovakia,1960.0,4,8,11,23
33114,Czechoslovakia,1964.0,5,37,29,71
33115,Czechoslovakia,1948.0,14,20,3,37
33116,Czechoslovakia,1964.0,5,37,29,71
33117,Czechoslovakia,1968.0,8,26,16,50
33118,Czechoslovakia,1952.0,11,4,10,25
33119,Czechoslovakia,1984.0,0,24,4,28
33120,Czechoslovakia,1964.0,5,37,29,71
33121,Czechoslovakia,1988.0,3,5,8,16
33122,Czechoslovakia,1980.0,17,18,17,52
33123,Czechoslovakia,1968.0,8,26,16,50
33124,Czechoslovakia,1924.0,1,4,5,10
33125,Czechoslovakia,1928.0,2,12,3,17
33126,Czechoslovakia,1948.0,14,20,3,37
33127,Czechoslovakia,1960.0,4,8,11,23
33128,Czechoslovakia,1980.0,17,18,17,52
33129,Czechoslovakia,1972.0,3,21,25,49
33130,Czechoslovakia,1984.0,0,24,4,28
33131,Czechoslovakia,1980.0,17,18,17,52
33132,Czechoslovakia,1972.0,3,21,25,49
33133,Czechoslovakia,1936.0,5,12,1,18
33134,Czechoslovakia,1980.0,17,18,17,52
33135,Czechoslovakia,1960.0,4,8,11,23
33136,Czechoslovakia,1964.0,5,37,29,71
33137,Czechoslovakia,1968.0,8,26,16,50
33138,Czechoslovakia,1948.0,14,20,3,37
33139,Czechoslovakia,1952.0,11,4,10,25
33140,Czechoslovakia,1980.0,17,18,17,52
33141,Czechoslovakia,1968.0,8,26,16,50
33142,Czechoslovakia,1984.0,0,24,4,28
33143,Czechoslovakia,1980.0,17,18,17,52
33144,Czechoslovakia,1976.0,2,23,9,34
33145,Czechoslovakia,1972.0,3,21,25,49
33146,Czechoslovakia,1980.0,17,18,17,52
33147,Czechoslovakia,1984.0,0,24,4,28
33148,Czechoslovakia,1992.0,4,3,28,35
33149,Czechoslovakia,1984.0,0,24,4,28
33150,Czechoslovakia,1992.0,4,3,28,35
33151,Czechoslovakia,1964.0,5,37,29,71
33152,Czechoslovakia,1980.0,17,18,17,52
33153,Czechoslovakia,1968.0,8,26,16,50
33154,Czechoslovakia,1928.0,2,12,3,17
33155,Czechoslovakia,1928.0,2,12,3,17
33156,Czechoslovakia,1928.0,2,12,3,17
33157,Czechoslovakia,1988.0,3,5,8,16
33158,Czechoslovakia,1920.0,0,0,10,10
33159,Czechoslovakia,1992.0,4,3,28,35
33160,Czechoslovakia,1984.0,0,24,4,28
33161,Czechoslovakia,1972.0,3,21,25,49
33162,Czechoslovakia,1960.0,4,8,11,23
33163,Czechoslovakia,1964.0,5,37,29,71
33164,Czechoslovakia,1952.0,11,4,10,25
33165,Czechoslovakia,1960.0,4,8,11,23
33166,Czechoslovakia,1980.0,17,18,17,52
33167,Czechoslovakia,1972.0,3,21,25,49
33168,Czechoslovakia,1976.0,2,23,9,34
33169,Czechoslovakia,1968.0,8,26,16,50
33170,Czechoslovakia,1972.0,3,21,25,49
33171,Czechoslovakia,1976.0,2,23,9,34
33172,Czechoslovakia,1956.0,1,5,1,7
33173,Czechoslovakia,1988.0,3,5,8,16
33174,Czechoslovakia,1972.0,3,21,25,49
33175,Czechoslovakia,1972.0,3,21,25,49
33176,Czechoslovakia,1976.0,2,23,9,34
33177,Czechoslovakia,1968.0,8,26,16,50
33178,Czechoslovakia,1964.0,5,37,29,71
33179,Czechoslovakia,1968.0,8,26,16,50
33180,Czechoslovakia,1964.0,5,37,29,71
33181,Czechoslovakia,1952.0,11,4,10,25
33182,Czechoslovakia,1960.0,4,8,11,23
33183,Czechoslovakia,1928.0,2,12,3,17
33184,Czechoslovakia,1980.0,17,18,17,52
33185,Czechoslovakia,1988.0,3,5,8,16
33186,Czechoslovakia,1988.0,3,5,8,16
33187,Czechoslovakia,1952.0,11,4,10,25
33188,Czechoslovakia,1972.0,3,21,25,49
33189,Czechoslovakia,1948.0,14,20,3,37
33190,Czechoslovakia,1948.0,14,20,3,37
33191,Czechoslovakia,1924.0,1,4,5,10
33192,Czechoslovakia,1936.0,5,12,1,18
33193,Czechoslovakia,1964.0,5,37,29,71
33194,Czechoslovakia,1964.0,5,37,29,71
33195,Czechoslovakia,1948.0,14,20,3,37
33196,Czechoslovakia,1964.0,5,37,29,71
33197,Czechoslovakia,1968.0,8,26,16,50
33198,Czechoslovakia,1964.0,5,37,29,71
33199,Czechoslovakia,1964.0,5,37,29,71
33200,Czechoslovakia,1968.0,8,26,16,50
33201,Czechoslovakia,1968.0,8,26,16,50
33202,Czechoslovakia,1972.0,3,21,25,49
33203,Czechoslovakia,1972.0,3,21,25,49
33204,Czechoslovakia,1960.0,4,8,11,23
33205,Czechoslovakia,1980.0,17,18,17,52
33206,Czechoslovakia,1960.0,4,8,11,23
33207,Czechoslovakia,1964.0,5,37,29,71
33208,Czechoslovakia,1968.0,8,26,16,50
33209,Czechoslovakia,1972.0,3,21,25,49
33210,Czechoslovakia,1964.0,5,37,29,71
33211,Czechoslovakia,1972.0,3,21,25,49
33212,Czechoslovakia,1976.0,2,23,9,34
33213,Czechoslovakia,1976.0,2,23,9,34
33214,Czechoslovakia,1988.0,3,5,8,16
33215,Czechoslovakia,1976.0,2,23,9,34
33216,Czechoslovakia,1964.0,5,37,29,71
33217,Czechoslovakia,1988.0,3,5,8,16
33218,Czechoslovakia,1932.0,1,3,2,6
33219,Czechoslovakia,1964.0,5,37,29,71
33220,Czechoslovakia,1984.0,0,24,4,28
33221,Czechoslovakia,1936.0,5,12,1,18
33222,Czechoslovakia,1920.0,0,0,10,10
33223,Czechoslovakia,1976.0,2,23,9,34
33224,Czechoslovakia,1992.0,4,3,28,35
33225,Czechoslovakia,1984.0,0,24,4,28
33226,Czechoslovakia,1984.0,0,24,4,28
33227,Czechoslovakia,1964.0,5,37,29,71
33228,Czechoslovakia,1960.0,4,8,11,23
33229,Czechoslovakia,1948.0,14,20,3,37
33230,Czechoslovakia,1976.0,2,23,9,34
33231,Czechoslovakia,1980.0,17,18,17,52
33232,Czechoslovakia,1920.0,0,0,10,10
33233,Czechoslovakia,1980.0,17,18,17,52
33234,Czechoslovakia,1964.0,5,37,29,71
33235,Czechoslovakia,1920.0,0,0,10,10
33236,Czechoslovakia,1968.0,8,26,16,50
33237,Czechoslovakia,1972.0,3,21,25,49
33238,Czechoslovakia,1972.0,3,21,25,49
33239,Czechoslovakia,1980.0,17,18,17,52
33240,Czechoslovakia,1964.0,5,37,29,71
33241,Czechoslovakia,1984.0,0,24,4,28
33242,Czechoslovakia,1988.0,3,5,8,16
33243,Czechoslovakia,1980.0,17,18,17,52
33244,Czechoslovakia,1960.0,4,8,11,23
33245,Czechoslovakia,1964.0,5,37,29,71
33246,Czechoslovakia,1980.0,17,18,17,52
33247,Czechoslovakia,1980.0,17,18,17,52
33248,Czechoslovakia,1948.0,14,20,3,37
33249,Czechoslovakia,1980.0,17,18,17,52
33250,Czechoslovakia,1992.0,4,3,28,35
33251,Czechoslovakia,1968.0,8,26,16,50
33252,Czechoslovakia,1972.0,3,21,25,49
33253,Czechoslovakia,1976.0,2,23,9,34
33254,Czechoslovakia,1972.0,3,21,25,49
33255,Czechoslovakia,1964.0,5,37,29,71
33256,Czechoslovakia,1976.0,2,23,9,34
33257,Czechoslovakia,1924.0,1,4,5,10
33258,Czechoslovakia,1924.0,1,4,5,10
33259,Czechoslovakia,1924.0,1,4,5,10
33260,Czechoslovakia,1988.0,3,5,8,16
33261,Czechoslovakia,1968.0,8,26,16,50
33262,Czechoslovakia,1992.0,4,3,28,35
33263,Czechoslovakia,1972.0,3,21,25,49
33264,Czechoslovakia,1964.0,5,37,29,71
33265,Czechoslovakia,1932.0,1,3,2,6
33266,Czechoslovakia,1936.0,5,12,1,18
33267,Czechoslovakia,1952.0,11,4,10,25
33268,Czechoslovakia,1992.0,4,3,28,35
33269,Czechoslovakia,1980.0,17,18,17,52
33270,Czechoslovakia,1968.0,8,26,16,50
33271,Czechoslovakia,1968.0,8,26,16,50
33272,Czechoslovakia,1952.0,11,4,10,25
33273,Czechoslovakia,1984.0,0,24,4,28
33274,Czechoslovakia,1968.0,8,26,16,50
33275,Czechoslovakia-1,1992.0,4,3,28,35
33276,Czechoslovakia,1992.0,4,3,28,35
33277,Czechoslovakia,1980.0,17,18,17,52
33278,Czechoslovakia,1948.0,14,20,3,37
33279,Czechoslovakia,1984.0,0,24,4,28
33280,Czechoslovakia,1952.0,11,4,10,25
33281,Czechoslovakia,1984.0,0,24,4,28
33282,Czechoslovakia,1948.0,14,20,3,37
33283,Czechoslovakia,1948.0,14,20,3,37
33284,Czechoslovakia,1960.0,4,8,11,23
33285,Czechoslovakia,1964.0,5,37,29,71
33286,Czechoslovakia,1948.0,14,20,3,37
33287,Czechoslovakia,1980.0,17,18,17,52
33288,Czechoslovakia,1984.0,0,24,4,28
33289,Czechoslovakia,1992.0,4,3,28,35
33290,Czechoslovakia,1972.0,3,21,25,49
33291,Czechoslovakia,1992.0,4,3,28,35
33292,Czechoslovakia,1964.0,5,37,29,71
33293,Czechoslovakia,1968.0,8,26,16,50
33294,Czechoslovakia,1960.0,4,8,11,23
33295,Czechoslovakia,1964.0,5,37,29,71
33296,Czechoslovakia,1964.0,5,37,29,71
33297,Czechoslovakia,1980.0,17,18,17,52
33298,Czechoslovakia,1968.0,8,26,16,50
33299,Czechoslovakia,1972.0,3,21,25,49
33300,Czechoslovakia,1948.0,14,20,3,37
33301,Czechoslovakia-1,1992.0,4,3,28,35
33302,Czechoslovakia,1984.0,0,24,4,28
33303,Czechoslovakia,1972.0,3,21,25,49
33304,Czechoslovakia,1972.0,3,21,25,49
33305,Czechoslovakia,1968.0,8,26,16,50
33306,Czechoslovakia,1928.0,2,12,3,17
33307,Czechoslovakia,1932.0,1,3,2,6
33308,Czechoslovakia,1956.0,1,5,1,7
33309,Czechoslovakia,1980.0,17,18,17,52
33310,Czechoslovakia,1920.0,0,0,10,10
33311,Czechoslovakia,1936.0,5,12,1,18
33312,Czechoslovakia,1980.0,17,18,17,52
33313,Czechoslovakia,1948.0,14,20,3,37
33314,Czechoslovakia,1992.0,4,3,28,35
33315,Czechoslovakia,1992.0,4,3,28,35
33316,Czechoslovakia,1964.0,5,37,29,71
33317,Czechoslovakia,1964.0,5,37,29,71
33318,Czechoslovakia,1968.0,8,26,16,50
33319,Czechoslovakia,1968.0,8,26,16,50
33320,Czechoslovakia,1964.0,5,37,29,71
33321,Czechoslovakia,1948.0,14,20,3,37
33322,Czechoslovakia,1980.0,17,18,17,52
33323,Czechoslovakia,1980.0,17,18,17,52
33324,Czechoslovakia,1988.0,3,5,8,16
33325,Czechoslovakia,1948.0,14,20,3,37
33326,Czechoslovakia,1952.0,11,4,10,25
33327,Czechoslovakia,1920.0,0,0,10,10
33328,Czechoslovakia,1980.0,17,18,17,52
33329,Czechoslovakia,1976.0,2,23,9,34
33330,Czechoslovakia,1972.0,3,21,25,49
33331,Czechoslovakia,1976.0,2,23,9,34
33332,Czechoslovakia,1948.0,14,20,3,37
33333,Czechoslovakia,1948.0,14,20,3,37
33334,Czechoslovakia,1980.0,17,18,17,52
33335,Czechoslovakia,1968.0,8,26,16,50
33336,Czechoslovakia,1932.0,1,3,2,6
33337,Czechoslovakia,1988.0,3,5,8,16
33338,Czechoslovakia,1924.0,1,4,5,10
33339,Czechoslovakia,1924.0,1,4,5,10
33340,Czechoslovakia,1928.0,2,12,3,17
33341,Czechoslovakia,1972.0,3,21,25,49
33342,Czechoslovakia,1964.0,5,37,29,71
33343,Czechoslovakia,1988.0,3,5,8,16
33344,Czechoslovakia,1960.0,4,8,11,23
33345,Czechoslovakia,1960.0,4,8,11,23
33346,Czechoslovakia,1992.0,4,3,28,35
33347,Czechoslovakia,1964.0,5,37,29,71
33348,Czechoslovakia,1976.0,2,23,9,34
33349,Czechoslovakia,1980.0,17,18,17,52
33350,Czechoslovakia,1968.0,8,26,16,50
33351,Czechoslovakia,1992.0,4,3,28,35
33352,Czechoslovakia,1984.0,0,24,4,28
33353,Czechoslovakia,1984.0,0,24,4,28
33354,Czechoslovakia,1972.0,3,21,25,49
33355,Czechoslovakia,1976.0,2,23,9,34
33356,Czechoslovakia,1972.0,3,21,25,49
33357,Czechoslovakia,1976.0,2,23,9,34
33358,Czechoslovakia,1980.0,17,18,17,52
33359,Czechoslovakia,1936.0,5,12,1,18
33360,Czechoslovakia,1980.0,17,18,17,52
33361,Czechoslovakia,1972.0,3,21,25,49
33362,Czechoslovakia,1964.0,5,37,29,71
33363,Czechoslovakia,1928.0,2,12,3,17
33364,Czechoslovakia,1976.0,2,23,9,34
33365,Czechoslovakia,1960.0,4,8,11,23
33366,Czechoslovakia,1964.0,5,37,29,71
33367,Czechoslovakia,1964.0,5,37,29,71
33368,Czechoslovakia,1964.0,5,37,29,71
33369,Czechoslovakia,1948.0,14,20,3,37
33370,Czechoslovakia,1992.0,4,3,28,35
33371,Czechoslovakia,1948.0,14,20,3,37
33372,Czechoslovakia,1948.0,14,20,3,37
33373,Czechoslovakia,1964.0,5,37,29,71
33374,Czechoslovakia,1932.0,1,3,2,6
33375,Czechoslovakia,1980.0,17,18,17,52
33376,Czechoslovakia,1984.0,0,24,4,28
33377,Czechoslovakia,1924.0,1,4,5,10
33378,Czechoslovakia,1924.0,1,4,5,10
33379,Czechoslovakia,1928.0,2,12,3,17
33380,Czechoslovakia,1928.0,2,12,3,17
33381,Czechoslovakia,1928.0,2,12,3,17
33382,Czechoslovakia,1980.0,17,18,17,52
33383,Czechoslovakia,1964.0,5,37,29,71
33384,Czechoslovakia,1952.0,11,4,10,25
33385,Czechoslovakia,1988.0,3,5,8,16
33386,Czechoslovakia,1976.0,2,23,9,34
33387,Czechoslovakia,1928.0,2,12,3,17
33388,Czechoslovakia,1960.0,4,8,11,23
33389,Czechoslovakia,1964.0,5,37,29,71
33390,Czechoslovakia,1936.0,5,12,1,18
33391,Czechoslovakia,1948.0,14,20,3,37
33392,Czechoslovakia,1992.0,4,3,28,35
33393,Czechoslovakia,1928.0,2,12,3,17
33394,Czechoslovakia,1936.0,5,12,1,18
33395,Czechoslovakia,1920.0,0,0,10,10
33396,Czechoslovakia,1980.0,17,18,17,52
33397,Czechoslovakia,1964.0,5,37,29,71
33398,Czechoslovakia,1976.0,2,23,9,34
33399,Czechoslovakia,1980.0,17,18,17,52
33400,Czechoslovakia,1972.0,3,21,25,49
33401,Czechoslovakia,1964.0,5,37,29,71
33402,Czechoslovakia,1980.0,17,18,17,52
33403,Czechoslovakia,1964.0,5,37,29,71
33404,Czechoslovakia,1920.0,0,0,10,10
33405,Czechoslovakia,1964.0,5,37,29,71
33406,Czechoslovakia,1948.0,14,20,3,37
33407,Czechoslovakia,1948.0,14,20,3,37
33408,Czechoslovakia,1952.0,11,4,10,25
33409,Czechoslovakia,1968.0,8,26,16,50
33410,Czechoslovakia,1980.0,17,18,17,52
33411,Czechoslovakia,1948.0,14,20,3,37
33412,Czechoslovakia,1948.0,14,20,3,37
33413,Czechoslovakia,1952.0,11,4,10,25
33414,Czechoslovakia,1952.0,11,4,10,25
33415,Czechoslovakia,1952.0,11,4,10,25
33416,Czechoslovakia,1964.0,5,37,29,71
33417,Czechoslovakia,1988.0,3,5,8,16
33418,Czechoslovakia,1992.0,4,3,28,35
33419,Czechoslovakia,1968.0,8,26,16,50
33420,Czechoslovakia,1920.0,0,0,10,10
33421,Czechoslovakia,1992.0,4,3,28,35
33422,Czechoslovakia,1992.0,4,3,28,35
33423,Nigeria,2008.0,0,16,7,23
33424,Nigeria,2008.0,0,16,7,23
33425,Nigeria,1992.0,0,7,4,11
33426,Nigeria,1996.0,17,4,3,24
33427,Nigeria,2016.0,0,0,18,18
33428,Nigeria,2008.0,0,16,7,23
33429,Nigeria,1996.0,17,4,3,24
33430,Nigeria,2016.0,0,0,18,18
33431,Nigeria,2004.0,0,0,8,8
33432,Nigeria,2000.0,6,2,0,8
33433,Nigeria,2008.0,0,16,7,23
33434,Nigeria,1996.0,17,4,3,24
33435,Nigeria,1996.0,17,4,3,24
33436,Nigeria,2016.0,0,0,18,18
33437,Nigeria,2008.0,0,16,7,23
33438,Nigeria,2008.0,0,16,7,23
33439,Nigeria,2004.0,0,0,8,8
33440,Nigeria,2000.0,6,2,0,8
33441,Nigeria,2016.0,0,0,18,18
33442,Nigeria,1996.0,17,4,3,24
33443,Nigeria,1996.0,17,4,3,24
33444,Nigeria,2000.0,6,2,0,8
33445,Nigeria,2000.0,6,2,0,8
33446,Nigeria,2008.0,0,16,7,23
33447,Nigeria,2016.0,0,0,18,18
33448,Nigeria,1996.0,17,4,3,24
33449,Nigeria,1996.0,17,4,3,24
33450,Nigeria,2004.0,0,0,8,8
33451,Nigeria,1984.0,0,1,4,5
33452,Nigeria,2008.0,0,16,7,23
33453,Nigeria,2004.0,0,0,8,8
33454,Nigeria,2016.0,0,0,18,18
33455,Nigeria,2016.0,0,0,18,18
33456,Nigeria,2016.0,0,0,18,18
33457,Nigeria,1992.0,0,7,4,11
33458,Nigeria,1992.0,0,7,4,11
33459,Nigeria,2004.0,0,0,8,8
33460,Nigeria,1996.0,17,4,3,24
33461,Nigeria,2000.0,6,2,0,8
33462,Nigeria,1992.0,0,7,4,11
33463,Nigeria,2008.0,0,16,7,23
33464,Nigeria,1992.0,0,7,4,11
33465,Nigeria,1972.0,0,0,1,1
33466,Nigeria,1996.0,17,4,3,24
33467,Nigeria,1992.0,0,7,4,11
33468,Nigeria,2008.0,0,16,7,23
33469,Nigeria,2008.0,0,16,7,23
33470,Nigeria,1992.0,0,7,4,11
33471,Nigeria,2004.0,0,0,8,8
33472,Nigeria,2008.0,0,16,7,23
33473,Nigeria,2008.0,0,16,7,23
33474,Nigeria,1996.0,17,4,3,24
33475,Nigeria,1992.0,0,7,4,11
33476,Nigeria,2008.0,0,16,7,23
33477,Nigeria,1984.0,0,1,4,5
33478,Nigeria,1996.0,17,4,3,24
33479,Nigeria,2016.0,0,0,18,18
33480,Nigeria,1964.0,0,0,1,1
33481,Nigeria,2016.0,0,0,18,18
33482,Nigeria,2000.0,6,2,0,8
33483,Nigeria,2016.0,0,0,18,18
33484,Nigeria,1996.0,17,4,3,24
33485,Nigeria,2008.0,0,16,7,23
33486,Nigeria,2008.0,0,16,7,23
33487,Nigeria,2000.0,6,2,0,8
33488,Nigeria,2008.0,0,16,7,23
33489,Nigeria,1996.0,17,4,3,24
33490,Nigeria,1996.0,17,4,3,24
33491,Nigeria,2008.0,0,16,7,23
33492,Nigeria,1996.0,17,4,3,24
33493,Nigeria,1996.0,17,4,3,24
33494,Nigeria,2008.0,0,16,7,23
33495,Nigeria,2008.0,0,16,7,23
33496,Nigeria,1996.0,17,4,3,24
33497,Nigeria,1992.0,0,7,4,11
33498,Nigeria,1996.0,17,4,3,24
33499,Nigeria,1996.0,17,4,3,24
33500,Nigeria,1992.0,0,7,4,11
33501,Nigeria,1996.0,17,4,3,24
33502,Nigeria,1996.0,17,4,3,24
33503,Nigeria,2008.0,0,16,7,23
33504,Nigeria,2008.0,0,16,7,23
33505,Nigeria,1984.0,0,1,4,5
33506,Nigeria,2016.0,0,0,18,18
33507,Nigeria,2016.0,0,0,18,18
33508,Nigeria,2016.0,0,0,18,18
33509,Nigeria,2016.0,0,0,18,18
33510,Nigeria,2016.0,0,0,18,18
33511,Nigeria,2000.0,6,2,0,8
33512,Nigeria,2004.0,0,0,8,8
33513,Nigeria,1984.0,0,1,4,5
33514,Nigeria,2016.0,0,0,18,18
33515,Nigeria,2016.0,0,0,18,18
33516,Nigeria,1984.0,0,1,4,5
33517,Nigeria,1992.0,0,7,4,11
33518,Nigeria,2008.0,0,16,7,23
33519,Nigeria,2004.0,0,0,8,8
33520,Nigeria,1996.0,17,4,3,24
33521,Nigeria,1996.0,17,4,3,24
33522,Brazil,1984.0,1,33,2,36
33523,Brazil,1988.0,1,17,5,23
33524,Brazil,2012.0,14,34,11,59
33525,Brazil,1984.0,1,33,2,36
33526,Brazil,1996.0,5,15,43,63
33527,Brazil,2000.0,0,12,36,48
33528,Brazil,2000.0,0,12,36,48
33529,Brazil,1996.0,5,15,43,63
33530,Brazil,1996.0,5,15,43,63
33531,Brazil,2000.0,0,12,36,48
33532,Brazil,2012.0,14,34,11,59
33533,Brazil,2008.0,14,34,30,78
33534,Brazil,2012.0,14,34,11,59
33535,Brazil,1948.0,0,0,10,10
33536,Brazil,1960.0,0,0,13,13
33537,Brazil,2004.0,18,19,3,40
33538,Brazil-1,2012.0,14,34,11,59
33539,Brazil-1,2016.0,36,8,6,50
33540,Brazil,1988.0,1,17,5,23
33541,Brazil,2012.0,14,34,11,59
33542,Brazil,1996.0,5,15,43,63
33543,Brazil,1984.0,1,33,2,36
33544,Brazil,1992.0,13,1,0,14
33545,Brazil,1960.0,0,0,13,13
33546,Brazil,1964.0,0,0,12,12
33547,Brazil,1996.0,5,15,43,63
33548,Brazil,1996.0,5,15,43,63
33549,Brazil,2008.0,14,34,30,78
33550,Brazil,2004.0,18,19,3,40
33551,Brazil,2008.0,14,34,30,78
33552,Brazil,1988.0,1,17,5,23
33553,Brazil,1996.0,5,15,43,63
33554,Brazil,1984.0,1,33,2,36
33555,Brazil,2004.0,18,19,3,40
33556,Brazil,2008.0,14,34,30,78
33557,Brazil,2012.0,14,34,11,59
33558,Brazil,2016.0,36,8,6,50
33559,Brazil,1984.0,1,33,2,36
33560,Brazil-1,2016.0,36,8,6,50
33561,Brazil,2008.0,14,34,30,78
33562,Brazil,1920.0,1,1,5,7
33563,Brazil,1988.0,1,17,5,23
33564,Brazil,1988.0,1,17,5,23
33565,Brazil,1996.0,5,15,43,63
33566,Brazil-1,2016.0,36,8,6,50
33567,Brazil-1,2000.0,0,12,36,48
33568,Brazil-1,2004.0,18,19,3,40
33569,Brazil,1984.0,1,33,2,36
33570,Brazil,1984.0,1,33,2,36
33571,Brazil,1964.0,0,0,12,12
33572,Brazil,1980.0,4,0,5,9
33573,Brazil,1960.0,0,0,13,13
33574,Brazil,1960.0,0,0,13,13
33575,Brazil,1960.0,0,0,13,13
33576,Brazil,1992.0,13,1,0,14
33577,Brazil,1996.0,5,15,43,63
33578,Brazil,1996.0,5,15,43,63
33579,Brazil,2000.0,0,12,36,48
33580,Brazil,2016.0,36,8,6,50
33581,Brazil,1996.0,5,15,43,63
33582,Brazil,1948.0,0,0,10,10
33583,Brazil,2016.0,36,8,6,50
33584,Brazil,2008.0,14,34,30,78
33585,Brazil,2008.0,14,34,30,78
33586,Brazil,2012.0,14,34,11,59
33587,Brazil,2016.0,36,8,6,50
33588,Brazil,2000.0,0,12,36,48
33589,Brazil,2008.0,14,34,30,78
33590,Brazil,2004.0,18,19,3,40
33591,Brazil,1992.0,13,1,0,14
33592,Brazil,1988.0,1,17,5,23
33593,Brazil,1992.0,13,1,0,14
33594,Brazil,1984.0,1,33,2,36
33595,Brazil,2008.0,14,34,30,78
33596,Brazil,1984.0,1,33,2,36
33597,Brazil,2008.0,14,34,30,78
33598,Brazil,2008.0,14,34,30,78
33599,Brazil,2012.0,14,34,11,59
33600,Brazil,1996.0,5,15,43,63
33601,Brazil,2000.0,0,12,36,48
33602,Brazil,1996.0,5,15,43,63
33603,Brazil,2000.0,0,12,36,48
33604,Brazil,1996.0,5,15,43,63
33605,Brazil,2016.0,36,8,6,50
33606,Brazil,1968.0,0,1,3,4
33607,Brazil,1976.0,0,0,3,3
33608,Brazil,1968.0,0,1,3,4
33609,Brazil,2004.0,18,19,3,40
33610,Brazil,2008.0,14,34,30,78
33611,Brazil,1988.0,1,17,5,23
33612,Brazil,1984.0,1,33,2,36
33613,Brazil,1988.0,1,17,5,23
33614,Brazil,1984.0,1,33,2,36
33615,Brazil,1952.0,1,0,2,3
33616,Brazil,1920.0,1,1,5,7
33617,Brazil,1920.0,1,1,5,7
33618,Brazil,1948.0,0,0,10,10
33619,Brazil,1952.0,1,0,2,3
33620,Brazil,1956.0,1,0,0,1
33621,Brazil,1996.0,5,15,43,63
33622,Brazil,2000.0,0,12,36,48
33623,Brazil,1996.0,5,15,43,63
33624,Brazil,2000.0,0,12,36,48
33625,Brazil,2012.0,14,34,11,59
33626,Brazil,2016.0,36,8,6,50
33627,Brazil,2012.0,14,34,11,59
33628,Brazil,2016.0,36,8,6,50
33629,Brazil,1988.0,1,17,5,23
33630,Brazil,1996.0,5,15,43,63
33631,Brazil,2012.0,14,34,11,59
33632,Brazil,2004.0,18,19,3,40
33633,Brazil,2008.0,14,34,30,78
33634,Brazil,2012.0,14,34,11,59
33635,Brazil,2004.0,18,19,3,40
33636,Brazil,2008.0,14,34,30,78
33637,Brazil,2012.0,14,34,11,59
33638,Brazil,1984.0,1,33,2,36
33639,Brazil,1996.0,5,15,43,63
33640,Brazil,2000.0,0,12,36,48
33641,Brazil,2008.0,14,34,30,78
33642,Brazil,1948.0,0,0,10,10
33643,Brazil,2004.0,18,19,3,40
33644,Brazil,2000.0,0,12,36,48
33645,Brazil,2008.0,14,34,30,78
33646,Brazil,1976.0,0,0,3,3
33647,Brazil,1980.0,4,0,5,9
33648,Brazil,1968.0,0,1,3,4
33649,Brazil,1980.0,4,0,5,9
33650,Brazil,1948.0,0,0,10,10
33651,Brazil,1996.0,5,15,43,63
33652,Brazil,2008.0,14,34,30,78
33653,Brazil,1996.0,5,15,43,63
33654,Brazil,2000.0,0,12,36,48
33655,Brazil,1984.0,1,33,2,36
33656,Brazil,1960.0,0,0,13,13
33657,Brazil,1992.0,13,1,0,14
33658,Brazil,2016.0,36,8,6,50
33659,Brazil,1984.0,1,33,2,36
33660,Brazil,2016.0,36,8,6,50
33661,Brazil,1988.0,1,17,5,23
33662,Brazil,1960.0,0,0,13,13
33663,Brazil,1964.0,0,0,12,12
33664,Brazil,2004.0,18,19,3,40
33665,Brazil,2000.0,0,12,36,48
33666,Brazil-1,2004.0,18,19,3,40
33667,Brazil-2,2008.0,14,34,30,78
33668,Brazil-1,2012.0,14,34,11,59
33669,Brazil,2008.0,14,34,30,78
33670,Brazil,2004.0,18,19,3,40
33671,Brazil,2008.0,14,34,30,78
33672,Brazil,2012.0,14,34,11,59
33673,Brazil,2016.0,36,8,6,50
33674,Brazil,2008.0,14,34,30,78
33675,Brazil,1948.0,0,0,10,10
33676,Brazil,2008.0,14,34,30,78
33677,Brazil,2012.0,14,34,11,59
33678,Brazil,2008.0,14,34,30,78
33679,Brazil,2008.0,14,34,30,78
33680,Brazil,2012.0,14,34,11,59
33681,Brazil-1,2008.0,14,34,30,78
33682,Brazil,2008.0,14,34,30,78
33683,Brazil,1988.0,1,17,5,23
33684,Brazil,2012.0,14,34,11,59
33685,Brazil,2016.0,36,8,6,50
33686,Brazil,1996.0,5,15,43,63
33687,Brazil,1984.0,1,33,2,36
33688,Brazil,2012.0,14,34,11,59
33689,Brazil,1960.0,0,0,13,13
33690,Brazil,1996.0,5,15,43,63
33691,Brazil,2000.0,0,12,36,48
33692,Brazil,2004.0,18,19,3,40
33693,Brazil,1976.0,0,0,3,3
33694,Brazil,1996.0,5,15,43,63
33695,Brazil,2012.0,14,34,11,59
33696,Brazil,1996.0,5,15,43,63
33697,Brazil,2000.0,0,12,36,48
33698,Brazil,2008.0,14,34,30,78
33699,Brazil,2004.0,18,19,3,40
33700,Brazil,2008.0,14,34,30,78
33701,Brazil,2008.0,14,34,30,78
33702,Brazil,1988.0,1,17,5,23
33703,Brazil,1964.0,0,0,12,12
33704,Brazil,2012.0,14,34,11,59
33705,Brazil,2016.0,36,8,6,50
33706,Brazil,2016.0,36,8,6,50
33707,Brazil,1984.0,1,33,2,36
33708,Brazil,2012.0,14,34,11,59
33709,Brazil,2012.0,14,34,11,59
33710,Brazil,1948.0,0,0,10,10
33711,Brazil,1988.0,1,17,5,23
33712,Brazil,2004.0,18,19,3,40
33713,Brazil,2008.0,14,34,30,78
33714,Brazil,2012.0,14,34,11,59
33715,Brazil,1984.0,1,33,2,36
33716,Brazil,1984.0,1,33,2,36
33717,Brazil,1992.0,13,1,0,14
33718,Brazil,2004.0,18,19,3,40
33719,Brazil,1988.0,1,17,5,23
33720,Brazil,1996.0,5,15,43,63
33721,Brazil,2016.0,36,8,6,50
33722,Brazil,1984.0,1,33,2,36
33723,Brazil,1988.0,1,17,5,23
33724,Brazil,1996.0,5,15,43,63
33725,Brazil,2000.0,0,12,36,48
33726,Brazil,2004.0,18,19,3,40
33727,Brazil,2004.0,18,19,3,40
33728,Brazil,2016.0,36,8,6,50
33729,Brazil,1996.0,5,15,43,63
33730,Brazil,2004.0,18,19,3,40
33731,Brazil,2008.0,14,34,30,78
33732,Brazil,1996.0,5,15,43,63
33733,Brazil,2004.0,18,19,3,40
33734,Brazil,2008.0,14,34,30,78
33735,Brazil,2000.0,0,12,36,48
33736,Brazil,2004.0,18,19,3,40
33737,Brazil,2008.0,14,34,30,78
33738,Brazil,2008.0,14,34,30,78
33739,Brazil,1996.0,5,15,43,63
33740,Brazil,2000.0,0,12,36,48
33741,Brazil,1996.0,5,15,43,63
33742,Brazil,2012.0,14,34,11,59
33743,Brazil,2016.0,36,8,6,50
33744,Brazil,1996.0,5,15,43,63
33745,Brazil,2008.0,14,34,30,78
33746,Brazil,1972.0,0,0,2,2
33747,Brazil,1992.0,13,1,0,14
33748,Brazil,1996.0,5,15,43,63
33749,Brazil,2000.0,0,12,36,48
33750,Brazil,2000.0,0,12,36,48
33751,Brazil,2008.0,14,34,30,78
33752,Brazil,2012.0,14,34,11,59
33753,Brazil,1960.0,0,0,13,13
33754,Brazil,1964.0,0,0,12,12
33755,Brazil,2000.0,0,12,36,48
33756,Brazil,2008.0,14,34,30,78
33757,Brazil,1988.0,1,17,5,23
33758,Brazil,1996.0,5,15,43,63
33759,Brazil,2000.0,0,12,36,48
33760,Brazil,1992.0,13,1,0,14
33761,Brazil,1988.0,1,17,5,23
33762,Brazil,2012.0,14,34,11,59
33763,Brazil,2004.0,18,19,3,40
33764,Brazil-1,2012.0,14,34,11,59
33765,Brazil,1996.0,5,15,43,63
33766,Brazil,2000.0,0,12,36,48
33767,Brazil,2000.0,0,12,36,48
33768,Brazil,2000.0,0,12,36,48
33769,Brazil,2004.0,18,19,3,40
33770,Brazil,2000.0,0,12,36,48
33771,Brazil,2000.0,0,12,36,48
33772,Brazil,1984.0,1,33,2,36
33773,Brazil,2012.0,14,34,11,59
33774,Brazil,2004.0,18,19,3,40
33775,Brazil,2008.0,14,34,30,78
33776,Brazil,2016.0,36,8,6,50
33777,Brazil-1,2012.0,14,34,11,59
33778,Brazil,1996.0,5,15,43,63
33779,Brazil,1996.0,5,15,43,63
33780,Brazil,2000.0,0,12,36,48
33781,Brazil,1980.0,4,0,5,9
33782,Brazil,2000.0,0,12,36,48
33783,Brazil,2012.0,14,34,11,59
33784,Brazil,2016.0,36,8,6,50
33785,Brazil,2016.0,36,8,6,50
33786,Brazil,2016.0,36,8,6,50
33787,Brazil,2008.0,14,34,30,78
33788,Brazil,2012.0,14,34,11,59
33789,Brazil,2016.0,36,8,6,50
33790,Brazil,1996.0,5,15,43,63
33791,Brazil,1980.0,4,0,5,9
33792,Brazil,2008.0,14,34,30,78
33793,Brazil,2008.0,14,34,30,78
33794,Brazil,1996.0,5,15,43,63
33795,Brazil,2008.0,14,34,30,78
33796,Brazil,2012.0,14,34,11,59
33797,Brazil,1996.0,5,15,43,63
33798,Brazil-1,2008.0,14,34,30,78
33799,Brazil,1984.0,1,33,2,36
33800,Brazil,2008.0,14,34,30,78
33801,Brazil,2016.0,36,8,6,50
33802,Brazil,1960.0,0,0,13,13
33803,Brazil,1964.0,0,0,12,12
33804,Brazil,2012.0,14,34,11,59
33805,Brazil,2016.0,36,8,6,50
33806,Brazil,1948.0,0,0,10,10
33807,Brazil,2004.0,18,19,3,40
33808,Brazil,2008.0,14,34,30,78
33809,Brazil,1980.0,4,0,5,9
33810,Brazil,1992.0,13,1,0,14
33811,Brazil,2004.0,18,19,3,40
33812,Brazil,2008.0,14,34,30,78
33813,Brazil,2004.0,18,19,3,40
33814,Brazil,2008.0,14,34,30,78
33815,Brazil,2012.0,14,34,11,59
33816,Brazil,1988.0,1,17,5,23
33817,Brazil,1996.0,5,15,43,63
33818,Brazil,1988.0,1,17,5,23
33819,Brazil,1964.0,0,0,12,12
33820,Brazil,2004.0,18,19,3,40
33821,Brazil,1984.0,1,33,2,36
33822,Brazil,2008.0,14,34,30,78
33823,Brazil,1996.0,5,15,43,63
33824,Brazil,1960.0,0,0,13,13
33825,Brazil,1964.0,0,0,12,12
33826,Brazil,2008.0,14,34,30,78
33827,Brazil,2012.0,14,34,11,59
33828,Brazil,2004.0,18,19,3,40
33829,Brazil,1996.0,5,15,43,63
33830,Brazil,2004.0,18,19,3,40
33831,Brazil,2008.0,14,34,30,78
33832,Brazil,2012.0,14,34,11,59
33833,Brazil,1992.0,13,1,0,14
33834,Brazil,1988.0,1,17,5,23
33835,Brazil,2012.0,14,34,11,59
33836,Brazil,2012.0,14,34,11,59
33837,Brazil,2008.0,14,34,30,78
33838,Brazil,2012.0,14,34,11,59
33839,Brazil,2016.0,36,8,6,50
33840,Brazil,1952.0,1,0,2,3
33841,Brazil,2016.0,36,8,6,50
33842,Brazil,2008.0,14,34,30,78
33843,Brazil,1984.0,1,33,2,36
33844,Brazil,2012.0,14,34,11,59
33845,Brazil,1948.0,0,0,10,10
33846,Brazil,1992.0,13,1,0,14
33847,Brazil,1920.0,1,1,5,7
33848,Brazil,1920.0,1,1,5,7
33849,Brazil,1996.0,5,15,43,63
33850,Brazil,2008.0,14,34,30,78
33851,Brazil,2012.0,14,34,11,59
33852,Brazil,1992.0,13,1,0,14
33853,Brazil,1996.0,5,15,43,63
33854,Brazil,1980.0,4,0,5,9
33855,Brazil,2012.0,14,34,11,59
33856,Brazil,1996.0,5,15,43,63
33857,Brazil,2000.0,0,12,36,48
33858,Brazil,2004.0,18,19,3,40
33859,Brazil,1984.0,1,33,2,36
33860,Brazil,2008.0,14,34,30,78
33861,Brazil,2012.0,14,34,11,59
33862,Brazil,1984.0,1,33,2,36
33863,Brazil,2004.0,18,19,3,40
33864,Brazil,2008.0,14,34,30,78
33865,Brazil,1968.0,0,1,3,4
33866,Brazil,1972.0,0,0,2,2
33867,Brazil,2008.0,14,34,30,78
33868,Brazil,2016.0,36,8,6,50
33869,Brazil,2016.0,36,8,6,50
33870,Brazil,2016.0,36,8,6,50
33871,Brazil,2012.0,14,34,11,59
33872,Brazil,2008.0,14,34,30,78
33873,Brazil,2016.0,36,8,6,50
33874,Brazil,2008.0,14,34,30,78
33875,Brazil,2000.0,0,12,36,48
33876,Brazil,1984.0,1,33,2,36
33877,Brazil,2008.0,14,34,30,78
33878,Brazil,2016.0,36,8,6,50
33879,Brazil,1996.0,5,15,43,63
33880,Brazil,2000.0,0,12,36,48
33881,Brazil,2000.0,0,12,36,48
33882,Brazil,2004.0,18,19,3,40
33883,Brazil,2012.0,14,34,11,59
33884,Brazil-1,2000.0,0,12,36,48
33885,Brazil-1,2004.0,18,19,3,40
33886,Brazil-2,2008.0,14,34,30,78
33887,Brazil,1996.0,5,15,43,63
33888,Brazil,1996.0,5,15,43,63
33889,Brazil,2004.0,18,19,3,40
33890,Brazil,2008.0,14,34,30,78
33891,Brazil,2012.0,14,34,11,59
33892,Brazil,2016.0,36,8,6,50
33893,Brazil,2016.0,36,8,6,50
33894,Brazil-2,1996.0,5,15,43,63
33895,Brazil,1988.0,1,17,5,23
33896,Brazil,2012.0,14,34,11,59
33897,Brazil,1996.0,5,15,43,63
33898,Brazil,2008.0,14,34,30,78
33899,Brazil,1984.0,1,33,2,36
33900,Brazil,2008.0,14,34,30,78
33901,Brazil,1960.0,0,0,13,13
33902,Brazil,1964.0,0,0,12,12
33903,Brazil,2004.0,18,19,3,40
33904,Brazil,2008.0,14,34,30,78
33905,Brazil,1996.0,5,15,43,63
33906,Brazil,2004.0,18,19,3,40
33907,Brazil,1984.0,1,33,2,36
33908,Brazil,2012.0,14,34,11,59
33909,Brazil,2016.0,36,8,6,50
33910,Brazil,2008.0,14,34,30,78
33911,Brazil-2,1996.0,5,15,43,63
33912,Brazil-2,2000.0,0,12,36,48
33913,Brazil,1996.0,5,15,43,63
33914,Brazil-1,1996.0,5,15,43,63
33915,Brazil-2,2000.0,0,12,36,48
33916,Brazil,2012.0,14,34,11,59
33917,Brazil,1984.0,1,33,2,36
33918,Brazil,2008.0,14,34,30,78
33919,Brazil,1996.0,5,15,43,63
33920,Brazil,1996.0,5,15,43,63
33921,Brazil,2000.0,0,12,36,48
33922,Brazil,2004.0,18,19,3,40
33923,Brazil,2008.0,14,34,30,78
33924,Brazil,2012.0,14,34,11,59
33925,Brazil,1996.0,5,15,43,63
33926,Brazil,2000.0,0,12,36,48
33927,Brazil-1,2016.0,36,8,6,50
33928,Brazil,1984.0,1,33,2,36
33929,Brazil,1964.0,0,0,12,12
33930,Brazil,2008.0,14,34,30,78
33931,Brazil,2012.0,14,34,11,59
33932,Brazil-1,2000.0,0,12,36,48
33933,Brazil-1,2004.0,18,19,3,40
33934,Brazil,2012.0,14,34,11,59
33935,Brazil,2008.0,14,34,30,78
33936,Brazil,2016.0,36,8,6,50
33937,Brazil-1,1996.0,5,15,43,63
33938,Brazil,2016.0,36,8,6,50
33939,Brazil,2008.0,14,34,30,78
33940,Brazil,2012.0,14,34,11,59
33941,Brazil,2000.0,0,12,36,48
33942,Brazil,1996.0,5,15,43,63
33943,Brazil,2000.0,0,12,36,48
33944,Brazil,1984.0,1,33,2,36
33945,Brazil,1964.0,0,0,12,12
33946,Brazil,2008.0,14,34,30,78
33947,Brazil,2016.0,36,8,6,50
33948,Brazil,1980.0,4,0,5,9
33949,Brazil,2008.0,14,34,30,78
33950,Brazil,1996.0,5,15,43,63
33951,Brazil,2000.0,0,12,36,48
33952,Brazil,1920.0,1,1,5,7
33953,Brazil,1948.0,0,0,10,10
33954,Brazil,2000.0,0,12,36,48
33955,Brazil,2016.0,36,8,6,50
33956,Brazil,2016.0,36,8,6,50
33957,Brazil,1960.0,0,0,13,13
33958,Brazil,1964.0,0,0,12,12
33959,Brazil,2008.0,14,34,30,78
33960,Brazil,1988.0,1,17,5,23
33961,Brazil,1992.0,13,1,0,14
33962,Brazil,2012.0,14,34,11,59
33963,Brazil,1992.0,13,1,0,14
33964,Brazil,2004.0,18,19,3,40
33965,Brazil,2008.0,14,34,30,78
33966,Brazil,2008.0,14,34,30,78
33967,Brazil,2012.0,14,34,11,59
33968,Brazil,2016.0,36,8,6,50
33969,Brazil,1984.0,1,33,2,36
33970,Brazil,2012.0,14,34,11,59
33971,Brazil,2008.0,14,34,30,78
33972,Brazil,2008.0,14,34,30,78
33973,Brazil,1984.0,1,33,2,36
33974,Brazil,1996.0,5,15,43,63
33975,Brazil,2000.0,0,12,36,48
33976,Brazil,2016.0,36,8,6,50
33977,Brazil,2000.0,0,12,36,48
33978,Brazil,2008.0,14,34,30,78
33979,Brazil,2012.0,14,34,11,59
33980,Brazil,2016.0,36,8,6,50
33981,Brazil,1980.0,4,0,5,9
33982,Brazil,2016.0,36,8,6,50
33983,Brazil,1984.0,1,33,2,36
33984,Brazil,2016.0,36,8,6,50
33985,Brazil,1984.0,1,33,2,36
33986,Brazil,1988.0,1,17,5,23
33987,Brazil,1920.0,1,1,5,7
33988,Brazil,2016.0,36,8,6,50
33989,Brazil,1984.0,1,33,2,36
33990,Brazil,2000.0,0,12,36,48
33991,Brazil,2012.0,14,34,11,59
33992,Brazil,2016.0,36,8,6,50
33993,Brazil,1996.0,5,15,43,63
33994,Brazil-1,2000.0,0,12,36,48
33995,Brazil,1996.0,5,15,43,63
33996,Brazil,2016.0,36,8,6,50
33997,Austria,1912.0,0,9,5,14
33998,Austria,1924.0,3,4,1,8
33999,Austria,2004.0,3,4,1,8
34000,Austria,1928.0,3,4,4,11
34001,Austria-1,1992.0,9,16,10,35
34002,Austria,1988.0,4,5,4,13
34003,Austria,1968.0,3,10,7,20
34004,Austria,1936.0,7,44,9,60
34005,Austria,1948.0,3,5,8,16
34006,Austria,1906.0,3,3,3,9
34007,Austria,1924.0,3,4,1,8
34008,Austria,1936.0,7,44,9,60
34009,Austria,2002.0,3,4,13,20
34010,Austria,2006.0,16,7,7,30
34011,Austria,2014.0,4,12,11,27
34012,Austria,1936.0,7,44,9,60
34013,Austria,1924.0,3,4,1,8
34014,Austria,1928.0,3,4,4,11
34015,Austria,1912.0,0,9,5,14
34016,Austria,1992.0,9,16,10,35
34017,Austria,2002.0,3,4,13,20
34018,Austria,2006.0,16,7,7,30
34019,Austria,1936.0,7,44,9,60
34020,Austria-2,1928.0,3,4,4,11
34021,Austria,1928.0,3,4,4,11
34022,Austria,1932.0,2,2,3,7
34023,Austria,1988.0,4,5,4,13
34024,Austria,1912.0,0,9,5,14
34025,Austria,2014.0,4,12,11,27
34026,Austria,1972.0,1,3,4,8
34027,Austria,1976.0,2,2,4,8
34028,Austria,1998.0,3,5,12,20
34029,Austria,2006.0,16,7,7,30
34030,Austria,2006.0,16,7,7,30
34031,Austria,1936.0,7,44,9,60
34032,Austria,1972.0,1,3,4,8
34033,Austria,2014.0,4,12,11,27
34034,Austria-1,1964.0,5,9,3,17
34035,Austria-1,1968.0,3,10,7,20
34036,Austria,1998.0,3,5,12,20
34037,Austria,2002.0,3,4,13,20
34038,Austria,2002.0,3,4,13,20
34039,Austria,2002.0,3,4,13,20
34040,Austria,1994.0,2,3,7,12
34041,Austria-1,1968.0,3,10,7,20
34042,Austria,2010.0,11,9,6,26
34043,Austria,2014.0,4,12,11,27
34044,Austria,1936.0,7,44,9,60
34045,Austria,1924.0,3,4,1,8
34046,Austria,1980.0,4,5,4,13
34047,Austria,1936.0,7,44,9,60
34048,Austria-1,1964.0,5,9,3,17
34049,Austria,1992.0,9,16,10,35
34050,Austria,2014.0,4,12,11,27
34051,Austria,2014.0,4,12,11,27
34052,Austria,1980.0,4,5,4,13
34053,Austria,2010.0,11,9,6,26
34054,Austria,1900.0,0,3,3,6
34055,Austria,1928.0,3,4,4,11
34056,Austria-1,1980.0,4,5,4,13
34057,Austria,1956.0,5,3,8,16
34058,Austria,2016.0,0,0,2,2
34059,Austria,1924.0,3,4,1,8
34060,Austria,1992.0,9,16,10,35
34061,Austria,1936.0,7,44,9,60
34062,Austria,1948.0,3,5,8,16
34063,Austria,1998.0,3,5,12,20
34064,Austria,2004.0,3,4,1,8
34065,Austria,1994.0,2,3,7,12
34066,Austria,1994.0,2,3,7,12
34067,Austria,1912.0,0,9,5,14
34068,Austria,2010.0,11,9,6,26
34069,Austria,2010.0,11,9,6,26
34070,Austria,2002.0,3,4,13,20
34071,Austria,2002.0,3,4,13,20
34072,Austria,2002.0,3,4,13,20
34073,Austria,2002.0,3,4,13,20
34074,Austria,2002.0,3,4,13,20
34075,Austria,2006.0,16,7,7,30
34076,Austria,2006.0,16,7,7,30
34077,Austria,2006.0,16,7,7,30
34078,Austria,2010.0,11,9,6,26
34079,Austria,2006.0,16,7,7,30
34080,Austria,2000.0,3,1,0,4
34081,Austria,1928.0,3,4,4,11
34082,Austria,1948.0,3,5,8,16
34083,Austria,2010.0,11,9,6,26
34084,Austria,2010.0,11,9,6,26
34085,Austria,2014.0,4,12,11,27
34086,Austria-1,1968.0,3,10,7,20
34087,Austria,2002.0,3,4,13,20
34088,Austria,2006.0,16,7,7,30
34089,Austria,1988.0,4,5,4,13
34090,Austria,1972.0,1,3,4,8
34091,Austria,1964.0,5,9,3,17
34092,Austria,1968.0,3,10,7,20
34093,Austria,1928.0,3,4,4,11
34094,Austria,1932.0,2,2,3,7
34095,Austria,1988.0,4,5,4,13
34096,Austria,1988.0,4,5,4,13
34097,Austria,2000.0,3,1,0,4
34098,Austria,2004.0,3,4,1,8
34099,Austria-1,1992.0,9,16,10,35
34100,Austria,1960.0,2,4,3,9
34101,Austria,1948.0,3,5,8,16
34102,Austria,1936.0,7,44,9,60
34103,Austria,2014.0,4,12,11,27
34104,Austria,1960.0,2,4,3,9
34105,Austria,1964.0,5,9,3,17
34106,Austria,2004.0,3,4,1,8
34107,Austria,1964.0,5,9,3,17
34108,Austria,2006.0,16,7,7,30
34109,Austria,1896.0,2,1,2,5
34110,Austria,1912.0,0,9,5,14
34111,Austria,1960.0,2,4,3,9
34112,Austria,1960.0,2,4,3,9
34113,Austria,1932.0,2,2,3,7
34114,Austria,2014.0,4,12,11,27
34115,Austria,1932.0,2,2,3,7
34116,Austria,1932.0,2,2,3,7
34117,Austria,1948.0,3,5,8,16
34118,Austria,1956.0,5,3,8,16
34119,Austria,1998.0,3,5,12,20
34120,Austria,2002.0,3,4,13,20
34121,Austria,1936.0,7,44,9,60
34122,Austria,1992.0,9,16,10,35
34123,Austria,1992.0,9,16,10,35
34124,Austria,1992.0,9,16,10,35
34125,Austria,1998.0,3,5,12,20
34126,Austria,1994.0,2,3,7,12
34127,Austria,1998.0,3,5,12,20
34128,Austria,2006.0,16,7,7,30
34129,Austria,2014.0,4,12,11,27
34130,Austria,2014.0,4,12,11,27
34131,Austria,1936.0,7,44,9,60
34132,Austria,1936.0,7,44,9,60
34133,Austria,1936.0,7,44,9,60
34134,Austria,1968.0,3,10,7,20
34135,Austria,1976.0,2,2,4,8
34136,Austria,1980.0,4,5,4,13
34137,Austria,2014.0,4,12,11,27
34138,Austria,1968.0,3,10,7,20
34139,Austria,1948.0,3,5,8,16
34140,Austria,1948.0,3,5,8,16
34141,Austria,1952.0,2,5,4,11
34142,Austria,1992.0,9,16,10,35
34143,Austria,2008.0,0,1,2,3
34144,Austria,1936.0,7,44,9,60
34145,Austria,1936.0,7,44,9,60
34146,Austria,1936.0,7,44,9,60
34147,Austria,1936.0,7,44,9,60
34148,Austria-1,1928.0,3,4,4,11
34149,Austria,1936.0,7,44,9,60
34150,Austria,1936.0,7,44,9,60
34151,Austria,2010.0,11,9,6,26
34152,Austria,2014.0,4,12,11,27
34153,Austria,1936.0,7,44,9,60
34154,Austria,1936.0,7,44,9,60
34155,Austria,1936.0,7,44,9,60
34156,Austria,1996.0,0,1,2,3
34157,Austria,1936.0,7,44,9,60
34158,Austria,1976.0,2,2,4,8
34159,Austria,2014.0,4,12,11,27
34160,Austria,1956.0,5,3,8,16
34161,Austria,1960.0,2,4,3,9
34162,Austria,1998.0,3,5,12,20
34163,Austria,2006.0,16,7,7,30
34164,Austria,1998.0,3,5,12,20
34165,Austria,2006.0,16,7,7,30
34166,Austria,2006.0,16,7,7,30
34167,Austria,2010.0,11,9,6,26
34168,Austria-1,1964.0,5,9,3,17
34169,Austria,2010.0,11,9,6,26
34170,Austria,2010.0,11,9,6,26
34171,Austria,1992.0,9,16,10,35
34172,Austria,1936.0,7,44,9,60
34173,Austria,1936.0,7,44,9,60
34174,Austria,1992.0,9,16,10,35
34175,Austria,1992.0,9,16,10,35
34176,Austria,1984.0,1,1,2,4
34177,Austria,1936.0,7,44,9,60
34178,Austria,1936.0,7,44,9,60
34179,Austria,1992.0,9,16,10,35
34180,Austria,1992.0,9,16,10,35
34181,Austria,1994.0,2,3,7,12
34182,Austria,2010.0,11,9,6,26
34183,Austria,2014.0,4,12,11,27
34184,Austria,2014.0,4,12,11,27
34185,Austria,1936.0,7,44,9,60
34186,Austria,1936.0,7,44,9,60
34187,Austria,1960.0,2,4,3,9
34188,Austria,1904.0,2,1,1,4
34189,Austria,1904.0,2,1,1,4
34190,"Philadelphia Turngemeinde, Philadelphia",1904.0,2,1,1,4
34191,Austria,1960.0,2,4,3,9
34192,Austria,1936.0,7,44,9,60
34193,Austria,1952.0,2,5,4,11
34194,Austria,1906.0,3,3,3,9
34195,Austria-1,2006.0,16,7,7,30
34196,Austria-1,2010.0,11,9,6,26
34197,Austria-1,2014.0,4,12,11,27
34198,Austria-1,2006.0,16,7,7,30
34199,Austria-1,2010.0,11,9,6,26
34200,Austria-1,2014.0,4,12,11,27
34201,Austria,2010.0,11,9,6,26
34202,Austria,1928.0,3,4,4,11
34203,Austria,1992.0,9,16,10,35
34204,Austria,1948.0,3,5,8,16
34205,Austria,1948.0,3,5,8,16
34206,Austria,1998.0,3,5,12,20
34207,Austria,1998.0,3,5,12,20
34208,Austria,2006.0,16,7,7,30
34209,Austria,2006.0,16,7,7,30
34210,Austria,1936.0,7,44,9,60
34211,Austria,1968.0,3,10,7,20
34212,Austria,2010.0,11,9,6,26
34213,Austria,2014.0,4,12,11,27
34214,Austria,1936.0,7,44,9,60
34215,Austria,1980.0,4,5,4,13
34216,Austria,1994.0,2,3,7,12
34217,Austria,1998.0,3,5,12,20
34218,Austria,1988.0,4,5,4,13
34219,Austria,2014.0,4,12,11,27
34220,Austria,1980.0,4,5,4,13
34221,Austria,1998.0,3,5,12,20
34222,Austria,1998.0,3,5,12,20
34223,Austria,2006.0,16,7,7,30
34224,Austria,2010.0,11,9,6,26
34225,Austria,2014.0,4,12,11,27
34226,Austria,1968.0,3,10,7,20
34227,Austria,1972.0,1,3,4,8
34228,Austria,1912.0,0,9,5,14
34229,Austria,1956.0,5,3,8,16
34230,Austria,1956.0,5,3,8,16
34231,Austria,2006.0,16,7,7,30
34232,Austria,2006.0,16,7,7,30
34233,Austria,2010.0,11,9,6,26
34234,Austria,2014.0,4,12,11,27
34235,Austria,1994.0,2,3,7,12
34236,Austria,1972.0,1,3,4,8
34237,Austria,1972.0,1,3,4,8
34238,Austria,1980.0,4,5,4,13
34239,Austria,1932.0,2,2,3,7
34240,Austria,1936.0,7,44,9,60
34241,Austria,1948.0,3,5,8,16
34242,Austria,1992.0,9,16,10,35
34243,Austria-1,1964.0,5,9,3,17
34244,Austria,1992.0,9,16,10,35
34245,Austria,1994.0,2,3,7,12
34246,Austria,1994.0,2,3,7,12
34247,Austria,1900.0,0,3,3,6
34248,Austria,1896.0,2,1,2,5
34249,Austria,1992.0,9,16,10,35
34250,Austria,1998.0,3,5,12,20
34251,Austria,1992.0,9,16,10,35
34252,Austria,1980.0,4,5,4,13
34253,Austria,2008.0,0,1,2,3
34254,Austria,1992.0,9,16,10,35
34255,Austria-1,1956.0,5,3,8,16
34256,Austria,1992.0,9,16,10,35
34257,Austria,2008.0,0,1,2,3
34258,Austria,1968.0,3,10,7,20
34259,Austria-1,1936.0,7,44,9,60
34260,Austria-1,1936.0,7,44,9,60
34261,Austria,1948.0,3,5,8,16
34262,Austria,2002.0,3,4,13,20
34263,Austria,1936.0,7,44,9,60
34264,Austria,1980.0,4,5,4,13
34265,Austria,1968.0,3,10,7,20
34266,Austria,1912.0,0,9,5,14
34267,Austria,1924.0,3,4,1,8
34268,Austria,2004.0,3,4,1,8
34269,Austria,1936.0,7,44,9,60
34270,Austria,1936.0,7,44,9,60
34271,Austria,1952.0,2,5,4,11
34272,Austria,1952.0,2,5,4,11
34273,Austria,1968.0,3,10,7,20
34274,Austria,1992.0,9,16,10,35
34275,Austria,1994.0,2,3,7,12
34276,Austria,2002.0,3,4,13,20
34277,Austria,1936.0,7,44,9,60
34278,Austria,1936.0,7,44,9,60
34279,Austria,1936.0,7,44,9,60
34280,Austria,1948.0,3,5,8,16
34281,Austria,2002.0,3,4,13,20
34282,Austria,2002.0,3,4,13,20
34283,Austria,2006.0,16,7,7,30
34284,Austria,2006.0,16,7,7,30
34285,Austria,1952.0,2,5,4,11
34286,Austria,1956.0,5,3,8,16
34287,Austria,1968.0,3,10,7,20
34288,Austria,1980.0,4,5,4,13
34289,Austria,1936.0,7,44,9,60
34290,Austria,1998.0,3,5,12,20
34291,Austria,1984.0,1,1,2,4
34292,Austria,2010.0,11,9,6,26
34293,Austria,2002.0,3,4,13,20
34294,Austria,1948.0,3,5,8,16
34295,Austria,2004.0,3,4,1,8
34296,Austria,2004.0,3,4,1,8
34297,Austria,1952.0,2,5,4,11
34298,Austria,1900.0,0,3,3,6
34299,Austria,1900.0,0,3,3,6
34300,Austria,1956.0,5,3,8,16
34301,Austria,1960.0,2,4,3,9
34302,Austria,1956.0,5,3,8,16
34303,Austria,1956.0,5,3,8,16
34304,Austria,1956.0,5,3,8,16
34305,Austria,1972.0,1,3,4,8
34306,Austria,1906.0,3,3,3,9
34307,Austria-1,1976.0,2,2,4,8
34308,Austria,1932.0,2,2,3,7
34309,Austria,1936.0,7,44,9,60
34310,Austria,1948.0,3,5,8,16
34311,Austria,1906.0,3,3,3,9
34312,Austria,1906.0,3,3,3,9
34313,Austria,1908.0,0,0,1,1
34314,Austria,2002.0,3,4,13,20
34315,Austria,2006.0,16,7,7,30
34316,Austria,2006.0,16,7,7,30
34317,Austria,2010.0,11,9,6,26
34318,Austria,2014.0,4,12,11,27
34319,Austria,2010.0,11,9,6,26
34320,Austria,2010.0,11,9,6,26
34321,Austria,2010.0,11,9,6,26
34322,Austria,2014.0,4,12,11,27
34323,Austria,1896.0,2,1,2,5
34324,Austria,1896.0,2,1,2,5
34325,Austria,1896.0,2,1,2,5
34326,Austria,1936.0,7,44,9,60
34327,Austria,1968.0,3,10,7,20
34328,Austria-1,1968.0,3,10,7,20
34329,Austria-1,1976.0,2,2,4,8
34330,Austria,1992.0,9,16,10,35
34331,Austria,1936.0,7,44,9,60
34332,Austria,1976.0,2,2,4,8
34333,Austria,1976.0,2,2,4,8
34334,Austria,1952.0,2,5,4,11
34335,Austria,1952.0,2,5,4,11
34336,Austria-1,1928.0,3,4,4,11
34337,Austria,2006.0,16,7,7,30
34338,Austria,2006.0,16,7,7,30
34339,Austria,1956.0,5,3,8,16
34340,Austria,1964.0,5,9,3,17
34341,Austria-1,1992.0,9,16,10,35
34342,Austria-1,1980.0,4,5,4,13
34343,Austria,1972.0,1,3,4,8
34344,Austria,1936.0,7,44,9,60
34345,Austria,1956.0,5,3,8,16
34346,Austria-1,1956.0,5,3,8,16
34347,Austria,1968.0,3,10,7,20
34348,Austria,1998.0,3,5,12,20
34349,Austria,1948.0,3,5,8,16
34350,Austria,1968.0,3,10,7,20
34351,Austria,1952.0,2,5,4,11
34352,Austria,1984.0,1,1,2,4
34353,Austria,1988.0,4,5,4,13
34354,Austria-2,1964.0,5,9,3,17
34355,Austria,2000.0,3,1,0,4
34356,Austria,1992.0,9,16,10,35
34357,Austria,1952.0,2,5,4,11
34358,Austria,1924.0,3,4,1,8
34359,Austria,1994.0,2,3,7,12
34360,Austria,2002.0,3,4,13,20
34361,Austria,2006.0,16,7,7,30
34362,Austria,2010.0,11,9,6,26
34363,Austria,2014.0,4,12,11,27
34364,Austria,2000.0,3,1,0,4
34365,Austria,2004.0,3,4,1,8
34366,Austria,1906.0,3,3,3,9
34367,Austria,1906.0,3,3,3,9
34368,Austria,1984.0,1,1,2,4
34369,Austria,1936.0,7,44,9,60
34370,Austria,1936.0,7,44,9,60
34371,Austria-1,1964.0,5,9,3,17
34372,Austria,1912.0,0,9,5,14
34373,Austria,1936.0,7,44,9,60
34374,Austria,1960.0,2,4,3,9
34375,Austria,1964.0,5,9,3,17
34376,Austria,1964.0,5,9,3,17
34377,Austria,1936.0,7,44,9,60
34378,Austria,1980.0,4,5,4,13
34379,Austria,1936.0,7,44,9,60
34380,Austria,2002.0,3,4,13,20
34381,Austria,1988.0,4,5,4,13
34382,Austria,1988.0,4,5,4,13
34383,Austria,1988.0,4,5,4,13
34384,Austria,1988.0,4,5,4,13
34385,Austria,1992.0,9,16,10,35
34386,Austria,1992.0,9,16,10,35
34387,Austria,2010.0,11,9,6,26
34388,Austria,2010.0,11,9,6,26
34389,Austria,2014.0,4,12,11,27
34390,Austria,1912.0,0,9,5,14
34391,Austria,1998.0,3,5,12,20
34392,Austria,1968.0,3,10,7,20
34393,Austria,1994.0,2,3,7,12
34394,Austria,1936.0,7,44,9,60
34395,Austria-1,1964.0,5,9,3,17
34396,Austria-1,1968.0,3,10,7,20
34397,Austria-2,1964.0,5,9,3,17
34398,Austria,1948.0,3,5,8,16
34399,Austria,1964.0,5,9,3,17
34400,Austria,1976.0,2,2,4,8
34401,Austria,1912.0,0,9,5,14
34402,Austria,1998.0,3,5,12,20
34403,Austria,1992.0,9,16,10,35
34404,Austria,1912.0,0,9,5,14
34405,Austria,1912.0,0,9,5,14
34406,Austria,1992.0,9,16,10,35
34407,Austria,1992.0,9,16,10,35
34408,Austria,1936.0,7,44,9,60
34409,Austria,1988.0,4,5,4,13
34410,Austria,1992.0,9,16,10,35
34411,Austria,1992.0,9,16,10,35
34412,Austria,1900.0,0,3,3,6
34413,Austria,1900.0,0,3,3,6
34414,Austria,1904.0,2,1,1,4
34415,Austria,1936.0,7,44,9,60
34416,Austria,1996.0,0,1,2,3
34417,Austria,1996.0,0,1,2,3
34418,Austria-1,1968.0,3,10,7,20
34419,Austria,2006.0,16,7,7,30
34420,Austria,1992.0,9,16,10,35
34421,Austria,1906.0,3,3,3,9
34422,Austria,1906.0,3,3,3,9
34423,Austria,1936.0,7,44,9,60
34424,Austria,1936.0,7,44,9,60
34425,Austria,1956.0,5,3,8,16
34426,Austria,1936.0,7,44,9,60
34427,Austria,1998.0,3,5,12,20
34428,Austria,1998.0,3,5,12,20
34429,Austria,2006.0,16,7,7,30
34430,Austria,1952.0,2,5,4,11
34431,Austria,1956.0,5,3,8,16
34432,Austria-1,1992.0,9,16,10,35
34433,Austria,1980.0,4,5,4,13
34434,Austria,1936.0,7,44,9,60
34435,Austria,1988.0,4,5,4,13
34436,Austria-2,1928.0,3,4,4,11
34437,Austria,1936.0,7,44,9,60
34438,Austria,1912.0,0,9,5,14
34439,Austria,2016.0,0,0,2,2
34440,Austria,1912.0,0,9,5,14
34441,Austria,1936.0,7,44,9,60
34442,Austria,1992.0,9,16,10,35
34443,Austria,2014.0,4,12,11,27
34444,Austria,1964.0,5,9,3,17
34445,Austria,1964.0,5,9,3,17
34446,Austria,1924.0,3,4,1,8
34447,Lithuania,2000.0,2,0,15,17
34448,Lithuania,2000.0,2,0,15,17
34449,Lithuania,2004.0,1,2,0,3
34450,Lithuania,2008.0,0,2,3,5
34451,Lithuania,2012.0,2,1,2,5
34452,Lithuania,1992.0,1,0,12,13
34453,Lithuania,1992.0,1,0,12,13
34454,Lithuania,2016.0,0,2,5,7
34455,Lithuania,1992.0,1,0,12,13
34456,Lithuania,1992.0,1,0,12,13
34457,Lithuania,1996.0,0,0,11,11
34458,Lithuania,2000.0,2,0,15,17
34459,Lithuania,2000.0,2,0,15,17
34460,Lithuania,2016.0,0,2,5,7
34461,Lithuania,2000.0,2,0,15,17
34462,Lithuania,2000.0,2,0,15,17
34463,Lithuania,1992.0,1,0,12,13
34464,Lithuania,1992.0,1,0,12,13
34465,Lithuania,1996.0,0,0,11,11
34466,Lithuania,2012.0,2,1,2,5
34467,Lithuania,1992.0,1,0,12,13
34468,Lithuania,2008.0,0,2,3,5
34469,Lithuania,1992.0,1,0,12,13
34470,Lithuania,1996.0,0,0,11,11
34471,Lithuania,2016.0,0,2,5,7
34472,Lithuania,1996.0,0,0,11,11
34473,Lithuania,2000.0,2,0,15,17
34474,Lithuania,1992.0,1,0,12,13
34475,Lithuania,1996.0,0,0,11,11
34476,Lithuania,2000.0,2,0,15,17
34477,Lithuania,2000.0,2,0,15,17
34478,Lithuania,2012.0,2,1,2,5
34479,Lithuania,2008.0,0,2,3,5
34480,Lithuania,1996.0,0,0,11,11
34481,Lithuania,1992.0,1,0,12,13
34482,Lithuania,2012.0,2,1,2,5
34483,Lithuania,2000.0,2,0,15,17
34484,Lithuania,2016.0,0,2,5,7
34485,Lithuania,2016.0,0,2,5,7
34486,Lithuania,1992.0,1,0,12,13
34487,Lithuania,1996.0,0,0,11,11
34488,Lithuania,2000.0,2,0,15,17
34489,Lithuania,2000.0,2,0,15,17
34490,Lithuania,2004.0,1,2,0,3
34491,Lithuania,2000.0,2,0,15,17
34492,Lithuania,1996.0,0,0,11,11
34493,Lithuania,2000.0,2,0,15,17
34494,Lithuania,2012.0,2,1,2,5
34495,Lithuania,2000.0,2,0,15,17
34496,Lithuania,1992.0,1,0,12,13
34497,Lithuania,1996.0,0,0,11,11
34498,Lithuania,2016.0,0,2,5,7
34499,Lithuania,1992.0,1,0,12,13
34500,Lithuania,2016.0,0,2,5,7
34501,Lithuania,2008.0,0,2,3,5
34502,Lithuania,2004.0,1,2,0,3
34503,Lithuania,2008.0,0,2,3,5
34504,Lithuania,2000.0,2,0,15,17
34505,Lithuania,1996.0,0,0,11,11
34506,Lithuania,2000.0,2,0,15,17
34507,Lithuania,1996.0,0,0,11,11
34508,Indonesia,2016.0,2,2,0,4
34509,Indonesia-1,2016.0,2,2,0,4
34510,Indonesia-1,1996.0,2,1,3,6
34511,Indonesia,1992.0,2,3,1,6
34512,Indonesia-1,2004.0,1,1,3,5
34513,Indonesia-1,1992.0,2,3,1,6
34514,Indonesia,2000.0,2,4,2,8
34515,Indonesia,1988.0,0,3,0,3
34516,Indonesia-1,1992.0,2,3,1,6
34517,Indonesia-1,2000.0,2,4,2,8
34518,Indonesia,2000.0,2,4,2,8
34519,Indonesia,2004.0,1,1,3,5
34520,Indonesia,2000.0,2,4,2,8
34521,Indonesia,2008.0,2,2,3,7
34522,Indonesia,2012.0,0,1,1,2
34523,Indonesia,2016.0,2,2,0,4
34524,Indonesia-1,1996.0,2,1,3,6
34525,Indonesia-1,2008.0,2,2,3,7
34526,Indonesia,2004.0,1,1,3,5
34527,Indonesia-1,2004.0,1,1,3,5
34528,Indonesia,1996.0,2,1,3,6
34529,Indonesia,1996.0,2,1,3,6
34530,Indonesia-1,2008.0,2,2,3,7
34531,Indonesia-1,2016.0,2,2,0,4
34532,Indonesia,2000.0,2,4,2,8
34533,Indonesia,2004.0,1,1,3,5
34534,Indonesia,1988.0,0,3,0,3
34535,Indonesia-1,2008.0,2,2,3,7
34536,Indonesia,2000.0,2,4,2,8
34537,Indonesia,1996.0,2,1,3,6
34538,Indonesia,1992.0,2,3,1,6
34539,Indonesia,1996.0,2,1,3,6
34540,Indonesia,1992.0,2,3,1,6
34541,Indonesia-1,2000.0,2,4,2,8
34542,Indonesia,2008.0,2,2,3,7
34543,Indonesia,2012.0,0,1,1,2
34544,Indonesia,1988.0,0,3,0,3
34545,Indonesia-1,2008.0,2,2,3,7
34546,Indonesia,2000.0,2,4,2,8
34547,Indonesia,1992.0,2,3,1,6
34548,Indonesia,2008.0,2,2,3,7
34549,Chile,1956.0,0,2,2,4
34550,Chile,2000.0,0,0,17,17
34551,Chile,2000.0,0,0,17,17
34552,Chile,1956.0,0,2,2,4
34553,Chile,2000.0,0,0,17,17
34554,Chile,1952.0,0,4,0,4
34555,Chile,1952.0,0,4,0,4
34556,Chile,1988.0,0,1,0,1
34557,Chile,1952.0,0,4,0,4
34558,Chile,2004.0,3,0,1,4
34559,Chile,2004.0,3,0,1,4
34560,Chile,2008.0,0,1,0,1
34561,Chile,2000.0,0,0,17,17
34562,Chile,2000.0,0,0,17,17
34563,Chile,2000.0,0,0,17,17
34564,Chile,1956.0,0,2,2,4
34565,Chile,2000.0,0,0,17,17
34566,Chile,2004.0,3,0,1,4
34567,Chile,2004.0,3,0,1,4
34568,Chile,1952.0,0,4,0,4
34569,Chile,2000.0,0,0,17,17
34570,Chile,2000.0,0,0,17,17
34571,Chile,2000.0,0,0,17,17
34572,Chile,2000.0,0,0,17,17
34573,Chile,2000.0,0,0,17,17
34574,Chile,1928.0,0,1,0,1
34575,Chile,2000.0,0,0,17,17
34576,Chile,2000.0,0,0,17,17
34577,Chile,2000.0,0,0,17,17
34578,Chile,1956.0,0,2,2,4
34579,Chile,2000.0,0,0,17,17
34580,Chile,2000.0,0,0,17,17
34581,Ukraine,2008.0,10,5,16,31
34582,Ukraine,2012.0,9,5,12,26
34583,Ukraine,2008.0,10,5,16,31
34584,Ukraine,1996.0,10,5,19,34
34585,Ukraine,1996.0,10,5,19,34
34586,Ukraine,1994.0,1,0,1,2
34587,Ukraine,2004.0,8,8,31,47
34588,Ukraine,2016.0,2,8,5,15
34589,Ukraine,2000.0,3,20,12,35
34590,Ukraine,2000.0,3,20,12,35
34591,Ukraine,2012.0,9,5,12,26
34592,Ukraine,2004.0,8,8,31,47
34593,Ukraine,2008.0,10,5,16,31
34594,Ukraine,2004.0,8,8,31,47
34595,Ukraine,2016.0,2,8,5,15
34596,Ukraine,2004.0,8,8,31,47
34597,Ukraine,2004.0,8,8,31,47
34598,Ukraine,1996.0,10,5,19,34
34599,Ukraine,2012.0,9,5,12,26
34600,Ukraine,2000.0,3,20,12,35
34601,Ukraine,2004.0,8,8,31,47
34602,Ukraine,2000.0,3,20,12,35
34603,Ukraine,2008.0,10,5,16,31
34604,Ukraine,2012.0,9,5,12,26
34605,Ukraine,2016.0,2,8,5,15
34606,Ukraine,2004.0,8,8,31,47
34607,Ukraine,2000.0,3,20,12,35
34608,Ukraine,2008.0,10,5,16,31
34609,Ukraine,2000.0,3,20,12,35
34610,Ukraine,2008.0,10,5,16,31
34611,Ukraine,2012.0,9,5,12,26
34612,Ukraine,2008.0,10,5,16,31
34613,Ukraine,2000.0,3,20,12,35
34614,Ukraine,2012.0,9,5,12,26
34615,Ukraine,2014.0,4,0,1,5
34616,Ukraine,2000.0,3,20,12,35
34617,Ukraine,2000.0,3,20,12,35
34618,Ukraine,2008.0,10,5,16,31
34619,Ukraine,1996.0,10,5,19,34
34620,Ukraine,2008.0,10,5,16,31
34621,Ukraine-1,2006.0,0,0,3,3
34622,Ukraine,2000.0,3,20,12,35
34623,Ukraine,2004.0,8,8,31,47
34624,Ukraine,2004.0,8,8,31,47
34625,Ukraine,2004.0,8,8,31,47
34626,Ukraine,2008.0,10,5,16,31
34627,Ukraine,1996.0,10,5,19,34
34628,Ukraine,2000.0,3,20,12,35
34629,Ukraine,2004.0,8,8,31,47
34630,Ukraine-1,2006.0,0,0,3,3
34631,Ukraine,2004.0,8,8,31,47
34632,Ukraine,2012.0,9,5,12,26
34633,Ukraine,1996.0,10,5,19,34
34634,Ukraine,2012.0,9,5,12,26
34635,Ukraine,2004.0,8,8,31,47
34636,Ukraine,2008.0,10,5,16,31
34637,Ukraine,2008.0,10,5,16,31
34638,Ukraine,2012.0,9,5,12,26
34639,Ukraine,2016.0,2,8,5,15
34640,Ukraine,2016.0,2,8,5,15
34641,Ukraine,2008.0,10,5,16,31
34642,Ukraine,1996.0,10,5,19,34
34643,Ukraine,1996.0,10,5,19,34
34644,Ukraine,2000.0,3,20,12,35
34645,Ukraine,2000.0,3,20,12,35
34646,Ukraine,2000.0,3,20,12,35
34647,Ukraine,2004.0,8,8,31,47
34648,Ukraine,2004.0,8,8,31,47
34649,Ukraine,2016.0,2,8,5,15
34650,Ukraine,1996.0,10,5,19,34
34651,Ukraine,2008.0,10,5,16,31
34652,Ukraine,1996.0,10,5,19,34
34653,Ukraine,2004.0,8,8,31,47
34654,Ukraine,2012.0,9,5,12,26
34655,Ukraine,2012.0,9,5,12,26
34656,Ukraine,2000.0,3,20,12,35
34657,Ukraine,2012.0,9,5,12,26
34658,Ukraine,2016.0,2,8,5,15
34659,Ukraine,1996.0,10,5,19,34
34660,Ukraine,1996.0,10,5,19,34
34661,Ukraine,2016.0,2,8,5,15
34662,Ukraine,2008.0,10,5,16,31
34663,Ukraine,2004.0,8,8,31,47
34664,Ukraine,2004.0,8,8,31,47
34665,Ukraine,2008.0,10,5,16,31
34666,Ukraine,2008.0,10,5,16,31
34667,Ukraine,2012.0,9,5,12,26
34668,Ukraine,2004.0,8,8,31,47
34669,Ukraine,2004.0,8,8,31,47
34670,Ukraine,2004.0,8,8,31,47
34671,Ukraine,2000.0,3,20,12,35
34672,Ukraine,2004.0,8,8,31,47
34673,Ukraine,2000.0,3,20,12,35
34674,Ukraine,1996.0,10,5,19,34
34675,Ukraine,1996.0,10,5,19,34
34676,Ukraine,2004.0,8,8,31,47
34677,Ukraine,2008.0,10,5,16,31
34678,Ukraine,2000.0,3,20,12,35
34679,Ukraine,1996.0,10,5,19,34
34680,Ukraine,2000.0,3,20,12,35
34681,Ukraine,2016.0,2,8,5,15
34682,Ukraine,1996.0,10,5,19,34
34683,Ukraine,2004.0,8,8,31,47
34684,Ukraine,1996.0,10,5,19,34
34685,Ukraine,2004.0,8,8,31,47
34686,Ukraine,2008.0,10,5,16,31
34687,Ukraine,2012.0,9,5,12,26
34688,Ukraine,2012.0,9,5,12,26
34689,Ukraine,2004.0,8,8,31,47
34690,Ukraine,1996.0,10,5,19,34
34691,Ukraine,2000.0,3,20,12,35
34692,Ukraine,2000.0,3,20,12,35
34693,Ukraine,2008.0,10,5,16,31
34694,Ukraine,1998.0,0,1,0,1
34695,Ukraine,2012.0,9,5,12,26
34696,Ukraine,2014.0,4,0,1,5
34697,Ukraine,1996.0,10,5,19,34
34698,Ukraine,1996.0,10,5,19,34
34699,Ukraine,1996.0,10,5,19,34
34700,Ukraine,2012.0,9,5,12,26
34701,Ukraine,2008.0,10,5,16,31
34702,Ukraine,2008.0,10,5,16,31
34703,Ukraine,2004.0,8,8,31,47
34704,Ukraine,2012.0,9,5,12,26
34705,Ukraine,2004.0,8,8,31,47
34706,Ukraine,2004.0,8,8,31,47
34707,Ukraine,2012.0,9,5,12,26
34708,Ukraine,2016.0,2,8,5,15
34709,Ukraine,1996.0,10,5,19,34
34710,Ukraine,2004.0,8,8,31,47
34711,Ukraine,2008.0,10,5,16,31
34712,Ukraine,1996.0,10,5,19,34
34713,Ukraine,2000.0,3,20,12,35
34714,Ukraine,2012.0,9,5,12,26
34715,Ukraine,2000.0,3,20,12,35
34716,Ukraine,2014.0,4,0,1,5
34717,Ukraine,2014.0,4,0,1,5
34718,Ukraine,2014.0,4,0,1,5
34719,Ukraine,2004.0,8,8,31,47
34720,Ukraine,2000.0,3,20,12,35
34721,Ukraine,2004.0,8,8,31,47
34722,Ukraine,1996.0,10,5,19,34
34723,Ukraine,1996.0,10,5,19,34
34724,Ukraine,2004.0,8,8,31,47
34725,Ukraine,1996.0,10,5,19,34
34726,Ukraine,1996.0,10,5,19,34
34727,Ukraine,2000.0,3,20,12,35
34728,Ukraine,2012.0,9,5,12,26
34729,Ukraine,2012.0,9,5,12,26
34730,Ukraine,2004.0,8,8,31,47
34731,Ukraine,2004.0,8,8,31,47
34732,Ukraine,2004.0,8,8,31,47
34733,Ukraine,2004.0,8,8,31,47
34734,Ukraine,2000.0,3,20,12,35
34735,Ukraine,2008.0,10,5,16,31
34736,Ukraine,2004.0,8,8,31,47
34737,Ukraine,2012.0,9,5,12,26
34738,Ukraine,2008.0,10,5,16,31
34739,Ukraine,1996.0,10,5,19,34
34740,Ukraine,2000.0,3,20,12,35
34741,Ukraine,2000.0,3,20,12,35
34742,Ukraine,2000.0,3,20,12,35
34743,Ukraine,2000.0,3,20,12,35
34744,Ukraine,1996.0,10,5,19,34
34745,Ukraine,1996.0,10,5,19,34
34746,Ukraine,2000.0,3,20,12,35
34747,Ukraine,2004.0,8,8,31,47
34748,Ukraine,2012.0,9,5,12,26
34749,Ukraine,1996.0,10,5,19,34
34750,Ukraine,2004.0,8,8,31,47
34751,Ukraine,2004.0,8,8,31,47
34752,Ukraine,2008.0,10,5,16,31
34753,Ukraine,2004.0,8,8,31,47
34754,Ukraine,2008.0,10,5,16,31
34755,Ukraine,2012.0,9,5,12,26
34756,Ukraine,2004.0,8,8,31,47
34757,Ukraine,1994.0,1,0,1,2
34758,Ukraine,2000.0,3,20,12,35
34759,Ukraine,2004.0,8,8,31,47
34760,Ukraine,2016.0,2,8,5,15
34761,Ukraine,2012.0,9,5,12,26
34762,Ukraine,2008.0,10,5,16,31
34763,Ukraine,2004.0,8,8,31,47
34764,Ukraine,2016.0,2,8,5,15
34765,Ukraine,2016.0,2,8,5,15
34766,Ukraine,1996.0,10,5,19,34
34767,Ukraine,2008.0,10,5,16,31
34768,Ukraine,2016.0,2,8,5,15
34769,Ukraine,2016.0,2,8,5,15
34770,Ukraine,2000.0,3,20,12,35
34771,Ukraine,2004.0,8,8,31,47
34772,Ukraine,2006.0,0,0,3,3
34773,Ukraine,1996.0,10,5,19,34
34774,Ukraine,2008.0,10,5,16,31
34775,Ukraine,2004.0,8,8,31,47
34776,Ukraine,1996.0,10,5,19,34
34777,Ukraine,2008.0,10,5,16,31
34778,Ukraine,2000.0,3,20,12,35
34779,Ukraine,2000.0,3,20,12,35
34780,Uganda,1972.0,1,1,0,2
34781,Uganda,1996.0,0,0,1,1
34782,Uganda,2012.0,1,0,0,1
34783,Uganda,1980.0,0,1,0,1
34784,Uganda,1968.0,0,1,1,2
34785,Uganda,1968.0,0,1,1,2
34786,Uganda,1972.0,1,1,0,2
34787,Syria,2004.0,0,0,1,1
34788,Syria,1984.0,0,1,0,1
34789,Syria,1996.0,1,0,0,1
34790,Qatar,2012.0,0,0,2,2
34791,Qatar,2012.0,0,0,2,2
34792,Qatar,2016.0,0,1,0,1
34793,Qatar,2000.0,0,0,1,1
34794,Qatar,1992.0,0,0,1,1
34795,Kuwait,2000.0,0,0,1,1
34796,Kuwait,2012.0,0,0,1,1
34797,Individual Olympic Athletes,2016.0,1,0,1,2
34798,Individual Olympic Athletes,2016.0,1,0,1,2
34799,Individual Olympic Athletes,1992.0,0,1,2,3
34800,Individual Olympic Athletes,1992.0,0,1,2,3
34801,Individual Olympic Athletes,1992.0,0,1,2,3
34802,Saudi Arabia,2012.0,0,0,4,4
34803,Saudi Arabia,2000.0,0,1,1,2
34804,Saudi Arabia,2012.0,0,0,4,4
34805,Saudi Arabia,2000.0,0,1,1,2
34806,Saudi Arabia,2012.0,0,0,4,4
34807,Saudi Arabia,2012.0,0,0,4,4
34808,United Arab Emirates,2004.0,1,0,0,1
34809,United Arab Emirates,2016.0,0,0,1,1
34810,Croatia,1992.0,0,12,3,15
34811,Croatia,2012.0,15,4,16,35
34812,Croatia,2004.0,15,3,3,21
34813,Croatia,1992.0,0,12,3,15
34814,Croatia,2004.0,15,3,3,21
34815,Croatia,2012.0,15,4,16,35
34816,Croatia,2012.0,15,4,16,35
34817,Croatia,2012.0,15,4,16,35
34818,Croatia,2016.0,7,15,2,24
34819,Croatia,2000.0,1,0,9,10
34820,Croatia,2012.0,15,4,16,35
34821,Croatia,2016.0,7,15,2,24
34822,Croatia,1996.0,16,12,0,28
34823,Croatia,2012.0,15,4,16,35
34824,Croatia,2012.0,15,4,16,35
34825,Croatia,2012.0,15,4,16,35
34826,Croatia,2016.0,7,15,2,24
34827,Croatia,2012.0,15,4,16,35
34828,Croatia,2016.0,7,15,2,24
34829,Croatia,1996.0,16,12,0,28
34830,Croatia,2012.0,15,4,16,35
34831,Croatia,2000.0,1,0,9,10
34832,Croatia,2012.0,15,4,16,35
34833,Croatia,1992.0,0,12,3,15
34834,Croatia,2012.0,15,4,16,35
34835,Croatia,2004.0,15,3,3,21
34836,Croatia,2004.0,15,3,3,21
34837,Croatia,2012.0,15,4,16,35
34838,Croatia,2004.0,15,3,3,21
34839,Croatia,2010.0,0,2,1,3
34840,Croatia,2016.0,7,15,2,24
34841,Croatia,2000.0,1,0,9,10
34842,Croatia,2000.0,1,0,9,10
34843,Croatia,1996.0,16,12,0,28
34844,Croatia,2016.0,7,15,2,24
34845,Croatia,2016.0,7,15,2,24
34846,Croatia,1996.0,16,12,0,28
34847,Croatia,2012.0,15,4,16,35
34848,Croatia,1996.0,16,12,0,28
34849,Croatia,2004.0,15,3,3,21
34850,Croatia,1992.0,0,12,3,15
34851,Croatia,1996.0,16,12,0,28
34852,Croatia,1996.0,16,12,0,28
34853,Croatia,2012.0,15,4,16,35
34854,Croatia,2012.0,15,4,16,35
34855,Croatia,2016.0,7,15,2,24
34856,Croatia,1992.0,0,12,3,15
34857,Croatia,1992.0,0,12,3,15
34858,Croatia,1996.0,16,12,0,28
34859,Croatia,2012.0,15,4,16,35
34860,Croatia,2016.0,7,15,2,24
34861,Croatia,1996.0,16,12,0,28
34862,Croatia,2004.0,15,3,3,21
34863,Croatia,1996.0,16,12,0,28
34864,Croatia,1996.0,16,12,0,28
34865,Croatia,2016.0,7,15,2,24
34866,Croatia,1992.0,0,12,3,15
34867,Croatia,2012.0,15,4,16,35
34868,Croatia,2006.0,1,2,0,3
34869,Croatia,2010.0,0,2,1,3
34870,Croatia,2010.0,0,2,1,3
34871,Croatia,2014.0,0,1,0,1
34872,Croatia,2002.0,3,1,0,4
34873,Croatia,2002.0,3,1,0,4
34874,Croatia,2002.0,3,1,0,4
34875,Croatia,2002.0,3,1,0,4
34876,Croatia,2006.0,1,2,0,3
34877,Croatia,2006.0,1,2,0,3
34878,Croatia,2016.0,7,15,2,24
34879,Croatia,1996.0,16,12,0,28
34880,Croatia,1996.0,16,12,0,28
34881,Croatia,1992.0,0,12,3,15
34882,Croatia,2004.0,15,3,3,21
34883,Croatia,2012.0,15,4,16,35
34884,Croatia,2004.0,15,3,3,21
34885,Croatia,2016.0,7,15,2,24
34886,Croatia,1996.0,16,12,0,28
34887,Croatia,2004.0,15,3,3,21
34888,Croatia,2012.0,15,4,16,35
34889,Croatia,2016.0,7,15,2,24
34890,Croatia,2016.0,7,15,2,24
34891,Croatia,2012.0,15,4,16,35
34892,Croatia,2016.0,7,15,2,24
34893,Croatia,1996.0,16,12,0,28
34894,Croatia,2004.0,15,3,3,21
34895,Croatia,2004.0,15,3,3,21
34896,Croatia,1996.0,16,12,0,28
34897,Croatia,2012.0,15,4,16,35
34898,Croatia,1996.0,16,12,0,28
34899,Croatia,1992.0,0,12,3,15
34900,Croatia,2012.0,15,4,16,35
34901,Croatia,2012.0,15,4,16,35
34902,Croatia,2012.0,15,4,16,35
34903,Croatia,2016.0,7,15,2,24
34904,Croatia,2008.0,0,2,3,5
34905,Croatia,1992.0,0,12,3,15
34906,Croatia,1996.0,16,12,0,28
34907,Croatia,2012.0,15,4,16,35
34908,Croatia,2016.0,7,15,2,24
34909,Croatia,2000.0,1,0,9,10
34910,Croatia,2004.0,15,3,3,21
34911,Croatia,2016.0,7,15,2,24
34912,Croatia,2000.0,1,0,9,10
34913,Croatia,1992.0,0,12,3,15
34914,Croatia,1992.0,0,12,3,15
34915,Croatia,1996.0,16,12,0,28
34916,Croatia,1992.0,0,12,3,15
34917,Croatia,2012.0,15,4,16,35
34918,Croatia,1996.0,16,12,0,28
34919,Croatia,2008.0,0,2,3,5
34920,Croatia,2016.0,7,15,2,24
34921,Croatia,1996.0,16,12,0,28
34922,Croatia,2012.0,15,4,16,35
34923,Croatia,2016.0,7,15,2,24
34924,Croatia,2012.0,15,4,16,35
34925,Croatia,2016.0,7,15,2,24
34926,Croatia,2000.0,1,0,9,10
34927,Croatia,2004.0,15,3,3,21
34928,Croatia,2000.0,1,0,9,10
34929,Croatia,2004.0,15,3,3,21
34930,Croatia,1996.0,16,12,0,28
34931,Croatia,1996.0,16,12,0,28
34932,Croatia,2000.0,1,0,9,10
34933,Croatia,2004.0,15,3,3,21
34934,Croatia,2004.0,15,3,3,21
34935,Croatia,2004.0,15,3,3,21
34936,Croatia,2016.0,7,15,2,24
34937,Croatia,1996.0,16,12,0,28
34938,Croatia,2012.0,15,4,16,35
34939,Croatia,1996.0,16,12,0,28
34940,Croatia,2012.0,15,4,16,35
34941,Croatia,2016.0,7,15,2,24
34942,Croatia,1992.0,0,12,3,15
34943,Croatia,2008.0,0,2,3,5
34944,Croatia,1996.0,16,12,0,28
34945,Croatia,2012.0,15,4,16,35
34946,Croatia,2008.0,0,2,3,5
34947,Croatia,2016.0,7,15,2,24
34948,Croatia,2004.0,15,3,3,21
34949,Croatia,2012.0,15,4,16,35
34950,Croatia,1992.0,0,12,3,15
34951,Croatia,1996.0,16,12,0,28
34952,Croatia,1996.0,16,12,0,28
34953,Croatia,2000.0,1,0,9,10
34954,Croatia,2004.0,15,3,3,21
34955,Croatia,2012.0,15,4,16,35
34956,Croatia,2012.0,15,4,16,35
34957,Croatia,2004.0,15,3,3,21
34958,Croatia,2008.0,0,2,3,5
34959,West Germany,1984.0,33,76,57,166
34960,West Germany,1976.0,23,32,55,110
34961,West Germany,1980.0,0,2,6,8
34962,West Germany,1984.0,33,76,57,166
34963,West Germany,1984.0,33,76,57,166
34964,West Germany,1984.0,33,76,57,166
34965,West Germany,1988.0,36,44,49,129
34966,West Germany,1984.0,33,76,57,166
34967,West Germany,1972.0,48,21,43,112
34968,West Germany,1976.0,23,32,55,110
34969,West Germany,1976.0,23,32,55,110
34970,West Germany-1,1968.0,19,19,23,61
34971,West Germany-1,1972.0,48,21,43,112
34972,West Germany,1972.0,48,21,43,112
34973,West Germany,1984.0,33,76,57,166
34974,West Germany,1988.0,36,44,49,129
34975,West Germany,1988.0,36,44,49,129
34976,West Germany-1,1972.0,48,21,43,112
34977,West Germany,1988.0,36,44,49,129
34978,West Germany,1988.0,36,44,49,129
34979,West Germany,1972.0,48,21,43,112
34980,West Germany,1972.0,48,21,43,112
34981,West Germany,1984.0,33,76,57,166
34982,West Germany,1984.0,33,76,57,166
34983,West Germany,1976.0,23,32,55,110
34984,West Germany,1972.0,48,21,43,112
34985,West Germany,1972.0,48,21,43,112
34986,West Germany,1988.0,36,44,49,129
34987,West Germany,1976.0,23,32,55,110
34988,West Germany,1984.0,33,76,57,166
34989,West Germany,1984.0,33,76,57,166
34990,West Germany,1988.0,36,44,49,129
34991,West Germany,1976.0,23,32,55,110
34992,West Germany,1968.0,19,19,23,61
34993,West Germany,1972.0,48,21,43,112
34994,West Germany,1972.0,48,21,43,112
34995,West Germany,1976.0,23,32,55,110
34996,West Germany,1980.0,0,2,6,8
34997,West Germany,1984.0,33,76,57,166
34998,West Germany,1984.0,33,76,57,166
34999,West Germany,1972.0,48,21,43,112
35000,West Germany,1984.0,33,76,57,166
35001,West Germany-1,1976.0,23,32,55,110
35002,West Germany,1984.0,33,76,57,166
35003,West Germany,1988.0,36,44,49,129
35004,West Germany,1976.0,23,32,55,110
35005,West Germany,1972.0,48,21,43,112
35006,West Germany,1976.0,23,32,55,110
35007,West Germany,1976.0,23,32,55,110
35008,West Germany,1976.0,23,32,55,110
35009,West Germany,1988.0,36,44,49,129
35010,West Germany,1976.0,23,32,55,110
35011,West Germany,1984.0,33,76,57,166
35012,West Germany,1988.0,36,44,49,129
35013,West Germany,1968.0,19,19,23,61
35014,West Germany-1,1976.0,23,32,55,110
35015,West Germany,1976.0,23,32,55,110
35016,West Germany,1976.0,23,32,55,110
35017,West Germany,1976.0,23,32,55,110
35018,West Germany,1984.0,33,76,57,166
35019,West Germany,1968.0,19,19,23,61
35020,West Germany,1984.0,33,76,57,166
35021,West Germany,1988.0,36,44,49,129
35022,West Germany,1988.0,36,44,49,129
35023,West Germany,1988.0,36,44,49,129
35024,West Germany,1984.0,33,76,57,166
35025,West Germany,1972.0,48,21,43,112
35026,West Germany-1,1968.0,19,19,23,61
35027,West Germany,1984.0,33,76,57,166
35028,West Germany,1988.0,36,44,49,129
35029,West Germany,1984.0,33,76,57,166
35030,West Germany,1976.0,23,32,55,110
35031,West Germany,1976.0,23,32,55,110
35032,West Germany,1976.0,23,32,55,110
35033,West Germany,1968.0,19,19,23,61
35034,West Germany,1988.0,36,44,49,129
35035,West Germany,1988.0,36,44,49,129
35036,West Germany,1984.0,33,76,57,166
35037,West Germany,1988.0,36,44,49,129
35038,West Germany,1972.0,48,21,43,112
35039,West Germany,1984.0,33,76,57,166
35040,West Germany,1968.0,19,19,23,61
35041,West Germany,1984.0,33,76,57,166
35042,West Germany,1972.0,48,21,43,112
35043,West Germany,1976.0,23,32,55,110
35044,West Germany,1972.0,48,21,43,112
35045,West Germany,1988.0,36,44,49,129
35046,West Germany,1972.0,48,21,43,112
35047,West Germany,1988.0,36,44,49,129
35048,West Germany,1984.0,33,76,57,166
35049,West Germany,1976.0,23,32,55,110
35050,West Germany,1988.0,36,44,49,129
35051,West Germany,1980.0,0,2,6,8
35052,West Germany,1984.0,33,76,57,166
35053,West Germany,1988.0,36,44,49,129
35054,West Germany,1968.0,19,19,23,61
35055,West Germany,1980.0,0,2,6,8
35056,West Germany,1984.0,33,76,57,166
35057,West Germany,1988.0,36,44,49,129
35058,West Germany,1984.0,33,76,57,166
35059,West Germany,1984.0,33,76,57,166
35060,West Germany,1988.0,36,44,49,129
35061,West Germany,1972.0,48,21,43,112
35062,West Germany,1972.0,48,21,43,112
35063,West Germany,1972.0,48,21,43,112
35064,West Germany,1976.0,23,32,55,110
35065,West Germany,1972.0,48,21,43,112
35066,West Germany,1988.0,36,44,49,129
35067,West Germany,1976.0,23,32,55,110
35068,West Germany,1984.0,33,76,57,166
35069,West Germany,1988.0,36,44,49,129
35070,West Germany,1988.0,36,44,49,129
35071,West Germany,1984.0,33,76,57,166
35072,West Germany,1988.0,36,44,49,129
35073,West Germany,1984.0,33,76,57,166
35074,West Germany,1988.0,36,44,49,129
35075,West Germany,1976.0,23,32,55,110
35076,West Germany,1984.0,33,76,57,166
35077,West Germany,1988.0,36,44,49,129
35078,West Germany-1,1968.0,19,19,23,61
35079,West Germany-1,1972.0,48,21,43,112
35080,West Germany,1984.0,33,76,57,166
35081,West Germany,1984.0,33,76,57,166
35082,West Germany,1988.0,36,44,49,129
35083,West Germany,1972.0,48,21,43,112
35084,West Germany,1984.0,33,76,57,166
35085,West Germany,1976.0,23,32,55,110
35086,West Germany,1984.0,33,76,57,166
35087,West Germany,1988.0,36,44,49,129
35088,West Germany,1968.0,19,19,23,61
35089,West Germany,1976.0,23,32,55,110
35090,West Germany,1988.0,36,44,49,129
35091,West Germany,1984.0,33,76,57,166
35092,West Germany,1988.0,36,44,49,129
35093,West Germany,1988.0,36,44,49,129
35094,West Germany,1972.0,48,21,43,112
35095,West Germany-1,1972.0,48,21,43,112
35096,West Germany,1984.0,33,76,57,166
35097,West Germany,1972.0,48,21,43,112
35098,West Germany,1988.0,36,44,49,129
35099,West Germany,1984.0,33,76,57,166
35100,West Germany,1988.0,36,44,49,129
35101,West Germany,1976.0,23,32,55,110
35102,West Germany,1988.0,36,44,49,129
35103,West Germany,1972.0,48,21,43,112
35104,West Germany-1,1968.0,19,19,23,61
35105,West Germany,1984.0,33,76,57,166
35106,West Germany,1984.0,33,76,57,166
35107,West Germany,1988.0,36,44,49,129
35108,West Germany,1972.0,48,21,43,112
35109,West Germany,1988.0,36,44,49,129
35110,West Germany,1988.0,36,44,49,129
35111,West Germany,1988.0,36,44,49,129
35112,West Germany,1988.0,36,44,49,129
35113,West Germany,1988.0,36,44,49,129
35114,West Germany,1984.0,33,76,57,166
35115,West Germany,1976.0,23,32,55,110
35116,West Germany,1988.0,36,44,49,129
35117,West Germany,1984.0,33,76,57,166
35118,West Germany,1984.0,33,76,57,166
35119,West Germany,1984.0,33,76,57,166
35120,West Germany,1984.0,33,76,57,166
35121,West Germany,1988.0,36,44,49,129
35122,West Germany,1988.0,36,44,49,129
35123,West Germany,1972.0,48,21,43,112
35124,West Germany,1984.0,33,76,57,166
35125,West Germany,1984.0,33,76,57,166
35126,West Germany,1988.0,36,44,49,129
35127,West Germany,1988.0,36,44,49,129
35128,West Germany,1984.0,33,76,57,166
35129,West Germany,1984.0,33,76,57,166
35130,West Germany,1984.0,33,76,57,166
35131,West Germany,1988.0,36,44,49,129
35132,West Germany,1984.0,33,76,57,166
35133,West Germany,1984.0,33,76,57,166
35134,West Germany,1984.0,33,76,57,166
35135,West Germany,1972.0,48,21,43,112
35136,West Germany,1988.0,36,44,49,129
35137,West Germany,1984.0,33,76,57,166
35138,West Germany,1984.0,33,76,57,166
35139,West Germany,1984.0,33,76,57,166
35140,West Germany,1976.0,23,32,55,110
35141,West Germany,1976.0,23,32,55,110
35142,West Germany,1976.0,23,32,55,110
35143,West Germany,1984.0,33,76,57,166
35144,West Germany,1976.0,23,32,55,110
35145,West Germany,1972.0,48,21,43,112
35146,West Germany,1976.0,23,32,55,110
35147,West Germany,1976.0,23,32,55,110
35148,West Germany,1968.0,19,19,23,61
35149,West Germany,1972.0,48,21,43,112
35150,West Germany,1984.0,33,76,57,166
35151,West Germany,1988.0,36,44,49,129
35152,West Germany,1988.0,36,44,49,129
35153,West Germany,1968.0,19,19,23,61
35154,West Germany,1968.0,19,19,23,61
35155,West Germany,1968.0,19,19,23,61
35156,West Germany,1988.0,36,44,49,129
35157,West Germany,1968.0,19,19,23,61
35158,West Germany,1976.0,23,32,55,110
35159,West Germany,1976.0,23,32,55,110
35160,West Germany,1976.0,23,32,55,110
35161,West Germany,1988.0,36,44,49,129
35162,West Germany,1988.0,36,44,49,129
35163,West Germany,1984.0,33,76,57,166
35164,West Germany,1976.0,23,32,55,110
35165,West Germany,1968.0,19,19,23,61
35166,West Germany,1972.0,48,21,43,112
35167,West Germany,1988.0,36,44,49,129
35168,West Germany,1988.0,36,44,49,129
35169,West Germany,1976.0,23,32,55,110
35170,West Germany,1984.0,33,76,57,166
35171,West Germany,1984.0,33,76,57,166
35172,West Germany,1968.0,19,19,23,61
35173,West Germany,1984.0,33,76,57,166
35174,West Germany,1984.0,33,76,57,166
35175,West Germany,1988.0,36,44,49,129
35176,West Germany,1968.0,19,19,23,61
35177,West Germany,1984.0,33,76,57,166
35178,West Germany,1976.0,23,32,55,110
35179,West Germany,1988.0,36,44,49,129
35180,West Germany,1984.0,33,76,57,166
35181,West Germany,1972.0,48,21,43,112
35182,West Germany,1968.0,19,19,23,61
35183,West Germany,1984.0,33,76,57,166
35184,West Germany,1988.0,36,44,49,129
35185,West Germany,1988.0,36,44,49,129
35186,West Germany,1972.0,48,21,43,112
35187,West Germany,1972.0,48,21,43,112
35188,West Germany,1976.0,23,32,55,110
35189,West Germany,1988.0,36,44,49,129
35190,West Germany,1968.0,19,19,23,61
35191,West Germany,1972.0,48,21,43,112
35192,West Germany,1988.0,36,44,49,129
35193,West Germany,1972.0,48,21,43,112
35194,West Germany,1972.0,48,21,43,112
35195,West Germany,1988.0,36,44,49,129
35196,West Germany,1972.0,48,21,43,112
35197,West Germany,1976.0,23,32,55,110
35198,West Germany,1984.0,33,76,57,166
35199,West Germany,1988.0,36,44,49,129
35200,West Germany,1972.0,48,21,43,112
35201,West Germany,1968.0,19,19,23,61
35202,West Germany,1972.0,48,21,43,112
35203,West Germany,1968.0,19,19,23,61
35204,West Germany,1988.0,36,44,49,129
35205,West Germany,1988.0,36,44,49,129
35206,West Germany,1976.0,23,32,55,110
35207,West Germany,1968.0,19,19,23,61
35208,West Germany,1980.0,0,2,6,8
35209,West Germany,1988.0,36,44,49,129
35210,West Germany,1988.0,36,44,49,129
35211,West Germany,1984.0,33,76,57,166
35212,West Germany,1968.0,19,19,23,61
35213,West Germany,1972.0,48,21,43,112
35214,West Germany,1972.0,48,21,43,112
35215,West Germany,1988.0,36,44,49,129
35216,West Germany,1988.0,36,44,49,129
35217,West Germany,1968.0,19,19,23,61
35218,West Germany,1968.0,19,19,23,61
35219,West Germany,1976.0,23,32,55,110
35220,West Germany,1976.0,23,32,55,110
35221,West Germany,1984.0,33,76,57,166
35222,West Germany,1984.0,33,76,57,166
35223,West Germany,1988.0,36,44,49,129
35224,West Germany,1968.0,19,19,23,61
35225,West Germany,1988.0,36,44,49,129
35226,West Germany,1972.0,48,21,43,112
35227,West Germany,1988.0,36,44,49,129
35228,West Germany,1972.0,48,21,43,112
35229,West Germany,1984.0,33,76,57,166
35230,West Germany,1972.0,48,21,43,112
35231,West Germany,1976.0,23,32,55,110
35232,West Germany,1972.0,48,21,43,112
35233,West Germany,1984.0,33,76,57,166
35234,West Germany,1988.0,36,44,49,129
35235,West Germany,1976.0,23,32,55,110
35236,West Germany,1984.0,33,76,57,166
35237,West Germany,1988.0,36,44,49,129
35238,West Germany,1976.0,23,32,55,110
35239,West Germany,1984.0,33,76,57,166
35240,West Germany,1972.0,48,21,43,112
35241,West Germany,1976.0,23,32,55,110
35242,West Germany,1968.0,19,19,23,61
35243,West Germany,1976.0,23,32,55,110
35244,West Germany,1972.0,48,21,43,112
35245,West Germany,1972.0,48,21,43,112
35246,West Germany,1972.0,48,21,43,112
35247,West Germany,1976.0,23,32,55,110
35248,West Germany,1976.0,23,32,55,110
35249,West Germany,1984.0,33,76,57,166
35250,West Germany,1984.0,33,76,57,166
35251,West Germany,1976.0,23,32,55,110
35252,West Germany,1988.0,36,44,49,129
35253,West Germany,1976.0,23,32,55,110
35254,West Germany,1972.0,48,21,43,112
35255,West Germany,1976.0,23,32,55,110
35256,West Germany,1972.0,48,21,43,112
35257,West Germany,1972.0,48,21,43,112
35258,West Germany,1984.0,33,76,57,166
35259,West Germany,1976.0,23,32,55,110
35260,West Germany,1988.0,36,44,49,129
35261,West Germany,1984.0,33,76,57,166
35262,West Germany,1968.0,19,19,23,61
35263,West Germany,1972.0,48,21,43,112
35264,West Germany,1984.0,33,76,57,166
35265,West Germany,1984.0,33,76,57,166
35266,West Germany,1968.0,19,19,23,61
35267,West Germany,1972.0,48,21,43,112
35268,West Germany,1972.0,48,21,43,112
35269,West Germany,1984.0,33,76,57,166
35270,West Germany,1976.0,23,32,55,110
35271,West Germany,1984.0,33,76,57,166
35272,West Germany,1968.0,19,19,23,61
35273,West Germany,1988.0,36,44,49,129
35274,West Germany,1968.0,19,19,23,61
35275,West Germany,1972.0,48,21,43,112
35276,West Germany,1972.0,48,21,43,112
35277,West Germany,1984.0,33,76,57,166
35278,West Germany,1984.0,33,76,57,166
35279,West Germany,1988.0,36,44,49,129
35280,West Germany,1980.0,0,2,6,8
35281,West Germany,1984.0,33,76,57,166
35282,West Germany,1972.0,48,21,43,112
35283,West Germany,1976.0,23,32,55,110
35284,West Germany,1988.0,36,44,49,129
35285,West Germany,1972.0,48,21,43,112
35286,West Germany,1984.0,33,76,57,166
35287,West Germany,1984.0,33,76,57,166
35288,West Germany,1972.0,48,21,43,112
35289,West Germany,1984.0,33,76,57,166
35290,West Germany,1968.0,19,19,23,61
35291,West Germany,1988.0,36,44,49,129
35292,West Germany,1968.0,19,19,23,61
35293,West Germany,1988.0,36,44,49,129
35294,West Germany,1968.0,19,19,23,61
35295,West Germany,1984.0,33,76,57,166
35296,West Germany,1988.0,36,44,49,129
35297,West Germany,1976.0,23,32,55,110
35298,West Germany,1968.0,19,19,23,61
35299,West Germany,1972.0,48,21,43,112
35300,West Germany,1972.0,48,21,43,112
35301,West Germany,1984.0,33,76,57,166
35302,West Germany,1968.0,19,19,23,61
35303,West Germany,1972.0,48,21,43,112
35304,West Germany,1988.0,36,44,49,129
35305,West Germany,1984.0,33,76,57,166
35306,West Germany,1976.0,23,32,55,110
35307,West Germany,1976.0,23,32,55,110
35308,West Germany,1976.0,23,32,55,110
35309,West Germany,1984.0,33,76,57,166
35310,West Germany,1988.0,36,44,49,129
35311,West Germany,1988.0,36,44,49,129
35312,West Germany,1984.0,33,76,57,166
35313,West Germany,1968.0,19,19,23,61
35314,West Germany,1988.0,36,44,49,129
35315,West Germany-1,1968.0,19,19,23,61
35316,West Germany,1968.0,19,19,23,61
35317,West Germany,1972.0,48,21,43,112
35318,West Germany,1968.0,19,19,23,61
35319,West Germany,1968.0,19,19,23,61
35320,West Germany,1972.0,48,21,43,112
35321,West Germany,1972.0,48,21,43,112
35322,West Germany,1984.0,33,76,57,166
35323,West Germany,1984.0,33,76,57,166
35324,West Germany,1988.0,36,44,49,129
35325,West Germany,1976.0,23,32,55,110
35326,West Germany,1984.0,33,76,57,166
35327,West Germany,1984.0,33,76,57,166
35328,West Germany,1988.0,36,44,49,129
35329,West Germany,1976.0,23,32,55,110
35330,West Germany,1976.0,23,32,55,110
35331,West Germany,1976.0,23,32,55,110
35332,West Germany,1984.0,33,76,57,166
35333,West Germany,1984.0,33,76,57,166
35334,West Germany,1968.0,19,19,23,61
35335,West Germany,1984.0,33,76,57,166
35336,West Germany,1984.0,33,76,57,166
35337,West Germany,1984.0,33,76,57,166
35338,West Germany,1984.0,33,76,57,166
35339,West Germany,1984.0,33,76,57,166
35340,West Germany,1972.0,48,21,43,112
35341,West Germany,1984.0,33,76,57,166
35342,West Germany,1984.0,33,76,57,166
35343,West Germany,1988.0,36,44,49,129
35344,West Germany,1988.0,36,44,49,129
35345,West Germany,1976.0,23,32,55,110
35346,West Germany,1984.0,33,76,57,166
35347,West Germany,1972.0,48,21,43,112
35348,West Germany,1984.0,33,76,57,166
35349,West Germany,1984.0,33,76,57,166
35350,West Germany,1972.0,48,21,43,112
35351,West Germany,1968.0,19,19,23,61
35352,West Germany,1988.0,36,44,49,129
35353,West Germany,1976.0,23,32,55,110
35354,West Germany,1976.0,23,32,55,110
35355,West Germany,1976.0,23,32,55,110
35356,West Germany,1984.0,33,76,57,166
35357,West Germany,1988.0,36,44,49,129
35358,West Germany,1988.0,36,44,49,129
35359,West Germany,1988.0,36,44,49,129
35360,West Germany,1984.0,33,76,57,166
35361,West Germany,1984.0,33,76,57,166
35362,West Germany,1984.0,33,76,57,166
35363,West Germany,1988.0,36,44,49,129
35364,West Germany,1976.0,23,32,55,110
35365,West Germany,1984.0,33,76,57,166
35366,West Germany,1976.0,23,32,55,110
35367,West Germany,1968.0,19,19,23,61
35368,West Germany,1972.0,48,21,43,112
35369,West Germany,1972.0,48,21,43,112
35370,West Germany,1984.0,33,76,57,166
35371,West Germany,1988.0,36,44,49,129
35372,West Germany,1976.0,23,32,55,110
35373,West Germany,1972.0,48,21,43,112
35374,West Germany,1976.0,23,32,55,110
35375,West Germany,1976.0,23,32,55,110
35376,West Germany,1976.0,23,32,55,110
35377,West Germany,1988.0,36,44,49,129
35378,West Germany,1988.0,36,44,49,129
35379,West Germany,1984.0,33,76,57,166
35380,West Germany,1984.0,33,76,57,166
35381,West Germany,1984.0,33,76,57,166
35382,West Germany,1972.0,48,21,43,112
35383,West Germany,1972.0,48,21,43,112
35384,West Germany,1972.0,48,21,43,112
35385,West Germany,1984.0,33,76,57,166
35386,West Germany,1984.0,33,76,57,166
35387,West Germany,1984.0,33,76,57,166
35388,West Germany,1972.0,48,21,43,112
35389,West Germany,1972.0,48,21,43,112
35390,West Germany,1984.0,33,76,57,166
35391,West Germany,1984.0,33,76,57,166
35392,West Germany,1972.0,48,21,43,112
35393,West Germany,1968.0,19,19,23,61
35394,West Germany,1984.0,33,76,57,166
35395,West Germany,1984.0,33,76,57,166
35396,West Germany,1988.0,36,44,49,129
35397,West Germany,1976.0,23,32,55,110
35398,West Germany,1972.0,48,21,43,112
35399,West Germany,1976.0,23,32,55,110
35400,West Germany,1976.0,23,32,55,110
35401,West Germany,1984.0,33,76,57,166
35402,West Germany,1984.0,33,76,57,166
35403,West Germany,1972.0,48,21,43,112
35404,West Germany,1984.0,33,76,57,166
35405,West Germany,1988.0,36,44,49,129
35406,West Germany,1984.0,33,76,57,166
35407,West Germany,1988.0,36,44,49,129
35408,West Germany,1988.0,36,44,49,129
35409,West Germany,1968.0,19,19,23,61
35410,West Germany,1984.0,33,76,57,166
35411,West Germany,1968.0,19,19,23,61
35412,West Germany,1976.0,23,32,55,110
35413,West Germany,1976.0,23,32,55,110
35414,West Germany,1976.0,23,32,55,110
35415,West Germany,1984.0,33,76,57,166
35416,West Germany,1984.0,33,76,57,166
35417,West Germany,1988.0,36,44,49,129
35418,West Germany,1988.0,36,44,49,129
35419,West Germany,1968.0,19,19,23,61
35420,West Germany,1968.0,19,19,23,61
35421,West Germany,1984.0,33,76,57,166
35422,West Germany,1984.0,33,76,57,166
35423,West Germany,1988.0,36,44,49,129
35424,West Germany,1972.0,48,21,43,112
35425,West Germany,1976.0,23,32,55,110
35426,West Germany,1976.0,23,32,55,110
35427,West Germany,1988.0,36,44,49,129
35428,West Germany,1972.0,48,21,43,112
35429,West Germany,1976.0,23,32,55,110
35430,West Germany-1,1972.0,48,21,43,112
35431,West Germany,1984.0,33,76,57,166
35432,West Germany-1,1976.0,23,32,55,110
35433,West Germany-1,1976.0,23,32,55,110
35434,West Germany,1984.0,33,76,57,166
35435,West Germany-1,1988.0,36,44,49,129
35436,West Germany,1984.0,33,76,57,166
35437,West Germany-1,1976.0,23,32,55,110
35438,West Germany,1988.0,36,44,49,129
35439,West Germany,1984.0,33,76,57,166
35440,West Germany,1972.0,48,21,43,112
35441,West Germany,1976.0,23,32,55,110
35442,West Germany,1976.0,23,32,55,110
35443,West Germany,1984.0,33,76,57,166
35444,West Germany,1984.0,33,76,57,166
35445,West Germany,1984.0,33,76,57,166
35446,West Germany,1972.0,48,21,43,112
35447,West Germany,1976.0,23,32,55,110
35448,West Germany,1968.0,19,19,23,61
35449,West Germany,1988.0,36,44,49,129
35450,West Germany,1988.0,36,44,49,129
35451,West Germany,1976.0,23,32,55,110
35452,West Germany,1984.0,33,76,57,166
35453,West Germany,1984.0,33,76,57,166
35454,West Germany,1988.0,36,44,49,129
35455,West Germany,1976.0,23,32,55,110
35456,West Germany,1976.0,23,32,55,110
35457,West Germany,1976.0,23,32,55,110
35458,West Germany,1988.0,36,44,49,129
35459,West Germany,1988.0,36,44,49,129
35460,West Germany,1984.0,33,76,57,166
35461,West Germany,1984.0,33,76,57,166
35462,West Germany-1,1984.0,33,76,57,166
35463,West Germany-1,1988.0,36,44,49,129
35464,West Germany,1972.0,48,21,43,112
35465,West Germany,1972.0,48,21,43,112
35466,West Germany,1972.0,48,21,43,112
35467,West Germany,1976.0,23,32,55,110
35468,West Germany-1,1972.0,48,21,43,112
35469,West Germany,1976.0,23,32,55,110
35470,West Germany,1972.0,48,21,43,112
35471,West Germany,1972.0,48,21,43,112
35472,West Germany,1984.0,33,76,57,166
35473,West Germany,1984.0,33,76,57,166
35474,West Germany,1976.0,23,32,55,110
35475,West Germany,1984.0,33,76,57,166
35476,West Germany,1972.0,48,21,43,112
35477,West Germany,1988.0,36,44,49,129
35478,West Germany,1984.0,33,76,57,166
35479,West Germany,1984.0,33,76,57,166
35480,West Germany,1984.0,33,76,57,166
35481,West Germany,1968.0,19,19,23,61
35482,West Germany,1972.0,48,21,43,112
35483,West Germany,1968.0,19,19,23,61
35484,West Germany,1968.0,19,19,23,61
35485,West Germany,1988.0,36,44,49,129
35486,West Germany,1988.0,36,44,49,129
35487,West Germany-2,1972.0,48,21,43,112
35488,West Germany-1,1972.0,48,21,43,112
35489,West Germany-1,1976.0,23,32,55,110
35490,West Germany,1988.0,36,44,49,129
35491,West Germany,1976.0,23,32,55,110
35492,West Germany,1972.0,48,21,43,112
35493,West Germany,1976.0,23,32,55,110
35494,West Germany,1984.0,33,76,57,166
35495,West Germany,1972.0,48,21,43,112
35496,West Germany,1976.0,23,32,55,110
35497,West Germany,1972.0,48,21,43,112
35498,West Germany,1972.0,48,21,43,112
35499,West Germany,1976.0,23,32,55,110
35500,West Germany,1968.0,19,19,23,61
35501,West Germany,1988.0,36,44,49,129
35502,West Germany,1984.0,33,76,57,166
35503,West Germany,1988.0,36,44,49,129
35504,West Germany,1972.0,48,21,43,112
35505,West Germany,1972.0,48,21,43,112
35506,West Germany,1984.0,33,76,57,166
35507,West Germany,1988.0,36,44,49,129
35508,West Germany,1984.0,33,76,57,166
35509,West Germany,1976.0,23,32,55,110
35510,West Germany,1976.0,23,32,55,110
35511,West Germany-1,1984.0,33,76,57,166
35512,West Germany,1984.0,33,76,57,166
35513,West Germany,1976.0,23,32,55,110
35514,West Germany,1988.0,36,44,49,129
35515,West Germany,1968.0,19,19,23,61
35516,West Germany,1984.0,33,76,57,166
35517,West Germany,1984.0,33,76,57,166
35518,West Germany,1988.0,36,44,49,129
35519,West Germany,1972.0,48,21,43,112
35520,West Germany,1980.0,0,2,6,8
35521,West Germany,1980.0,0,2,6,8
35522,West Germany,1968.0,19,19,23,61
35523,West Germany,1972.0,48,21,43,112
35524,West Germany,1976.0,23,32,55,110
35525,West Germany-1,1968.0,19,19,23,61
35526,West Germany,1968.0,19,19,23,61
35527,West Germany,1972.0,48,21,43,112
35528,West Germany,1972.0,48,21,43,112
35529,West Germany,1984.0,33,76,57,166
35530,West Germany,1988.0,36,44,49,129
35531,West Germany,1972.0,48,21,43,112
35532,West Germany,1972.0,48,21,43,112
35533,West Germany,1984.0,33,76,57,166
35534,West Germany,1988.0,36,44,49,129
35535,West Germany,1988.0,36,44,49,129
35536,West Germany,1988.0,36,44,49,129
35537,West Germany,1984.0,33,76,57,166
35538,West Germany-2,1972.0,48,21,43,112
35539,West Germany-1,1972.0,48,21,43,112
35540,West Germany-1,1976.0,23,32,55,110
35541,West Germany-1,1976.0,23,32,55,110
35542,West Germany,1968.0,19,19,23,61
35543,West Germany,1984.0,33,76,57,166
35544,West Germany,1984.0,33,76,57,166
35545,Armenia,2012.0,0,1,2,3
35546,Armenia,2016.0,1,3,0,4
35547,Armenia,2008.0,0,0,6,6
35548,Armenia,2016.0,1,3,0,4
35549,Armenia,2008.0,0,0,6,6
35550,Armenia,2008.0,0,0,6,6
35551,Armenia,2012.0,0,1,2,3
35552,Armenia,2012.0,0,1,2,3
35553,Armenia,2016.0,1,3,0,4
35554,Armenia,2008.0,0,0,6,6
35555,Armenia,2008.0,0,0,6,6
35556,Armenia,2000.0,0,0,1,1
35557,Armenia,2016.0,1,3,0,4
35558,Armenia,1996.0,1,1,0,2
35559,Armenia,1996.0,1,1,0,2
35560,Armenia,2008.0,0,0,6,6
35561,Serbia,2012.0,1,1,14,16
35562,Serbia,2016.0,14,27,13,54
35563,Serbia,2016.0,14,27,13,54
35564,Serbia,2016.0,14,27,13,54
35565,Serbia,2016.0,14,27,13,54
35566,Serbia,2016.0,14,27,13,54
35567,Serbia,2016.0,14,27,13,54
35568,Serbia,2016.0,14,27,13,54
35569,Serbia,2016.0,14,27,13,54
35570,Serbia,2008.0,0,1,14,15
35571,Serbia,2016.0,14,27,13,54
35572,Serbia,2008.0,0,1,14,15
35573,Serbia,2016.0,14,27,13,54
35574,Serbia,2016.0,14,27,13,54
35575,Serbia,2016.0,14,27,13,54
35576,Serbia,2016.0,14,27,13,54
35577,Serbia,2008.0,0,1,14,15
35578,Serbia,2008.0,0,1,14,15
35579,Serbia,2012.0,1,1,14,16
35580,Serbia,2016.0,14,27,13,54
35581,Serbia,2008.0,0,1,14,15
35582,Serbia,2012.0,1,1,14,16
35583,Serbia,2016.0,14,27,13,54
35584,Serbia,2016.0,14,27,13,54
35585,Serbia,2016.0,14,27,13,54
35586,Serbia,2016.0,14,27,13,54
35587,Serbia,2016.0,14,27,13,54
35588,Serbia,2016.0,14,27,13,54
35589,Serbia,2016.0,14,27,13,54
35590,Serbia,2016.0,14,27,13,54
35591,Serbia,2012.0,1,1,14,16
35592,Serbia,2016.0,14,27,13,54
35593,Serbia,2012.0,1,1,14,16
35594,Serbia,2016.0,14,27,13,54
35595,Serbia,2012.0,1,1,14,16
35596,Serbia,2016.0,14,27,13,54
35597,Serbia,2016.0,14,27,13,54
35598,Serbia,2016.0,14,27,13,54
35599,Serbia,2016.0,14,27,13,54
35600,Serbia,2012.0,1,1,14,16
35601,Serbia,2016.0,14,27,13,54
35602,Serbia,2016.0,14,27,13,54
35603,Serbia,2012.0,1,1,14,16
35604,Serbia,2016.0,14,27,13,54
35605,Serbia,2016.0,14,27,13,54
35606,Serbia,2016.0,14,27,13,54
35607,Serbia,2016.0,14,27,13,54
35608,Serbia,2008.0,0,1,14,15
35609,Serbia,2016.0,14,27,13,54
35610,Serbia,2008.0,0,1,14,15
35611,Serbia,2012.0,1,1,14,16
35612,Serbia,2016.0,14,27,13,54
35613,Serbia,2012.0,1,1,14,16
35614,Serbia,2016.0,14,27,13,54
35615,Serbia,2016.0,14,27,13,54
35616,Serbia,2008.0,0,1,14,15
35617,Serbia,2012.0,1,1,14,16
35618,Serbia,2016.0,14,27,13,54
35619,Serbia,2016.0,14,27,13,54
35620,Serbia,2016.0,14,27,13,54
35621,Serbia,2016.0,14,27,13,54
35622,Serbia,2016.0,14,27,13,54
35623,Serbia,2008.0,0,1,14,15
35624,Serbia,2012.0,1,1,14,16
35625,Serbia,2008.0,0,1,14,15
35626,Serbia,2012.0,1,1,14,16
35627,Serbia,2008.0,0,1,14,15
35628,Serbia,2008.0,0,1,14,15
35629,Serbia,2016.0,14,27,13,54
35630,Serbia,2008.0,0,1,14,15
35631,Serbia,2012.0,1,1,14,16
35632,Serbia,2016.0,14,27,13,54
35633,Serbia,2016.0,14,27,13,54
35634,Serbia,2016.0,14,27,13,54
35635,Serbia,2016.0,14,27,13,54
35636,Serbia,2016.0,14,27,13,54
35637,Serbia,2016.0,14,27,13,54
35638,Serbia,2016.0,14,27,13,54
35639,Serbia,2008.0,0,1,14,15
35640,Serbia,2012.0,1,1,14,16
35641,Serbia,2016.0,14,27,13,54
35642,Serbia,2008.0,0,1,14,15
35643,Serbia,2016.0,14,27,13,54
35644,Serbia,2012.0,1,1,14,16
35645,Serbia,2016.0,14,27,13,54
35646,Niger,2016.0,0,1,0,1
35647,Niger,1972.0,0,0,1,1
35648,India,1928.0,14,0,0,14
35649,India,1964.0,15,0,0,15
35650,India,1928.0,14,0,0,14
35651,India,1932.0,15,0,0,15
35652,India,1936.0,19,0,0,19
35653,India,1960.0,0,13,0,13
35654,India,1932.0,15,0,0,15
35655,India,1980.0,16,0,0,16
35656,India,1972.0,0,0,14,14
35657,India,2008.0,1,0,2,3
35658,India,1932.0,15,0,0,15
35659,India,1932.0,15,0,0,15
35660,India,1932.0,15,0,0,15
35661,India,1928.0,14,0,0,14
35662,India,1932.0,15,0,0,15
35663,India,1936.0,19,0,0,19
35664,India,1980.0,16,0,0,16
35665,India,1968.0,0,0,16,16
35666,India,1948.0,20,0,0,20
35667,India,1952.0,14,0,1,15
35668,India,1956.0,17,0,0,17
35669,India,1960.0,0,13,0,13
35670,India,1972.0,0,0,14,14
35671,India,1952.0,14,0,1,15
35672,India,1936.0,19,0,0,19
35673,India,1948.0,20,0,0,20
35674,India,1952.0,14,0,1,15
35675,India,1948.0,20,0,0,20
35676,India,1952.0,14,0,1,15
35677,India,2012.0,0,2,4,6
35678,India,1936.0,19,0,0,19
35679,India,1948.0,20,0,0,20
35680,India,1936.0,19,0,0,19
35681,India,1980.0,16,0,0,16
35682,India,1948.0,20,0,0,20
35683,India,1952.0,14,0,1,15
35684,India,1956.0,17,0,0,17
35685,India,1972.0,0,0,14,14
35686,India,1936.0,19,0,0,19
35687,India,1928.0,14,0,0,14
35688,India,1948.0,20,0,0,20
35689,India,1936.0,19,0,0,19
35690,India,1928.0,14,0,0,14
35691,India,1928.0,14,0,0,14
35692,India,1932.0,15,0,0,15
35693,India,1932.0,15,0,0,15
35694,India,1948.0,20,0,0,20
35695,India,1936.0,19,0,0,19
35696,India,1980.0,16,0,0,16
35697,India,1952.0,14,0,1,15
35698,India,1932.0,15,0,0,15
35699,India,1936.0,19,0,0,19
35700,India,1948.0,20,0,0,20
35701,India,1956.0,17,0,0,17
35702,India,1964.0,15,0,0,15
35703,India,1980.0,16,0,0,16
35704,India,1936.0,19,0,0,19
35705,India,1936.0,19,0,0,19
35706,India,1928.0,14,0,0,14
35707,India,1972.0,0,0,14,14
35708,India,2012.0,0,2,4,6
35709,India,1948.0,20,0,0,20
35710,India,1956.0,17,0,0,17
35711,India,1972.0,0,0,14,14
35712,India,1980.0,16,0,0,16
35713,India,2008.0,1,0,2,3
35714,India,2012.0,0,2,4,6
35715,India,2012.0,0,2,4,6
35716,India,1948.0,20,0,0,20
35717,India,1960.0,0,13,0,13
35718,India,1964.0,15,0,0,15
35719,India,1952.0,14,0,1,15
35720,India,1956.0,17,0,0,17
35721,India,1956.0,17,0,0,17
35722,India,1960.0,0,13,0,13
35723,India,1964.0,15,0,0,15
35724,India,2016.0,0,1,1,2
35725,India,2000.0,0,0,1,1
35726,India,1980.0,16,0,0,16
35727,India,1928.0,14,0,0,14
35728,India,1936.0,19,0,0,19
35729,India,1936.0,19,0,0,19
35730,India,1932.0,15,0,0,15
35731,India,1972.0,0,0,14,14
35732,India,2012.0,0,2,4,6
35733,India,2012.0,0,2,4,6
35734,India,1936.0,19,0,0,19
35735,India,1928.0,14,0,0,14
35736,India,1996.0,0,0,1,1
35737,India,1964.0,15,0,0,15
35738,India,1952.0,14,0,1,15
35739,India,1956.0,17,0,0,17
35740,India,1968.0,0,0,16,16
35741,India,1972.0,0,0,14,14
35742,India,1960.0,0,13,0,13
35743,India,1964.0,15,0,0,15
35744,India,1968.0,0,0,16,16
35745,India,1936.0,19,0,0,19
35746,India,1928.0,14,0,0,14
35747,India,1932.0,15,0,0,15
35748,India,1948.0,20,0,0,20
35749,India,1900.0,0,2,0,2
35750,India,1900.0,0,2,0,2
35751,India,1968.0,0,0,16,16
35752,India,1952.0,14,0,1,15
35753,India,1948.0,20,0,0,20
35754,India,1980.0,16,0,0,16
35755,India,2004.0,0,1,0,1
35756,India,1948.0,20,0,0,20
35757,India,1928.0,14,0,0,14
35758,India,1948.0,20,0,0,20
35759,India,1968.0,0,0,16,16
35760,India,1960.0,0,13,0,13
35761,India,1980.0,16,0,0,16
35762,India,1928.0,14,0,0,14
35763,India,1936.0,19,0,0,19
35764,India,1980.0,16,0,0,16
35765,India,1960.0,0,13,0,13
35766,India,1924.0,7,0,0,7
35767,India,1924.0,7,0,0,7
35768,India,1924.0,7,0,0,7
35769,India,1924.0,7,0,0,7
35770,India,1924.0,7,0,0,7
35771,India,1924.0,7,0,0,7
35772,India,1924.0,7,0,0,7
35773,India,2016.0,0,1,1,2
35774,India,1968.0,0,0,16,16
35775,India,1972.0,0,0,14,14
35776,India,1956.0,17,0,0,17
35777,India,1968.0,0,0,16,16
35778,India,1968.0,0,0,16,16
35779,India,1968.0,0,0,16,16
35780,India,1956.0,17,0,0,17
35781,India,1960.0,0,13,0,13
35782,India,1964.0,15,0,0,15
35783,India,1964.0,15,0,0,15
35784,India,1980.0,16,0,0,16
35785,India,1964.0,15,0,0,15
35786,India,1948.0,20,0,0,20
35787,India,1952.0,14,0,1,15
35788,India,1960.0,0,13,0,13
35789,India,1964.0,15,0,0,15
35790,India,1968.0,0,0,16,16
35791,India,1964.0,15,0,0,15
35792,India,1968.0,0,0,16,16
35793,India,1956.0,17,0,0,17
35794,India,1980.0,16,0,0,16
35795,India,1932.0,15,0,0,15
35796,India,1964.0,15,0,0,15
35797,India,1968.0,0,0,16,16
35798,India,1972.0,0,0,14,14
35799,India,1972.0,0,0,14,14
35800,India,1956.0,17,0,0,17
35801,India,1968.0,0,0,16,16
35802,India,1972.0,0,0,14,14
35803,India,1964.0,15,0,0,15
35804,India,1968.0,0,0,16,16
35805,India,1928.0,14,0,0,14
35806,India,1960.0,0,13,0,13
35807,India,1972.0,0,0,14,14
35808,India,1948.0,20,0,0,20
35809,India,1952.0,14,0,1,15
35810,India,1972.0,0,0,14,14
35811,India,1960.0,0,13,0,13
35812,India,1964.0,15,0,0,15
35813,India,1968.0,0,0,16,16
35814,India,1980.0,16,0,0,16
35815,India,1980.0,16,0,0,16
35816,India,1932.0,15,0,0,15
35817,India,1936.0,19,0,0,19
35818,India,1968.0,0,0,16,16
35819,India,1952.0,14,0,1,15
35820,India,1956.0,17,0,0,17
35821,India,1960.0,0,13,0,13
35822,India,1964.0,15,0,0,15
35823,India,1972.0,0,0,14,14
35824,India,2008.0,1,0,2,3
35825,India,1956.0,17,0,0,17
35826,India,1948.0,20,0,0,20
35827,India,1956.0,17,0,0,17
35828,India,1960.0,0,13,0,13
35829,India,1948.0,20,0,0,20
35830,India,1952.0,14,0,1,15
35831,India,1956.0,17,0,0,17
35832,India,1952.0,14,0,1,15
35833,India,1936.0,19,0,0,19
35834,India,1980.0,16,0,0,16
35835,India,1948.0,20,0,0,20
35836,India,1952.0,14,0,1,15
35837,India,1956.0,17,0,0,17
35838,India,1956.0,17,0,0,17
35839,India,1932.0,15,0,0,15
35840,India,1980.0,16,0,0,16
35841,India,1932.0,15,0,0,15
35842,India,1936.0,19,0,0,19
35843,India,1948.0,20,0,0,20
35844,India,1928.0,14,0,0,14
35845,Belgium,1920.0,57,65,66,188
35846,Belgium,1920.0,57,65,66,188
35847,Belgium,1920.0,57,65,66,188
35848,Belgium,1912.0,7,1,11,19
35849,Belgium,1908.0,1,24,8,33
35850,Belgium,1912.0,7,1,11,19
35851,Belgium,1912.0,7,1,11,19
35852,Belgium,1920.0,57,65,66,188
35853,Belgium,1924.0,3,30,11,44
35854,Belgium,1928.0,0,1,5,6
35855,Belgium,1920.0,57,65,66,188
35856,Belgium,1920.0,57,65,66,188
35857,Belgium,1952.0,5,3,0,8
35858,Belgium,1920.0,57,65,66,188
35859,Belgium,1920.0,57,65,66,188
35860,Belgium,1920.0,57,65,66,188
35861,Belgium,1948.0,7,6,8,21
35862,Belgium,1920.0,57,65,66,188
35863,Belgium,1908.0,1,24,8,33
35864,Belgium,1924.0,3,30,11,44
35865,Belgium,1920.0,57,65,66,188
35866,Belgium,1924.0,3,30,11,44
35867,Belgium,1924.0,3,30,11,44
35868,Belgium,1920.0,57,65,66,188
35869,Belgium,1920.0,57,65,66,188
35870,Belgium,1920.0,57,65,66,188
35871,Belgium,1924.0,3,30,11,44
35872,Belgium,1936.0,0,0,14,14
35873,Belgium,1920.0,57,65,66,188
35874,Belgium,1924.0,3,30,11,44
35875,Belgium,2016.0,2,17,2,21
35876,Belgium,1908.0,1,24,8,33
35877,Belgium,1912.0,7,1,11,19
35878,Belgium,1920.0,57,65,66,188
35879,Belgium,1920.0,57,65,66,188
35880,Belgium,2016.0,2,17,2,21
35881,Belgium,2008.0,1,4,0,5
35882,Belgium,1908.0,1,24,8,33
35883,Belgium,1920.0,57,65,66,188
35884,Belgium,1920.0,57,65,66,188
35885,Belgium,1920.0,57,65,66,188
35886,Belgium,1920.0,57,65,66,188
35887,Belgium,1920.0,57,65,66,188
35888,Belgium,1992.0,0,1,2,3
35889,Belgium,2016.0,2,17,2,21
35890,Belgium,1920.0,57,65,66,188
35891,Belgium,1948.0,7,6,8,21
35892,Royal Club Nautique de Gand,1900.0,6,24,13,43
35893,Edelweiss II-1,1920.0,57,65,66,188
35894,Belgium,2000.0,0,3,4,7
35895,Belgium,1936.0,0,0,14,14
35896,Belgium,2016.0,2,17,2,21
35897,Belgium,1920.0,57,65,66,188
35898,Belgium,1920.0,57,65,66,188
35899,Belgium,1920.0,57,65,66,188
35900,Belgium,1920.0,57,65,66,188
35901,Belgium,1920.0,57,65,66,188
35902,Belgium,1920.0,57,65,66,188
35903,Belgium,1920.0,57,65,66,188
35904,Belgium,1906.0,2,3,6,11
35905,Belgium,1924.0,3,30,11,44
35906,Belgium,1920.0,57,65,66,188
35907,Brussels Swimming and Water Polo Club,1900.0,6,24,13,43
35908,Belgium,1920.0,57,65,66,188
35909,Belgium,1920.0,57,65,66,188
35910,Belgium,1920.0,57,65,66,188
35911,Belgium,1936.0,0,0,14,14
35912,Edelweiss II-1,1920.0,57,65,66,188
35913,Edelweiss II-1,1920.0,57,65,66,188
35914,Belgium,2016.0,2,17,2,21
35915,Belgium,1920.0,57,65,66,188
35916,Belgium,1912.0,7,1,11,19
35917,Belgium,2012.0,0,1,2,3
35918,Belgium,1924.0,3,30,11,44
35919,Belgium,1906.0,2,3,6,11
35920,Belgium,1984.0,1,2,2,5
35921,Belgium,1976.0,0,3,6,9
35922,Belgium,1924.0,3,30,11,44
35923,Belgium,1920.0,57,65,66,188
35924,Belgium,1920.0,57,65,66,188
35925,Brussels Swimming and Water Polo Club,1900.0,6,24,13,43
35926,Brussels Swimming and Water Polo Club,1900.0,6,24,13,43
35927,Belgium,1920.0,57,65,66,188
35928,Royal Club Nautique de Gand,1900.0,6,24,13,43
35929,Belgium,1912.0,7,1,11,19
35930,Belgium,1948.0,7,6,8,21
35931,Belgium,1920.0,57,65,66,188
35932,Royal Club Nautique de Gand,1900.0,6,24,13,43
35933,Belgium,1924.0,3,30,11,44
35934,Belgium,1924.0,3,30,11,44
35935,Belgium,1936.0,0,0,14,14
35936,Belgium,1928.0,0,1,5,6
35937,Belgium,1920.0,57,65,66,188
35938,Belgium,1924.0,3,30,11,44
35939,Belgium,1920.0,57,65,66,188
35940,Belgium,1920.0,57,65,66,188
35941,Belgium,1920.0,57,65,66,188
35942,Belgium,1920.0,57,65,66,188
35943,Belgium,1920.0,57,65,66,188
35944,Belgium,1920.0,57,65,66,188
35945,Antwerpia V,1920.0,57,65,66,188
35946,Belgium,1948.0,7,6,8,21
35947,Belgium,1920.0,57,65,66,188
35948,Belgium,1920.0,57,65,66,188
35949,Belgium,1920.0,57,65,66,188
35950,Belgium,1906.0,2,3,6,11
35951,Belgium,1908.0,1,24,8,33
35952,Belgium,1920.0,57,65,66,188
35953,Belgium,1924.0,3,30,11,44
35954,Belgium,1924.0,3,30,11,44
35955,Belgium,1936.0,0,0,14,14
35956,Belgium,1924.0,3,30,11,44
35957,Royal Club Nautique de Gand,1900.0,6,24,13,43
35958,Royal Club Nautique de Gand,1908.0,1,24,8,33
35959,Belgium,2000.0,0,3,4,7
35960,Belgium,1906.0,2,3,6,11
35961,Belgium,1996.0,2,2,2,6
35962,Belgium,1920.0,57,65,66,188
35963,Belgium,1924.0,3,30,11,44
35964,Univ. of Brussels,1900.0,6,24,13,43
35965,Belgium,1920.0,57,65,66,188
35966,Belgium,1920.0,57,65,66,188
35967,Belgium,1920.0,57,65,66,188
35968,Belgium,1920.0,57,65,66,188
35969,Belgium,1920.0,57,65,66,188
35970,Belgium,1984.0,1,2,2,5
35971,Belgium,1924.0,3,30,11,44
35972,Belgium,1924.0,3,30,11,44
35973,Belgium,2016.0,2,17,2,21
35974,Belgium,1920.0,57,65,66,188
35975,Belgium,1924.0,3,30,11,44
35976,Belgium,2016.0,2,17,2,21
35977,Belgium,1920.0,57,65,66,188
35978,Belgium,1936.0,0,0,14,14
35979,Belgium,1920.0,57,65,66,188
35980,Belgium,2016.0,2,17,2,21
35981,Belgium,2016.0,2,17,2,21
35982,Belgium,1908.0,1,24,8,33
35983,Belgium,1912.0,7,1,11,19
35984,Belgium,1900.0,6,24,13,43
35985,Belgium,1906.0,2,3,6,11
35986,Belgium,1920.0,57,65,66,188
35987,Belgium,1920.0,57,65,66,188
35988,Belgium,1936.0,0,0,14,14
35989,Belgium,1920.0,57,65,66,188
35990,Belgium,1906.0,2,3,6,11
35991,Belgium,1912.0,7,1,11,19
35992,Belgium,1920.0,57,65,66,188
35993,Belgium,1924.0,3,30,11,44
35994,Belgium,1920.0,57,65,66,188
35995,Belgium,1908.0,1,24,8,33
35996,Belgium,1920.0,57,65,66,188
35997,Brussels Swimming and Water Polo Club,1900.0,6,24,13,43
35998,Belgium,1908.0,1,24,8,33
35999,Belgium,1908.0,1,24,8,33
36000,Belgium,1920.0,57,65,66,188
36001,Belgium,1920.0,57,65,66,188
36002,Belgium,1920.0,57,65,66,188
36003,Belgium,1920.0,57,65,66,188
36004,Belgium,1920.0,57,65,66,188
36005,Belgium,1920.0,57,65,66,188
36006,Belgium,1920.0,57,65,66,188
36007,Belgium,1920.0,57,65,66,188
36008,Belgium,1920.0,57,65,66,188
36009,Belgium,1920.0,57,65,66,188
36010,Belgium,1928.0,0,1,5,6
36011,Belgium,1924.0,3,30,11,44
36012,Belgium,1900.0,6,24,13,43
36013,Belgium,1948.0,7,6,8,21
36014,Belgium,1920.0,57,65,66,188
36015,Belgium,1924.0,3,30,11,44
36016,Belgium,1936.0,0,0,14,14
36017,Belgium,1920.0,57,65,66,188
36018,Belgium,2008.0,1,4,0,5
36019,Belgium,1920.0,57,65,66,188
36020,Belgium,1924.0,3,30,11,44
36021,Belgium,1920.0,57,65,66,188
36022,Belgium,1920.0,57,65,66,188
36023,Belgium,2000.0,0,3,4,7
36024,Belgium,1900.0,6,24,13,43
36025,Belgium,1920.0,57,65,66,188
36026,Belgium,1920.0,57,65,66,188
36027,Belgium,1996.0,2,2,2,6
36028,Belgium,1964.0,2,0,1,3
36029,Belgium,1920.0,57,65,66,188
36030,Belgium,1968.0,0,1,2,3
36031,Belgium,1920.0,57,65,66,188
36032,Belgium,2016.0,2,17,2,21
36033,Brussels Swimming and Water Polo Club,1900.0,6,24,13,43
36034,Belgium,1908.0,1,24,8,33
36035,Belgium,1912.0,7,1,11,19
36036,Antwerpia V,1920.0,57,65,66,188
36037,Belgium,1952.0,5,3,0,8
36038,Belgium,1952.0,5,3,0,8
36039,Belgium,1900.0,6,24,13,43
36040,Belgium,1900.0,6,24,13,43
36041,Belgium,1920.0,57,65,66,188
36042,Belgium,1984.0,1,2,2,5
36043,Belgium,1920.0,57,65,66,188
36044,Belgium,1920.0,57,65,66,188
36045,Belgium,1920.0,57,65,66,188
36046,Belgium,2008.0,1,4,0,5
36047,Antwerpia V,1920.0,57,65,66,188
36048,Royal Club Nautique de Gand,1900.0,6,24,13,43
36049,Belgium,1920.0,57,65,66,188
36050,Belgium,2004.0,1,0,2,3
36051,Belgium,1912.0,7,1,11,19
36052,Belgium,1920.0,57,65,66,188
36053,Belgium,1920.0,57,65,66,188
36054,Belgium,1920.0,57,65,66,188
36055,Belgium,2004.0,1,0,2,3
36056,Belgium,1924.0,3,30,11,44
36057,Belgium,1924.0,3,30,11,44
36058,Belgium,1924.0,3,30,11,44
36059,Belgium,1912.0,7,1,11,19
36060,Belgium,1920.0,57,65,66,188
36061,Belgium,1948.0,7,6,8,21
36062,Zut,1908.0,1,24,8,33
36063,Tan-Fe-Pah,1920.0,57,65,66,188
36064,Belgium,1924.0,3,30,11,44
36065,Zut,1908.0,1,24,8,33
36066,Belgium,1984.0,1,2,2,5
36067,Belgium,1936.0,0,0,14,14
36068,Belgium,1920.0,57,65,66,188
36069,Belgium,1920.0,57,65,66,188
36070,Univ. of Brussels,1900.0,6,24,13,43
36071,Belgium,1920.0,57,65,66,188
36072,Belgium,1920.0,57,65,66,188
36073,Tan-Fe-Pah,1920.0,57,65,66,188
36074,Belgium,1952.0,5,3,0,8
36075,Belgium,1920.0,57,65,66,188
36076,Belgium,1920.0,57,65,66,188
36077,Belgium,1920.0,57,65,66,188
36078,Belgium,1920.0,57,65,66,188
36079,Belgium,1920.0,57,65,66,188
36080,Belgium,1948.0,7,6,8,21
36081,Belgium,1920.0,57,65,66,188
36082,Belgium,1906.0,2,3,6,11
36083,Belgium,1912.0,7,1,11,19
36084,Belgium,1920.0,57,65,66,188
36085,Univ. of Brussels,1900.0,6,24,13,43
36086,Belgium,1984.0,1,2,2,5
36087,Belgium,1948.0,7,6,8,21
36088,Belgium,1920.0,57,65,66,188
36089,Belgium,1972.0,0,2,0,2
36090,Belgium,1976.0,0,3,6,9
36091,Belgium,1920.0,57,65,66,188
36092,Belgium,1996.0,2,2,2,6
36093,Univ. of Brussels,1900.0,6,24,13,43
36094,Belgium,1920.0,57,65,66,188
36095,Belgium,1936.0,0,0,14,14
36096,Belgium,2016.0,2,17,2,21
36097,Belgium,1920.0,57,65,66,188
36098,Belgium,1920.0,57,65,66,188
36099,Belgium,1948.0,7,6,8,21
36100,Belgium,2008.0,1,4,0,5
36101,Belgium,1992.0,0,1,2,3
36102,Belgium,1976.0,0,3,6,9
36103,Belgium,1976.0,0,3,6,9
36104,Belgium,2000.0,0,3,4,7
36105,Belgium,2004.0,1,0,2,3
36106,Belgium,1956.0,0,2,0,2
36107,Belgium,1908.0,1,24,8,33
36108,Belgium,1912.0,7,1,11,19
36109,Brussels Swimming and Water Polo Club,1900.0,6,24,13,43
36110,Belgium,1908.0,1,24,8,33
36111,Belgium,1936.0,0,0,14,14
36112,Belgium,1920.0,57,65,66,188
36113,Belgium,1960.0,0,2,2,4
36114,Belgium,1920.0,57,65,66,188
36115,Belgium,1920.0,57,65,66,188
36116,Belgium,1920.0,57,65,66,188
36117,Univ. of Brussels,1900.0,6,24,13,43
36118,Royal Club Nautique de Gand,1908.0,1,24,8,33
36119,Belgium-1,1924.0,3,30,11,44
36120,Belgium,1948.0,7,6,8,21
36121,Belgium-1,1924.0,3,30,11,44
36122,Belgium,1920.0,57,65,66,188
36123,Royal Club Nautique de Gand,1908.0,1,24,8,33
36124,Belgium-1,1900.0,6,24,13,43
36125,Univ. of Brussels,1900.0,6,24,13,43
36126,Belgium,1956.0,0,2,0,2
36127,Belgium,1960.0,0,2,2,4
36128,Belgium,1948.0,7,6,8,21
36129,Belgium,1948.0,7,6,8,21
36130,Belgium,1912.0,7,1,11,19
36131,Belgium,1920.0,57,65,66,188
36132,Belgium,1920.0,57,65,66,188
36133,Belgium,1952.0,5,3,0,8
36134,Belgium,1952.0,5,3,0,8
36135,Belgium,1912.0,7,1,11,19
36136,Royal Club Nautique de Gand,1900.0,6,24,13,43
36137,Belgium,1924.0,3,30,11,44
36138,Royal Club Nautique de Gand,1906.0,2,3,6,11
36139,Royal Club Nautique de Gand,1906.0,2,3,6,11
36140,Royal Club Nautique de Gand,1908.0,1,24,8,33
36141,Belgium,1920.0,57,65,66,188
36142,Belgium,2008.0,1,4,0,5
36143,Belgium,1920.0,57,65,66,188
36144,Belgium,1924.0,3,30,11,44
36145,Belgium,1948.0,7,6,8,21
36146,Belgium,1900.0,6,24,13,43
36147,Belgium,1908.0,1,24,8,33
36148,Belgium,1988.0,0,0,2,2
36149,Univ. of Brussels,1900.0,6,24,13,43
36150,Belgium,1920.0,57,65,66,188
36151,Belgium,1920.0,57,65,66,188
36152,Belgium,1920.0,57,65,66,188
36153,Belgium,1920.0,57,65,66,188
36154,Belgium,1920.0,57,65,66,188
36155,Belgium,1908.0,1,24,8,33
36156,Belgium,1912.0,7,1,11,19
36157,Belgium,1920.0,57,65,66,188
36158,Belgium,1924.0,3,30,11,44
36159,Belgium,1920.0,57,65,66,188
36160,Royal Club Nautique de Gand,1908.0,1,24,8,33
36161,Belgium,1972.0,0,2,0,2
36162,Belgium,1936.0,0,0,14,14
36163,Belgium,1920.0,57,65,66,188
36164,Belgium,1992.0,0,1,2,3
36165,Belgium,1968.0,0,1,2,3
36166,Belgium,1948.0,7,6,8,21
36167,Univ. of Brussels,1900.0,6,24,13,43
36168,Belgium,1964.0,2,0,1,3
36169,Belgium,1908.0,1,24,8,33
36170,Brussels Swimming and Water Polo Club,1900.0,6,24,13,43
36171,Belgium,1920.0,57,65,66,188
36172,Belgium,1924.0,3,30,11,44
36173,Belgium,1924.0,3,30,11,44
36174,Belgium,1912.0,7,1,11,19
36175,Belgium,1964.0,2,0,1,3
36176,Brussels Swimming and Water Polo Club,1900.0,6,24,13,43
36177,Belgium,2000.0,0,3,4,7
36178,Belgium,1920.0,57,65,66,188
36179,Brussels Swimming and Water Polo Club,1900.0,6,24,13,43
36180,Univ. of Brussels,1900.0,6,24,13,43
36181,Belgium,1928.0,0,1,5,6
36182,Antwerpia V,1920.0,57,65,66,188
36183,Belgium,1960.0,0,2,2,4
36184,Belgium,1928.0,0,1,5,6
36185,Belgium,2016.0,2,17,2,21
36186,Belgium,1936.0,0,0,14,14
36187,Belgium,1920.0,57,65,66,188
36188,Belgium,1908.0,1,24,8,33
36189,Belgium,1908.0,1,24,8,33
36190,Belgium,1920.0,57,65,66,188
36191,Belgium,1920.0,57,65,66,188
36192,Royal Club Nautique de Gand,1908.0,1,24,8,33
36193,Belgium,1920.0,57,65,66,188
36194,Belgium,2016.0,2,17,2,21
36195,Belgium,1920.0,57,65,66,188
36196,Belgium,1924.0,3,30,11,44
36197,Belgium,2016.0,2,17,2,21
36198,Belgium,1920.0,57,65,66,188
36199,Belgium,1924.0,3,30,11,44
36200,Belgium,2016.0,2,17,2,21
36201,Brussels Swimming and Water Polo Club,1900.0,6,24,13,43
36202,Belgium,1976.0,0,3,6,9
36203,Belgium,1948.0,7,6,8,21
36204,Belgium,1920.0,57,65,66,188
36205,Belgium,2012.0,0,1,2,3
36206,Belgium,1900.0,6,24,13,43
36207,Belgium,1908.0,1,24,8,33
36208,Belgium,1908.0,1,24,8,33
36209,Belgium,2016.0,2,17,2,21
36210,Belgium,2016.0,2,17,2,21
36211,Belgium,1996.0,2,2,2,6
36212,Belgium,1920.0,57,65,66,188
36213,Belgium,1920.0,57,65,66,188
36214,Belgium,1920.0,57,65,66,188
36215,Royal Club Nautique de Gand,1900.0,6,24,13,43
36216,Belgium,1976.0,0,3,6,9
36217,Belgium,1976.0,0,3,6,9
36218,Belgium,1924.0,3,30,11,44
36219,Belgium,1924.0,3,30,11,44
36220,Belgium,1920.0,57,65,66,188
36221,Belgium,1920.0,57,65,66,188
36222,Belgium,1920.0,57,65,66,188
36223,Belgium,1920.0,57,65,66,188
36224,Belgium,1920.0,57,65,66,188
36225,Belgium,1920.0,57,65,66,188
36226,Belgium,1980.0,1,0,0,1
36227,Belgium,1988.0,0,0,2,2
36228,Belgium,1948.0,7,6,8,21
36229,Belgium,1920.0,57,65,66,188
36230,Belgium,1924.0,3,30,11,44
36231,Belgium,1924.0,3,30,11,44
36232,Belgium,1920.0,57,65,66,188
36233,Belgium-1,1924.0,3,30,11,44
36234,Tan-Fe-Pah,1920.0,57,65,66,188
36235,Belgium,1936.0,0,0,14,14
36236,Belgium,1900.0,6,24,13,43
36237,Belgium,1900.0,6,24,13,43
36238,Belgium,2016.0,2,17,2,21
36239,Belgium,1920.0,57,65,66,188
36240,Belgium,1920.0,57,65,66,188
36241,Belgium,1920.0,57,65,66,188
36242,Belgium,1900.0,6,24,13,43
36243,Belgium,1900.0,6,24,13,43
36244,Belgium,1900.0,6,24,13,43
36245,Belgium,1900.0,6,24,13,43
36246,Belgium,1920.0,57,65,66,188
36247,Belgium,1920.0,57,65,66,188
36248,Belgium,1920.0,57,65,66,188
36249,Belgium,1920.0,57,65,66,188
36250,Belgium,1920.0,57,65,66,188
36251,Belgium,1920.0,57,65,66,188
36252,Belgium,1968.0,0,1,2,3
36253,Royal Club Nautique de Gand,1900.0,6,24,13,43
36254,Royal Club Nautique de Gand,1908.0,1,24,8,33
36255,Belgium,1900.0,6,24,13,43
36256,Belgium,1952.0,5,3,0,8
36257,Belgium,1920.0,57,65,66,188
36258,Belgium,1920.0,57,65,66,188
36259,Belgium,1920.0,57,65,66,188
36260,Belgium,1920.0,57,65,66,188
36261,Belgium,1920.0,57,65,66,188
36262,Belgium,1976.0,0,3,6,9
36263,Belgium,1920.0,57,65,66,188
36264,Belgium,1948.0,7,6,8,21
36265,Belgium,2000.0,0,3,4,7
36266,Belgium,2012.0,0,1,2,3
36267,Belgium,2016.0,2,17,2,21
36268,Belgium,1920.0,57,65,66,188
36269,Belgium,1920.0,57,65,66,188
36270,Belgium,1920.0,57,65,66,188
36271,Belgium,2016.0,2,17,2,21
36272,Belgium,1920.0,57,65,66,188
36273,Belgium,1928.0,0,1,5,6
36274,Belgium,2016.0,2,17,2,21
36275,Belgium,1996.0,2,2,2,6
36276,Belgium,2000.0,0,3,4,7
36277,Belgium,1960.0,0,2,2,4
36278,Royal Club Nautique de Gand,1908.0,1,24,8,33
36279,Belgium,1912.0,7,1,11,19
36280,Belgium,1998.0,0,0,1,1
36281,Belgium,1920.0,57,65,66,188
36282,Belgium,1932.0,0,0,1,1
36283,Belgium,1920.0,57,65,66,188
36284,Belgium,1920.0,57,65,66,188
36285,Belgium,1906.0,2,3,6,11
36286,Belgium,1906.0,2,3,6,11
36287,Belgium,1920.0,57,65,66,188
36288,Belgium,1920.0,57,65,66,188
36289,Royal Club Nautique de Gand,1900.0,6,24,13,43
36290,Royal Club Nautique de Gand,1908.0,1,24,8,33
36291,Belgium,1920.0,57,65,66,188
36292,Belgium,1924.0,3,30,11,44
36293,Belgium-1,1924.0,3,30,11,44
36294,Belgium,1920.0,57,65,66,188
36295,Belgium,1952.0,5,3,0,8
36296,Belgium,1948.0,7,6,8,21
36297,Belgium,1920.0,57,65,66,188
36298,Belgium,1920.0,57,65,66,188
36299,Belgium,1976.0,0,3,6,9
36300,Zut,1908.0,1,24,8,33
36301,Antwerpia V,1920.0,57,65,66,188
36302,Belgium,1908.0,1,24,8,33
36303,Belgium,1996.0,2,2,2,6
36304,Belgium-1,1924.0,3,30,11,44
36305,Belgium,1908.0,1,24,8,33
36306,Belgium,1912.0,7,1,11,19
36307,Belgium,1920.0,57,65,66,188
36308,Belgium,1948.0,7,6,8,21
36309,Belgium,1948.0,7,6,8,21
36310,Belgium,1920.0,57,65,66,188
36311,Belgium,1920.0,57,65,66,188
36312,Belgium,1948.0,7,6,8,21
36313,Algeria,2000.0,1,1,3,5
36314,Algeria,1996.0,2,0,1,3
36315,Algeria,2008.0,0,1,1,2
36316,Algeria,1992.0,1,0,1,2
36317,Algeria,2008.0,0,1,1,2
36318,Algeria,2000.0,1,1,3,5
36319,Algeria,2012.0,1,0,0,1
36320,Algeria,2016.0,0,2,0,2
36321,Algeria,2016.0,0,2,0,2
36322,Algeria,2000.0,1,1,3,5
36323,Algeria,1996.0,2,0,1,3
36324,Algeria,1984.0,0,0,2,2
36325,Algeria,2000.0,1,1,3,5
36326,Algeria,2000.0,1,1,3,5
36327,Algeria,1992.0,1,0,1,2
36328,Algeria,1996.0,2,0,1,3
36329,Algeria,1984.0,0,0,2,2
36330,Jamaica,2016.0,11,17,2,30
36331,Jamaica,2016.0,11,17,2,30
36332,Jamaica,2000.0,0,20,3,23
36333,Jamaica,2004.0,6,1,6,13
36334,Jamaica,2012.0,8,9,8,25
36335,Jamaica,2016.0,11,17,2,30
36336,Jamaica,1996.0,1,3,12,16
36337,Jamaica,2000.0,0,20,3,23
36338,Jamaica,1996.0,1,3,12,16
36339,Jamaica,2012.0,8,9,8,25
36340,Jamaica,2012.0,8,9,8,25
36341,Jamaica,2012.0,8,9,8,25
36342,Jamaica,2016.0,11,17,2,30
36343,Jamaica,2008.0,5,3,6,14
36344,Jamaica,2008.0,5,3,6,14
36345,Jamaica,2012.0,8,9,8,25
36346,Jamaica,2012.0,8,9,8,25
36347,Jamaica,2012.0,8,9,8,25
36348,Jamaica,2016.0,11,17,2,30
36349,Jamaica,2016.0,11,17,2,30
36350,Jamaica,2016.0,11,17,2,30
36351,Jamaica,2000.0,0,20,3,23
36352,Jamaica,2004.0,6,1,6,13
36353,Jamaica,1988.0,0,7,0,7
36354,Jamaica,2012.0,8,9,8,25
36355,Jamaica,1988.0,0,7,0,7
36356,Jamaica,2000.0,0,20,3,23
36357,Jamaica,2004.0,6,1,6,13
36358,Jamaica,2004.0,6,1,6,13
36359,Jamaica,2004.0,6,1,6,13
36360,Jamaica,2008.0,5,3,6,14
36361,Jamaica,2012.0,8,9,8,25
36362,Jamaica,2012.0,8,9,8,25
36363,Jamaica,2016.0,11,17,2,30
36364,Jamaica,2012.0,8,9,8,25
36365,Jamaica,1996.0,1,3,12,16
36366,Jamaica,1992.0,0,3,1,4
36367,Jamaica,1992.0,0,3,1,4
36368,Jamaica,1996.0,1,3,12,16
36369,Jamaica,1988.0,0,7,0,7
36370,Jamaica,2004.0,6,1,6,13
36371,Jamaica,2012.0,8,9,8,25
36372,Jamaica,2016.0,11,17,2,30
36373,Jamaica,2016.0,11,17,2,30
36374,Jamaica,1984.0,0,5,2,7
36375,Jamaica,2016.0,11,17,2,30
36376,Jamaica,2016.0,11,17,2,30
36377,Jamaica,2016.0,11,17,2,30
36378,Jamaica,2008.0,5,3,6,14
36379,Jamaica,2012.0,8,9,8,25
36380,Jamaica,2012.0,8,9,8,25
36381,Jamaica,2012.0,8,9,8,25
36382,Jamaica,2016.0,11,17,2,30
36383,Jamaica,2016.0,11,17,2,30
36384,Jamaica,2012.0,8,9,8,25
36385,Jamaica,2000.0,0,20,3,23
36386,Jamaica,1996.0,1,3,12,16
36387,Jamaica,2016.0,11,17,2,30
36388,Jamaica,2000.0,0,20,3,23
36389,Jamaica,2000.0,0,20,3,23
36390,Jamaica,1988.0,0,7,0,7
36391,Jamaica,1988.0,0,7,0,7
36392,Jamaica,1992.0,0,3,1,4
36393,Jamaica,1996.0,1,3,12,16
36394,Jamaica,2000.0,0,20,3,23
36395,Jamaica,2000.0,0,20,3,23
36396,Jamaica,1996.0,1,3,12,16
36397,Jamaica,2000.0,0,20,3,23
36398,Jamaica,2000.0,0,20,3,23
36399,Jamaica,2012.0,8,9,8,25
36400,Jamaica,2000.0,0,20,3,23
36401,Jamaica,2016.0,11,17,2,30
36402,Jamaica,2016.0,11,17,2,30
36403,Jamaica,1988.0,0,7,0,7
36404,Jamaica,1952.0,5,3,0,8
36405,Jamaica,1984.0,0,5,2,7
36406,Jamaica,2000.0,0,20,3,23
36407,Jamaica,2000.0,0,20,3,23
36408,Jamaica,2004.0,6,1,6,13
36409,Jamaica,1996.0,1,3,12,16
36410,Jamaica,2008.0,5,3,6,14
36411,Jamaica,2012.0,8,9,8,25
36412,Jamaica,1996.0,1,3,12,16
36413,Jamaica,2016.0,11,17,2,30
36414,Jamaica,2000.0,0,20,3,23
36415,Jamaica,2000.0,0,20,3,23
36416,Jamaica,2004.0,6,1,6,13
36417,Jamaica,1996.0,1,3,12,16
36418,Jamaica,2000.0,0,20,3,23
36419,Jamaica,2016.0,11,17,2,30
36420,Jamaica,2000.0,0,20,3,23
36421,Jamaica,2004.0,6,1,6,13
36422,Jamaica,1948.0,1,2,0,3
36423,Jamaica,1952.0,5,3,0,8
36424,Jamaica,1952.0,5,3,0,8
36425,Jamaica,1952.0,5,3,0,8
36426,Jamaica,2016.0,11,17,2,30
36427,Jamaica,2016.0,11,17,2,30
36428,Jamaica,2016.0,11,17,2,30
36429,Jamaica,1984.0,0,5,2,7
36430,Jamaica,1968.0,0,1,0,1
36431,Jamaica,1972.0,0,0,1,1
36432,Jamaica,2016.0,11,17,2,30
36433,Jamaica,1996.0,1,3,12,16
36434,Jamaica,1988.0,0,7,0,7
36435,Jamaica,1980.0,0,0,3,3
36436,Jamaica,1984.0,0,5,2,7
36437,Jamaica,1984.0,0,5,2,7
36438,Jamaica,1992.0,0,3,1,4
36439,Jamaica,1996.0,1,3,12,16
36440,Jamaica,1996.0,1,3,12,16
36441,Jamaica,1996.0,1,3,12,16
36442,Jamaica,2000.0,0,20,3,23
36443,Jamaica,2000.0,0,20,3,23
36444,Jamaica,2012.0,8,9,8,25
36445,Jamaica,2000.0,0,20,3,23
36446,Jamaica,2016.0,11,17,2,30
36447,Jamaica,1976.0,1,1,0,2
36448,Jamaica,1976.0,1,1,0,2
36449,Jamaica,1980.0,0,0,3,3
36450,Jamaica,1984.0,0,5,2,7
36451,Jamaica,1952.0,5,3,0,8
36452,Jamaica,1952.0,5,3,0,8
36453,Jamaica,2000.0,0,20,3,23
36454,Jamaica,2004.0,6,1,6,13
36455,Jamaica,1996.0,1,3,12,16
36456,Jamaica,1996.0,1,3,12,16
36457,Jamaica,2004.0,6,1,6,13
36458,Jamaica,2008.0,5,3,6,14
36459,Jamaica,2012.0,8,9,8,25
36460,Jamaica,2004.0,6,1,6,13
36461,Jamaica,2008.0,5,3,6,14
36462,Jamaica,2008.0,5,3,6,14
36463,Jamaica,2012.0,8,9,8,25
36464,Jamaica,1984.0,0,5,2,7
36465,Jamaica,2016.0,11,17,2,30
36466,Jamaica,2016.0,11,17,2,30
36467,Jamaica,2016.0,11,17,2,30
36468,Jamaica,2008.0,5,3,6,14
36469,Jamaica,2012.0,8,9,8,25
36470,Jamaica,1980.0,0,0,3,3
36471,Jamaica,2008.0,5,3,6,14
36472,Jamaica,2012.0,8,9,8,25
36473,Jamaica,2008.0,5,3,6,14
36474,Jamaica,2000.0,0,20,3,23
36475,Jamaica,2016.0,11,17,2,30
36476,Jamaica,2008.0,5,3,6,14
36477,Jamaica,2008.0,5,3,6,14
36478,Jamaica,2012.0,8,9,8,25
36479,Jamaica,2004.0,6,1,6,13
36480,Jamaica,2008.0,5,3,6,14
36481,Jamaica,2012.0,8,9,8,25
36482,Jamaica,2016.0,11,17,2,30
36483,Jamaica,1948.0,1,2,0,3
36484,Jamaica,1948.0,1,2,0,3
36485,Jamaica,1952.0,5,3,0,8
36486,Jamaica,1952.0,5,3,0,8
36487,Trinidad and Tobago,2012.0,1,4,5,10
36488,Trinidad and Tobago,2008.0,5,1,0,6
36489,Trinidad and Tobago,1964.0,0,1,5,6
36490,Trinidad and Tobago,2008.0,5,1,0,6
36491,Trinidad and Tobago,2012.0,1,4,5,10
36492,Trinidad and Tobago,1996.0,0,0,2,2
36493,Trinidad and Tobago,1996.0,0,0,2,2
36494,Trinidad and Tobago,2000.0,0,1,1,2
36495,Trinidad and Tobago,2000.0,0,1,1,2
36496,Trinidad and Tobago,2004.0,0,0,1,1
36497,Trinidad and Tobago,2008.0,5,1,0,6
36498,Trinidad and Tobago,2012.0,1,4,5,10
36499,Trinidad and Tobago,2008.0,5,1,0,6
36500,Trinidad and Tobago,2012.0,1,4,5,10
36501,Trinidad and Tobago,1976.0,1,0,0,1
36502,Trinidad and Tobago,2012.0,1,4,5,10
36503,Trinidad and Tobago,2012.0,1,4,5,10
36504,Trinidad and Tobago,1952.0,0,0,2,2
36505,Trinidad and Tobago,2012.0,1,4,5,10
36506,Trinidad and Tobago,1964.0,0,1,5,6
36507,Trinidad and Tobago,1964.0,0,1,5,6
36508,Trinidad and Tobago,1964.0,0,1,5,6
36509,Trinidad and Tobago,1964.0,0,1,5,6
36510,Trinidad and Tobago,1964.0,0,1,5,6
36511,Trinidad and Tobago,2012.0,1,4,5,10
36512,Trinidad and Tobago,2008.0,5,1,0,6
36513,Trinidad and Tobago,2008.0,5,1,0,6
36514,Trinidad and Tobago,2012.0,1,4,5,10
36515,Trinidad and Tobago,2012.0,1,4,5,10
36516,Trinidad and Tobago,2016.0,0,0,1,1
36517,Trinidad and Tobago,1948.0,0,1,0,1
36518,Trinidad and Tobago,1952.0,0,0,2,2
36519,Colombia,2012.0,1,3,4,8
36520,Colombia,2016.0,3,2,3,8
36521,Colombia,1972.0,0,1,2,3
36522,Colombia,1984.0,0,1,0,1
36523,Colombia,2004.0,0,0,2,2
36524,Colombia,2012.0,1,3,4,8
36525,Colombia,2016.0,3,2,3,8
36526,Racing Club de France,1900.0,0,1,0,1
36527,Colombia,2012.0,1,3,4,8
36528,Colombia,2016.0,3,2,3,8
36529,Colombia,1988.0,0,0,1,1
36530,Colombia,2016.0,3,2,3,8
36531,Colombia,2016.0,3,2,3,8
36532,Colombia,2004.0,0,0,2,2
36533,Colombia,2012.0,1,3,4,8
36534,Colombia,2012.0,1,3,4,8
36535,Colombia,2012.0,1,3,4,8
36536,Colombia,2016.0,3,2,3,8
36537,Colombia,1972.0,0,1,2,3
36538,Colombia,2016.0,3,2,3,8
36539,Colombia,2008.0,0,1,1,2
36540,Colombia,2012.0,1,3,4,8
36541,Colombia,1992.0,0,0,1,1
36542,Colombia,1972.0,0,1,2,3
36543,Colombia,2008.0,0,1,1,2
36544,Colombia,2012.0,1,3,4,8
36545,Colombia,2000.0,1,0,0,1
36546,Colombia,2016.0,3,2,3,8
36547,Luxembourg,1920.0,0,1,0,1
36548,Luxembourg,1952.0,1,0,0,1
36549,Luxembourg,1992.0,0,2,0,2
36550,Luxembourg,1992.0,0,2,0,2
36551,Luxembourg,1924.0,1,1,0,2
36552,Luxembourg,1924.0,1,1,0,2
36553,Luxembourg,1928.0,1,0,0,1
36554,Luxembourg,1900.0,1,0,0,1
36555,Botswana,2012.0,0,1,0,1
36556,Tunisia,2016.0,0,0,3,3
36557,Tunisia,2016.0,0,0,3,3
36558,Tunisia,1964.0,0,1,1,2
36559,Tunisia,1964.0,0,1,1,2
36560,Tunisia,1968.0,1,0,1,2
36561,Tunisia,1968.0,1,0,1,2
36562,Tunisia,1972.0,0,1,0,1
36563,Tunisia,2012.0,1,1,1,3
36564,Tunisia,2008.0,1,0,0,1
36565,Tunisia,2012.0,1,1,1,3
36566,Tunisia,2012.0,1,1,1,3
36567,Tunisia,1996.0,0,0,1,1
36568,Tunisia,2016.0,0,0,3,3
36569,South Korea,2016.0,13,3,10,26
36570,South Korea,1984.0,6,28,7,41
36571,South Korea,1988.0,28,37,12,77
36572,South Korea,1992.0,33,6,17,56
36573,South Korea-2,1988.0,28,37,12,77
36574,South Korea,2008.0,41,11,26,78
36575,South Korea,1998.0,6,4,2,12
36576,South Korea,2006.0,14,3,2,19
36577,South Korea,2006.0,14,3,2,19
36578,South Korea,2006.0,14,3,2,19
36579,South Korea,2006.0,14,3,2,19
36580,South Korea,1984.0,6,28,7,41
36581,South Korea,2008.0,41,11,26,78
36582,South Korea,1988.0,28,37,12,77
36583,South Korea,1976.0,1,1,15,17
36584,South Korea,2012.0,18,13,30,61
36585,South Korea,1984.0,6,28,7,41
36586,South Korea,1992.0,33,6,17,56
36587,South Korea,1996.0,10,49,7,66
36588,South Korea,2008.0,41,11,26,78
36589,South Korea,2006.0,14,3,2,19
36590,South Korea,1976.0,1,1,15,17
36591,South Korea,1992.0,33,6,17,56
36592,South Korea,1988.0,28,37,12,77
36593,South Korea,1994.0,7,1,1,9
36594,South Korea,1994.0,7,1,1,9
36595,South Korea,1998.0,6,4,2,12
36596,South Korea,2016.0,13,3,10,26
36597,South Korea,2016.0,13,3,10,26
36598,South Korea,1992.0,33,6,17,56
36599,South Korea,1992.0,33,6,17,56
36600,South Korea,1984.0,6,28,7,41
36601,South Korea,2012.0,18,13,30,61
36602,South Korea,1988.0,28,37,12,77
36603,South Korea,1996.0,10,49,7,66
36604,South Korea,2002.0,5,2,0,7
36605,South Korea,2002.0,5,2,0,7
36606,South Korea,2006.0,14,3,2,19
36607,South Korea,2006.0,14,3,2,19
36608,South Korea,2012.0,18,13,30,61
36609,South Korea,1984.0,6,28,7,41
36610,South Korea,2012.0,18,13,30,61
36611,South Korea,2004.0,14,28,10,52
36612,South Korea,2008.0,41,11,26,78
36613,South Korea,2012.0,18,13,30,61
36614,South Korea,1996.0,10,49,7,66
36615,South Korea,2016.0,13,3,10,26
36616,South Korea,2004.0,14,28,10,52
36617,South Korea,2008.0,41,11,26,78
36618,South Korea,2002.0,5,2,0,7
36619,South Korea,1988.0,28,37,12,77
36620,South Korea,2012.0,18,13,30,61
36621,South Korea,2008.0,41,11,26,78
36622,South Korea,2000.0,12,26,35,73
36623,South Korea,2000.0,12,26,35,73
36624,South Korea-1,1992.0,33,6,17,56
36625,South Korea,1988.0,28,37,12,77
36626,South Korea,1952.0,0,0,2,2
36627,South Korea,2008.0,41,11,26,78
36628,South Korea,2006.0,14,3,2,19
36629,South Korea,2012.0,18,13,30,61
36630,South Korea-1,1992.0,33,6,17,56
36631,South Korea-1,1996.0,10,49,7,66
36632,South Korea-2,1996.0,10,49,7,66
36633,South Korea,2002.0,5,2,0,7
36634,South Korea,2002.0,5,2,0,7
36635,South Korea,1988.0,28,37,12,77
36636,South Korea,2008.0,41,11,26,78
36637,South Korea,2014.0,7,5,2,14
36638,South Korea,2012.0,18,13,30,61
36639,South Korea,2000.0,12,26,35,73
36640,South Korea,2012.0,18,13,30,61
36641,South Korea,1996.0,10,49,7,66
36642,South Korea,2016.0,13,3,10,26
36643,South Korea,2010.0,6,10,2,18
36644,South Korea,1996.0,10,49,7,66
36645,South Korea,2008.0,41,11,26,78
36646,South Korea,1996.0,10,49,7,66
36647,South Korea,1984.0,6,28,7,41
36648,South Korea-2,2000.0,12,26,35,73
36649,South Korea-2,2004.0,14,28,10,52
36650,South Korea,1988.0,28,37,12,77
36651,South Korea,2008.0,41,11,26,78
36652,South Korea,1984.0,6,28,7,41
36653,South Korea,1988.0,28,37,12,77
36654,South Korea,2000.0,12,26,35,73
36655,South Korea,1988.0,28,37,12,77
36656,South Korea,1988.0,28,37,12,77
36657,South Korea,1996.0,10,49,7,66
36658,South Korea,1948.0,0,0,2,2
36659,South Korea,2012.0,18,13,30,61
36660,South Korea,1996.0,10,49,7,66
36661,South Korea,2004.0,14,28,10,52
36662,South Korea,2008.0,41,11,26,78
36663,South Korea,2004.0,14,28,10,52
36664,South Korea-1,1992.0,33,6,17,56
36665,South Korea,1992.0,33,6,17,56
36666,South Korea,1996.0,10,49,7,66
36667,South Korea,2008.0,41,11,26,78
36668,South Korea,2000.0,12,26,35,73
36669,South Korea,1992.0,33,6,17,56
36670,South Korea,1988.0,28,37,12,77
36671,South Korea,2004.0,14,28,10,52
36672,South Korea,2008.0,41,11,26,78
36673,South Korea,2012.0,18,13,30,61
36674,South Korea-2,1992.0,33,6,17,56
36675,South Korea,1984.0,6,28,7,41
36676,South Korea-1,2008.0,41,11,26,78
36677,South Korea,2000.0,12,26,35,73
36678,South Korea,2012.0,18,13,30,61
36679,South Korea,1992.0,33,6,17,56
36680,South Korea,1988.0,28,37,12,77
36681,South Korea,1992.0,33,6,17,56
36682,South Korea-1,1992.0,33,6,17,56
36683,South Korea,1996.0,10,49,7,66
36684,South Korea,2000.0,12,26,35,73
36685,South Korea,2004.0,14,28,10,52
36686,South Korea,2008.0,41,11,26,78
36687,South Korea,2012.0,18,13,30,61
36688,South Korea,1988.0,28,37,12,77
36689,South Korea,1996.0,10,49,7,66
36690,South Korea,2000.0,12,26,35,73
36691,South Korea,1988.0,28,37,12,77
36692,South Korea,2000.0,12,26,35,73
36693,South Korea,1988.0,28,37,12,77
36694,South Korea,1992.0,33,6,17,56
36695,South Korea,1996.0,10,49,7,66
36696,South Korea,2004.0,14,28,10,52
36697,South Korea,2000.0,12,26,35,73
36698,South Korea,2008.0,41,11,26,78
36699,South Korea,2008.0,41,11,26,78
36700,South Korea,2016.0,13,3,10,26
36701,South Korea,1964.0,0,2,1,3
36702,South Korea,1976.0,1,1,15,17
36703,South Korea,1988.0,28,37,12,77
36704,South Korea,1996.0,10,49,7,66
36705,South Korea-2,1996.0,10,49,7,66
36706,South Korea,1976.0,1,1,15,17
36707,South Korea,1996.0,10,49,7,66
36708,South Korea,2000.0,12,26,35,73
36709,South Korea,2004.0,14,28,10,52
36710,South Korea,2004.0,14,28,10,52
36711,South Korea,2008.0,41,11,26,78
36712,South Korea,1992.0,33,6,17,56
36713,South Korea,2000.0,12,26,35,73
36714,South Korea,2004.0,14,28,10,52
36715,South Korea,2004.0,14,28,10,52
36716,South Korea,1968.0,0,1,1,2
36717,South Korea,2008.0,41,11,26,78
36718,South Korea,1996.0,10,49,7,66
36719,South Korea,2000.0,12,26,35,73
36720,South Korea,2004.0,14,28,10,52
36721,South Korea,1988.0,28,37,12,77
36722,South Korea,1992.0,33,6,17,56
36723,South Korea,1984.0,6,28,7,41
36724,South Korea,2006.0,14,3,2,19
36725,South Korea,1996.0,10,49,7,66
36726,South Korea,1976.0,1,1,15,17
36727,South Korea,2012.0,18,13,30,61
36728,South Korea,1994.0,7,1,1,9
36729,South Korea,1994.0,7,1,1,9
36730,South Korea,1998.0,6,4,2,12
36731,South Korea,1998.0,6,4,2,12
36732,South Korea,1998.0,6,4,2,12
36733,South Korea,1988.0,28,37,12,77
36734,South Korea,2000.0,12,26,35,73
36735,South Korea,2000.0,12,26,35,73
36736,South Korea,1996.0,10,49,7,66
36737,South Korea,2016.0,13,3,10,26
36738,South Korea,2000.0,12,26,35,73
36739,South Korea,2000.0,12,26,35,73
36740,South Korea,2008.0,41,11,26,78
36741,South Korea,1988.0,28,37,12,77
36742,South Korea,2008.0,41,11,26,78
36743,South Korea,2012.0,18,13,30,61
36744,South Korea-1,2016.0,13,3,10,26
36745,South Korea,2008.0,41,11,26,78
36746,South Korea,1984.0,6,28,7,41
36747,South Korea,1992.0,33,6,17,56
36748,South Korea,2012.0,18,13,30,61
36749,South Korea,1992.0,33,6,17,56
36750,South Korea-1,2012.0,18,13,30,61
36751,South Korea,2004.0,14,28,10,52
36752,South Korea,2012.0,18,13,30,61
36753,South Korea,2000.0,12,26,35,73
36754,South Korea,1984.0,6,28,7,41
36755,South Korea,1988.0,28,37,12,77
36756,South Korea,1996.0,10,49,7,66
36757,South Korea,2012.0,18,13,30,61
36758,South Korea,1996.0,10,49,7,66
36759,South Korea,2000.0,12,26,35,73
36760,South Korea,1964.0,0,2,1,3
36761,South Korea-2,1992.0,33,6,17,56
36762,South Korea,2000.0,12,26,35,73
36763,South Korea,1984.0,6,28,7,41
36764,South Korea,1976.0,1,1,15,17
36765,South Korea,2012.0,18,13,30,61
36766,South Korea,2012.0,18,13,30,61
36767,South Korea,2000.0,12,26,35,73
36768,South Korea,1968.0,0,1,1,2
36769,South Korea,1996.0,10,49,7,66
36770,South Korea,2008.0,41,11,26,78
36771,South Korea,2004.0,14,28,10,52
36772,South Korea,2008.0,41,11,26,78
36773,South Korea,2008.0,41,11,26,78
36774,South Korea,2012.0,18,13,30,61
36775,South Korea,2012.0,18,13,30,61
36776,South Korea,2016.0,13,3,10,26
36777,South Korea,2000.0,12,26,35,73
36778,South Korea,2006.0,14,3,2,19
36779,South Korea,2006.0,14,3,2,19
36780,South Korea,2006.0,14,3,2,19
36781,South Korea,1988.0,28,37,12,77
36782,South Korea,1996.0,10,49,7,66
36783,South Korea,1996.0,10,49,7,66
36784,South Korea,1988.0,28,37,12,77
36785,South Korea,2014.0,7,5,2,14
36786,South Korea,1976.0,1,1,15,17
36787,South Korea,1996.0,10,49,7,66
36788,South Korea,2000.0,12,26,35,73
36789,South Korea,1976.0,1,1,15,17
36790,South Korea,2012.0,18,13,30,61
36791,South Korea,1996.0,10,49,7,66
36792,South Korea,2000.0,12,26,35,73
36793,South Korea,2004.0,14,28,10,52
36794,South Korea,1984.0,6,28,7,41
36795,South Korea,1988.0,28,37,12,77
36796,South Korea,2008.0,41,11,26,78
36797,South Korea,2014.0,7,5,2,14
36798,South Korea,2002.0,5,2,0,7
36799,South Korea,2012.0,18,13,30,61
36800,South Korea,2000.0,12,26,35,73
36801,South Korea,2012.0,18,13,30,61
36802,South Korea,2012.0,18,13,30,61
36803,South Korea,2016.0,13,3,10,26
36804,South Korea,2016.0,13,3,10,26
36805,South Korea,2014.0,7,5,2,14
36806,South Korea,2012.0,18,13,30,61
36807,South Korea,1996.0,10,49,7,66
36808,South Korea,2012.0,18,13,30,61
36809,South Korea,1992.0,33,6,17,56
36810,South Korea,2004.0,14,28,10,52
36811,South Korea,2008.0,41,11,26,78
36812,South Korea,1956.0,0,1,1,2
36813,South Korea,2012.0,18,13,30,61
36814,South Korea,2014.0,7,5,2,14
36815,South Korea,2000.0,12,26,35,73
36816,South Korea,2000.0,12,26,35,73
36817,South Korea,1984.0,6,28,7,41
36818,South Korea,1988.0,28,37,12,77
36819,South Korea,2004.0,14,28,10,52
36820,South Korea,2000.0,12,26,35,73
36821,South Korea,2008.0,41,11,26,78
36822,South Korea-1,1996.0,10,49,7,66
36823,South Korea-2,2000.0,12,26,35,73
36824,South Korea-2,2004.0,14,28,10,52
36825,South Korea,1998.0,6,4,2,12
36826,South Korea,1998.0,6,4,2,12
36827,South Korea,1996.0,10,49,7,66
36828,South Korea,1984.0,6,28,7,41
36829,South Korea,2012.0,18,13,30,61
36830,South Korea,1992.0,33,6,17,56
36831,South Korea,1992.0,33,6,17,56
36832,South Korea,1994.0,7,1,1,9
36833,South Korea,2000.0,12,26,35,73
36834,South Korea,1988.0,28,37,12,77
36835,South Korea,2008.0,41,11,26,78
36836,South Korea,1988.0,28,37,12,77
36837,South Korea,2004.0,14,28,10,52
36838,South Korea,2008.0,41,11,26,78
36839,South Korea,2000.0,12,26,35,73
36840,South Korea,2000.0,12,26,35,73
36841,South Korea,1984.0,6,28,7,41
36842,South Korea,1988.0,28,37,12,77
36843,South Korea,1996.0,10,49,7,66
36844,South Korea,1996.0,10,49,7,66
36845,South Korea,2000.0,12,26,35,73
36846,South Korea,1992.0,33,6,17,56
36847,South Korea,1984.0,6,28,7,41
36848,South Korea,1988.0,28,37,12,77
36849,South Korea,2004.0,14,28,10,52
36850,South Korea,2012.0,18,13,30,61
36851,South Korea,2008.0,41,11,26,78
36852,South Korea,2012.0,18,13,30,61
36853,South Korea,2016.0,13,3,10,26
36854,South Korea,2000.0,12,26,35,73
36855,South Korea,2008.0,41,11,26,78
36856,South Korea,2012.0,18,13,30,61
36857,South Korea,1988.0,28,37,12,77
36858,South Korea,1984.0,6,28,7,41
36859,South Korea,1988.0,28,37,12,77
36860,South Korea,2012.0,18,13,30,61
36861,South Korea,2000.0,12,26,35,73
36862,South Korea,2012.0,18,13,30,61
36863,South Korea,2016.0,13,3,10,26
36864,South Korea,2004.0,14,28,10,52
36865,South Korea,2008.0,41,11,26,78
36866,South Korea,1996.0,10,49,7,66
36867,South Korea,1996.0,10,49,7,66
36868,South Korea,2012.0,18,13,30,61
36869,South Korea,1984.0,6,28,7,41
36870,South Korea,1996.0,10,49,7,66
36871,South Korea,1984.0,6,28,7,41
36872,South Korea,2012.0,18,13,30,61
36873,South Korea,2016.0,13,3,10,26
36874,South Korea,1992.0,33,6,17,56
36875,South Korea,1992.0,33,6,17,56
36876,South Korea,1988.0,28,37,12,77
36877,South Korea,1996.0,10,49,7,66
36878,South Korea,1984.0,6,28,7,41
36879,South Korea,1988.0,28,37,12,77
36880,South Korea,2008.0,41,11,26,78
36881,South Korea,1996.0,10,49,7,66
36882,South Korea-1,2000.0,12,26,35,73
36883,South Korea-1,1992.0,33,6,17,56
36884,South Korea,1996.0,10,49,7,66
36885,South Korea,1988.0,28,37,12,77
36886,South Korea,2008.0,41,11,26,78
36887,South Korea,2000.0,12,26,35,73
36888,South Korea,2000.0,12,26,35,73
36889,South Korea,1984.0,6,28,7,41
36890,South Korea,2008.0,41,11,26,78
36891,South Korea,1996.0,10,49,7,66
36892,South Korea,1988.0,28,37,12,77
36893,South Korea,2000.0,12,26,35,73
36894,South Korea,2010.0,6,10,2,18
36895,South Korea,1948.0,0,0,2,2
36896,South Korea,1952.0,0,0,2,2
36897,South Korea,1988.0,28,37,12,77
36898,South Korea,2016.0,13,3,10,26
36899,South Korea,1994.0,7,1,1,9
36900,South Korea,1994.0,7,1,1,9
36901,South Korea,2000.0,12,26,35,73
36902,South Korea,1988.0,28,37,12,77
36903,South Korea,1988.0,28,37,12,77
36904,South Korea,1992.0,33,6,17,56
36905,South Korea,1992.0,33,6,17,56
36906,South Korea,2000.0,12,26,35,73
36907,South Korea,2000.0,12,26,35,73
36908,South Korea,1988.0,28,37,12,77
36909,South Korea,2000.0,12,26,35,73
36910,South Korea,2016.0,13,3,10,26
36911,South Korea,1988.0,28,37,12,77
36912,South Korea,1992.0,33,6,17,56
36913,South Korea-2,1992.0,33,6,17,56
36914,South Korea,1984.0,6,28,7,41
36915,South Korea,1964.0,0,2,1,3
36916,South Korea,1984.0,6,28,7,41
36917,South Korea,2016.0,13,3,10,26
36918,South Korea,2012.0,18,13,30,61
36919,South Korea,2000.0,12,26,35,73
36920,South Korea,1984.0,6,28,7,41
36921,South Korea,1988.0,28,37,12,77
36922,South Korea,1988.0,28,37,12,77
36923,South Korea,2000.0,12,26,35,73
36924,South Korea,2010.0,6,10,2,18
36925,South Korea,2014.0,7,5,2,14
36926,South Korea,2000.0,12,26,35,73
36927,South Korea,1992.0,33,6,17,56
36928,South Korea,1994.0,7,1,1,9
36929,South Korea,1998.0,6,4,2,12
36930,South Korea,2016.0,13,3,10,26
36931,South Korea,2016.0,13,3,10,26
36932,South Korea,1996.0,10,49,7,66
36933,South Korea,2004.0,14,28,10,52
36934,South Korea,2012.0,18,13,30,61
36935,South Korea,2004.0,14,28,10,52
36936,South Korea,2004.0,14,28,10,52
36937,South Korea,1996.0,10,49,7,66
36938,South Korea,2000.0,12,26,35,73
36939,South Korea,2008.0,41,11,26,78
36940,South Korea-1,1992.0,33,6,17,56
36941,South Korea-2,1996.0,10,49,7,66
36942,South Korea,2008.0,41,11,26,78
36943,South Korea,2012.0,18,13,30,61
36944,South Korea,2016.0,13,3,10,26
36945,South Korea-1,2000.0,12,26,35,73
36946,South Korea,2004.0,14,28,10,52
36947,South Korea,2010.0,6,10,2,18
36948,South Korea,1992.0,33,6,17,56
36949,South Korea,1992.0,33,6,17,56
36950,South Korea,1996.0,10,49,7,66
36951,South Korea-1,2004.0,14,28,10,52
36952,South Korea,1996.0,10,49,7,66
36953,South Korea,2006.0,14,3,2,19
36954,South Korea,1988.0,28,37,12,77
36955,South Korea,2004.0,14,28,10,52
36956,South Korea,1988.0,28,37,12,77
36957,South Korea-1,2004.0,14,28,10,52
36958,South Korea-1,2008.0,41,11,26,78
36959,South Korea,1988.0,28,37,12,77
36960,South Korea,1998.0,6,4,2,12
36961,South Korea,2006.0,14,3,2,19
36962,South Korea,2006.0,14,3,2,19
36963,South Korea,2006.0,14,3,2,19
36964,South Korea,2010.0,6,10,2,18
36965,South Korea,2010.0,6,10,2,18
36966,South Korea,1992.0,33,6,17,56
36967,South Korea,1988.0,28,37,12,77
36968,South Korea,1984.0,6,28,7,41
36969,South Korea-1,2008.0,41,11,26,78
36970,South Korea-1,2008.0,41,11,26,78
36971,South Korea,1988.0,28,37,12,77
36972,South Korea-1,2008.0,41,11,26,78
36973,South Korea,1988.0,28,37,12,77
36974,South Korea,1984.0,6,28,7,41
36975,South Korea,2010.0,6,10,2,18
36976,South Korea,2010.0,6,10,2,18
36977,South Korea,2010.0,6,10,2,18
36978,South Korea,1996.0,10,49,7,66
36979,South Korea,2008.0,41,11,26,78
36980,South Korea,2008.0,41,11,26,78
36981,South Korea,2000.0,12,26,35,73
36982,South Korea,2000.0,12,26,35,73
36983,South Korea,1992.0,33,6,17,56
36984,South Korea,1992.0,33,6,17,56
36985,South Korea,1998.0,6,4,2,12
36986,South Korea,1984.0,6,28,7,41
36987,South Korea,1992.0,33,6,17,56
36988,South Korea,2008.0,41,11,26,78
36989,South Korea,1996.0,10,49,7,66
36990,South Korea,2004.0,14,28,10,52
36991,South Korea,2000.0,12,26,35,73
36992,South Korea,2010.0,6,10,2,18
36993,South Korea,2014.0,7,5,2,14
36994,South Korea,1988.0,28,37,12,77
36995,South Korea,2000.0,12,26,35,73
36996,South Korea,2004.0,14,28,10,52
36997,South Korea,2004.0,14,28,10,52
36998,South Korea,2012.0,18,13,30,61
36999,South Korea,1992.0,33,6,17,56
37000,South Korea,1996.0,10,49,7,66
37001,South Korea,2000.0,12,26,35,73
37002,South Korea,2010.0,6,10,2,18
37003,South Korea,2010.0,6,10,2,18
37004,South Korea,2014.0,7,5,2,14
37005,South Korea,2000.0,12,26,35,73
37006,South Korea,2008.0,41,11,26,78
37007,South Korea,2016.0,13,3,10,26
37008,South Korea,1976.0,1,1,15,17
37009,South Korea,1984.0,6,28,7,41
37010,South Korea,1976.0,1,1,15,17
37011,South Korea,2008.0,41,11,26,78
37012,South Korea,2004.0,14,28,10,52
37013,South Korea,1984.0,6,28,7,41
37014,South Korea-1,2008.0,41,11,26,78
37015,South Korea-1,2012.0,18,13,30,61
37016,South Korea,2008.0,41,11,26,78
37017,South Korea,1976.0,1,1,15,17
37018,South Korea,1992.0,33,6,17,56
37019,South Korea,1992.0,33,6,17,56
37020,South Korea,1992.0,33,6,17,56
37021,South Korea,2010.0,6,10,2,18
37022,South Korea,2010.0,6,10,2,18
37023,South Korea,1984.0,6,28,7,41
37024,South Korea,2004.0,14,28,10,52
37025,South Korea,2004.0,14,28,10,52
37026,South Korea,1992.0,33,6,17,56
37027,South Korea,1996.0,10,49,7,66
37028,South Korea,2004.0,14,28,10,52
37029,South Korea,2008.0,41,11,26,78
37030,South Korea,2000.0,12,26,35,73
37031,South Korea,2004.0,14,28,10,52
37032,South Korea,2004.0,14,28,10,52
37033,South Korea-2,1996.0,10,49,7,66
37034,South Korea-1,2004.0,14,28,10,52
37035,South Korea,1992.0,33,6,17,56
37036,South Korea,2008.0,41,11,26,78
37037,South Korea,2012.0,18,13,30,61
37038,South Korea,2012.0,18,13,30,61
37039,South Korea,1988.0,28,37,12,77
37040,South Korea,1988.0,28,37,12,77
37041,South Korea,2012.0,18,13,30,61
37042,South Korea,1996.0,10,49,7,66
37043,South Korea,1996.0,10,49,7,66
37044,South Korea,2000.0,12,26,35,73
37045,South Korea,2012.0,18,13,30,61
37046,South Korea,2008.0,41,11,26,78
37047,South Korea,2012.0,18,13,30,61
37048,South Korea,2006.0,14,3,2,19
37049,South Korea,2008.0,41,11,26,78
37050,South Korea,1972.0,0,1,0,1
37051,South Korea,1996.0,10,49,7,66
37052,South Korea,1988.0,28,37,12,77
37053,South Korea,2012.0,18,13,30,61
37054,South Korea,2016.0,13,3,10,26
37055,South Korea,2012.0,18,13,30,61
37056,South Korea,2012.0,18,13,30,61
37057,South Korea,1992.0,33,6,17,56
37058,South Korea,1996.0,10,49,7,66
37059,South Korea,2004.0,14,28,10,52
37060,South Korea,2008.0,41,11,26,78
37061,South Korea,1996.0,10,49,7,66
37062,South Korea,2004.0,14,28,10,52
37063,South Korea,2008.0,41,11,26,78
37064,South Korea,1984.0,6,28,7,41
37065,South Korea,1988.0,28,37,12,77
37066,South Korea,2008.0,41,11,26,78
37067,South Korea,1992.0,33,6,17,56
37068,South Korea,2004.0,14,28,10,52
37069,South Korea,2008.0,41,11,26,78
37070,South Korea,2008.0,41,11,26,78
37071,South Korea,2000.0,12,26,35,73
37072,South Korea-1,1996.0,10,49,7,66
37073,South Korea,2002.0,5,2,0,7
37074,South Korea,2016.0,13,3,10,26
37075,South Korea,2000.0,12,26,35,73
37076,South Korea,1988.0,28,37,12,77
37077,South Korea,1992.0,33,6,17,56
37078,South Korea,1996.0,10,49,7,66
37079,South Korea,2008.0,41,11,26,78
37080,South Korea,1992.0,33,6,17,56
37081,South Korea,1996.0,10,49,7,66
37082,South Korea,2000.0,12,26,35,73
37083,South Korea,2008.0,41,11,26,78
37084,South Korea,2000.0,12,26,35,73
37085,South Korea,1988.0,28,37,12,77
37086,South Korea,2012.0,18,13,30,61
37087,South Korea-1,1992.0,33,6,17,56
37088,South Korea-2,1996.0,10,49,7,66
37089,South Korea,2012.0,18,13,30,61
37090,South Korea,1976.0,1,1,15,17
37091,South Korea,2008.0,41,11,26,78
37092,South Korea,2016.0,13,3,10,26
37093,South Korea,2000.0,12,26,35,73
37094,South Korea,2004.0,14,28,10,52
37095,South Korea,2004.0,14,28,10,52
37096,South Korea,2008.0,41,11,26,78
37097,South Korea,2008.0,41,11,26,78
37098,South Korea,1988.0,28,37,12,77
37099,South Korea,1988.0,28,37,12,77
37100,South Korea,2010.0,6,10,2,18
37101,South Korea,2010.0,6,10,2,18
37102,South Korea,2014.0,7,5,2,14
37103,South Korea,2014.0,7,5,2,14
37104,South Korea,2014.0,7,5,2,14
37105,South Korea,1988.0,28,37,12,77
37106,South Korea,1988.0,28,37,12,77
37107,South Korea,2008.0,41,11,26,78
37108,South Korea,2008.0,41,11,26,78
37109,South Korea,2012.0,18,13,30,61
37110,South Korea,2012.0,18,13,30,61
37111,South Korea,1976.0,1,1,15,17
37112,South Korea,1988.0,28,37,12,77
37113,South Korea,2008.0,41,11,26,78
37114,South Korea,2008.0,41,11,26,78
37115,South Korea,1988.0,28,37,12,77
37116,South Korea,2006.0,14,3,2,19
37117,South Korea,1984.0,6,28,7,41
37118,South Korea,1988.0,28,37,12,77
37119,South Korea,2000.0,12,26,35,73
37120,South Korea-1,2004.0,14,28,10,52
37121,South Korea,1988.0,28,37,12,77
37122,South Korea,1984.0,6,28,7,41
37123,South Korea,1988.0,28,37,12,77
37124,South Korea,1984.0,6,28,7,41
37125,South Korea,2010.0,6,10,2,18
37126,South Korea,2010.0,6,10,2,18
37127,South Korea,2014.0,7,5,2,14
37128,South Korea,2014.0,7,5,2,14
37129,South Korea,2014.0,7,5,2,14
37130,South Korea-1,2016.0,13,3,10,26
37131,South Korea-1,1992.0,33,6,17,56
37132,South Korea,1996.0,10,49,7,66
37133,South Korea,2000.0,12,26,35,73
37134,South Korea,1988.0,28,37,12,77
37135,South Korea,2012.0,18,13,30,61
37136,South Korea,1984.0,6,28,7,41
37137,South Korea,2000.0,12,26,35,73
37138,South Korea,1988.0,28,37,12,77
37139,South Korea,1984.0,6,28,7,41
37140,South Korea,1984.0,6,28,7,41
37141,South Korea,1988.0,28,37,12,77
37142,South Korea,2000.0,12,26,35,73
37143,South Korea,2004.0,14,28,10,52
37144,South Korea,2008.0,41,11,26,78
37145,South Korea,2012.0,18,13,30,61
37146,South Korea,2008.0,41,11,26,78
37147,South Korea,1992.0,33,6,17,56
37148,South Korea,1988.0,28,37,12,77
37149,South Korea,2000.0,12,26,35,73
37150,South Korea,2004.0,14,28,10,52
37151,South Korea,2006.0,14,3,2,19
37152,South Korea,2000.0,12,26,35,73
37153,South Korea,2008.0,41,11,26,78
37154,South Korea,1956.0,0,1,1,2
37155,South Korea,1996.0,10,49,7,66
37156,South Korea,2008.0,41,11,26,78
37157,South Korea,1988.0,28,37,12,77
37158,South Korea,1988.0,28,37,12,77
37159,South Korea,1994.0,7,1,1,9
37160,South Korea,1998.0,6,4,2,12
37161,South Korea,1998.0,6,4,2,12
37162,South Korea,2012.0,18,13,30,61
37163,South Korea,2004.0,14,28,10,52
37164,South Korea,2012.0,18,13,30,61
37165,South Korea,1996.0,10,49,7,66
37166,South Korea,1976.0,1,1,15,17
37167,South Korea,2004.0,14,28,10,52
37168,South Korea,1988.0,28,37,12,77
37169,South Korea,1992.0,33,6,17,56
37170,South Korea,1996.0,10,49,7,66
37171,South Korea,2000.0,12,26,35,73
37172,South Korea,2008.0,41,11,26,78
37173,South Korea,2008.0,41,11,26,78
37174,South Korea,2016.0,13,3,10,26
37175,South Korea,2008.0,41,11,26,78
37176,South Korea,1976.0,1,1,15,17
37177,South Korea,1984.0,6,28,7,41
37178,South Korea,1996.0,10,49,7,66
37179,South Korea,1976.0,1,1,15,17
37180,South Korea-1,1996.0,10,49,7,66
37181,South Korea-1,2000.0,12,26,35,73
37182,South Korea,1988.0,28,37,12,77
37183,South Korea-2,1988.0,28,37,12,77
37184,South Korea-2,1992.0,33,6,17,56
37185,South Korea-2,1996.0,10,49,7,66
37186,South Korea,1992.0,33,6,17,56
37187,South Korea,2004.0,14,28,10,52
37188,South Korea,2008.0,41,11,26,78
37189,South Korea,2012.0,18,13,30,61
37190,South Korea,2008.0,41,11,26,78
37191,South Korea-1,2000.0,12,26,35,73
37192,South Korea,2004.0,14,28,10,52
37193,South Korea,1984.0,6,28,7,41
37194,South Korea,1996.0,10,49,7,66
37195,South Korea,1992.0,33,6,17,56
37196,South Korea,2000.0,12,26,35,73
37197,South Korea,2000.0,12,26,35,73
37198,South Korea,2004.0,14,28,10,52
37199,South Korea,2008.0,41,11,26,78
37200,South Korea,2008.0,41,11,26,78
37201,South Korea,2012.0,18,13,30,61
37202,South Korea,1984.0,6,28,7,41
37203,South Korea,1988.0,28,37,12,77
37204,South Korea,1976.0,1,1,15,17
37205,South Korea,1988.0,28,37,12,77
37206,South Korea,1988.0,28,37,12,77
37207,North Korea,2008.0,2,1,3,6
37208,North Korea,2012.0,4,0,2,6
37209,North Korea,2016.0,2,3,2,7
37210,North Korea,1992.0,4,0,7,11
37211,North Korea,1996.0,2,1,2,5
37212,North Korea,1976.0,1,1,0,2
37213,North Korea,1980.0,0,3,2,5
37214,North Korea,1964.0,0,1,0,1
37215,North Korea,1980.0,0,3,2,5
37216,North Korea,2008.0,2,1,3,6
37217,North Korea,1972.0,1,1,13,15
37218,North Korea,1992.0,4,0,7,11
37219,North Korea,1972.0,1,1,13,15
37220,North Korea,1980.0,0,3,2,5
37221,North Korea,1972.0,1,1,13,15
37222,North Korea,1972.0,1,1,13,15
37223,North Korea,2000.0,0,1,3,4
37224,North Korea,1972.0,1,1,13,15
37225,North Korea,2004.0,0,4,1,5
37226,North Korea,1992.0,4,0,7,11
37227,North Korea,1996.0,2,1,2,5
37228,North Korea,2004.0,0,4,1,5
37229,North Korea,2016.0,2,3,2,7
37230,North Korea,1992.0,4,0,7,11
37231,North Korea,1996.0,2,1,2,5
37232,North Korea,1972.0,1,1,13,15
37233,North Korea,2016.0,2,3,2,7
37234,North Korea,2004.0,0,4,1,5
37235,North Korea,2016.0,2,3,2,7
37236,North Korea,1972.0,1,1,13,15
37237,North Korea,1972.0,1,1,13,15
37238,North Korea,2000.0,0,1,3,4
37239,North Korea,2012.0,4,0,2,6
37240,North Korea,1972.0,1,1,13,15
37241,North Korea,1972.0,1,1,13,15
37242,North Korea,1992.0,4,0,7,11
37243,North Korea,1972.0,1,1,13,15
37244,North Korea,1996.0,2,1,2,5
37245,North Korea,2000.0,0,1,3,4
37246,North Korea,2004.0,0,4,1,5
37247,North Korea,1992.0,4,0,7,11
37248,North Korea-1,1992.0,4,0,7,11
37249,North Korea,1976.0,1,1,0,2
37250,North Korea,1980.0,0,3,2,5
37251,North Korea,1992.0,4,0,7,11
37252,North Korea,1992.0,4,0,7,11
37253,North Korea,1972.0,1,1,13,15
37254,North Korea,1980.0,0,3,2,5
37255,North Korea,2008.0,2,1,3,6
37256,North Korea,2012.0,4,0,2,6
37257,North Korea,2016.0,2,3,2,7
37258,North Korea,1992.0,4,0,7,11
37259,North Korea,1972.0,1,1,13,15
37260,North Korea,2008.0,2,1,3,6
37261,North Korea,2008.0,2,1,3,6
37262,North Korea,1972.0,1,1,13,15
37263,North Korea,2016.0,2,3,2,7
37264,North Korea,2000.0,0,1,3,4
37265,North Korea,2004.0,0,4,1,5
37266,North Korea,1996.0,2,1,2,5
37267,North Korea,2012.0,4,0,2,6
37268,North Korea,2016.0,2,3,2,7
37269,North Korea,2012.0,4,0,2,6
37270,North Korea,1972.0,1,1,13,15
37271,North Korea,2008.0,2,1,3,6
37272,North Korea,2012.0,4,0,2,6
37273,North Korea-1,1992.0,4,0,7,11
37274,China,1998.0,0,9,5,14
37275,China,1998.0,0,9,5,14
37276,China,2002.0,2,5,9,16
37277,China,1996.0,19,70,17,106
37278,China,1984.0,24,13,37,74
37279,China,2008.0,74,53,57,184
37280,China,1996.0,19,70,17,106
37281,China,1996.0,19,70,17,106
37282,China,2008.0,74,53,57,184
37283,China,2000.0,39,23,17,79
37284,China-1,2008.0,74,53,57,184
37285,China-1,2012.0,56,40,29,125
37286,China,2016.0,46,30,37,113
37287,China,2008.0,74,53,57,184
37288,China,1996.0,19,70,17,106
37289,China,2012.0,56,40,29,125
37290,China,2016.0,46,30,37,113
37291,China,2016.0,46,30,37,113
37292,China,2012.0,56,40,29,125
37293,China,2012.0,56,40,29,125
37294,China,2008.0,74,53,57,184
37295,China,1996.0,19,70,17,106
37296,China,2016.0,46,30,37,113
37297,China,2016.0,46,30,37,113
37298,China,2014.0,3,4,5,12
37299,China,2012.0,56,40,29,125
37300,China,1996.0,19,70,17,106
37301,China,2008.0,74,53,57,184
37302,China,1988.0,6,16,30,52
37303,China,1988.0,6,16,30,52
37304,China,2004.0,52,27,15,94
37305,China,2008.0,74,53,57,184
37306,China,2012.0,56,40,29,125
37307,China,2016.0,46,30,37,113
37308,China-1,1988.0,6,16,30,52
37309,China,1994.0,0,1,2,3
37310,China,1998.0,0,9,5,14
37311,China,2016.0,46,30,37,113
37312,China-1,2004.0,52,27,15,94
37313,China,2008.0,74,53,57,184
37314,China,2008.0,74,53,57,184
37315,China,2008.0,74,53,57,184
37316,China,2012.0,56,40,29,125
37317,China,2012.0,56,40,29,125
37318,China,2016.0,46,30,37,113
37319,China,1984.0,24,13,37,74
37320,China,2012.0,56,40,29,125
37321,China,2000.0,39,23,17,79
37322,China,2008.0,74,53,57,184
37323,China,1996.0,19,70,17,106
37324,China,2004.0,52,27,15,94
37325,China,2008.0,74,53,57,184
37326,China,2008.0,74,53,57,184
37327,China,2008.0,74,53,57,184
37328,China,2012.0,56,40,29,125
37329,China,2012.0,56,40,29,125
37330,China,2008.0,74,53,57,184
37331,China,2012.0,56,40,29,125
37332,China,1984.0,24,13,37,74
37333,China,1984.0,24,13,37,74
37334,China,1992.0,18,48,19,85
37335,China,1996.0,19,70,17,106
37336,China,2008.0,74,53,57,184
37337,China,1984.0,24,13,37,74
37338,China,2000.0,39,23,17,79
37339,China,2004.0,52,27,15,94
37340,China-1,1992.0,18,48,19,85
37341,China,2008.0,74,53,57,184
37342,China,2008.0,74,53,57,184
37343,China,2008.0,74,53,57,184
37344,China,2008.0,74,53,57,184
37345,China,2012.0,56,40,29,125
37346,China,2016.0,46,30,37,113
37347,China,2008.0,74,53,57,184
37348,China,1984.0,24,13,37,74
37349,China,1992.0,18,48,19,85
37350,China,1988.0,6,16,30,52
37351,China,1996.0,19,70,17,106
37352,China,2012.0,56,40,29,125
37353,China,2012.0,56,40,29,125
37354,China,2008.0,74,53,57,184
37355,China,2012.0,56,40,29,125
37356,China,2016.0,46,30,37,113
37357,China,2016.0,46,30,37,113
37358,China,1992.0,18,48,19,85
37359,China-2,1992.0,18,48,19,85
37360,China,1996.0,19,70,17,106
37361,China-1,1996.0,19,70,17,106
37362,China,2012.0,56,40,29,125
37363,China,2000.0,39,23,17,79
37364,China,2012.0,56,40,29,125
37365,China,2012.0,56,40,29,125
37366,China,2016.0,46,30,37,113
37367,China,2016.0,46,30,37,113
37368,China,2016.0,46,30,37,113
37369,China,2016.0,46,30,37,113
37370,China,2008.0,74,53,57,184
37371,China,2012.0,56,40,29,125
37372,China,2016.0,46,30,37,113
37373,China,1996.0,19,70,17,106
37374,China,2000.0,39,23,17,79
37375,China,2004.0,52,27,15,94
37376,China-1,2008.0,74,53,57,184
37377,China,2004.0,52,27,15,94
37378,China,2008.0,74,53,57,184
37379,China,2016.0,46,30,37,113
37380,China,2016.0,46,30,37,113
37381,China,2016.0,46,30,37,113
37382,China,1996.0,19,70,17,106
37383,China,1996.0,19,70,17,106
37384,China,1996.0,19,70,17,106
37385,China,2014.0,3,4,5,12
37386,China,2016.0,46,30,37,113
37387,China,1996.0,19,70,17,106
37388,China,2012.0,56,40,29,125
37389,China,1998.0,0,9,5,14
37390,China,2002.0,2,5,9,16
37391,China,2004.0,52,27,15,94
37392,China,2008.0,74,53,57,184
37393,China,2016.0,46,30,37,113
37394,China,2012.0,56,40,29,125
37395,China,2012.0,56,40,29,125
37396,China,2008.0,74,53,57,184
37397,China-1,2008.0,74,53,57,184
37398,China-1,2012.0,56,40,29,125
37399,China-1,2016.0,46,30,37,113
37400,China,1992.0,18,48,19,85
37401,China,1996.0,19,70,17,106
37402,China,1996.0,19,70,17,106
37403,China,2000.0,39,23,17,79
37404,China,2000.0,39,23,17,79
37405,China,2016.0,46,30,37,113
37406,China,2000.0,39,23,17,79
37407,China,2004.0,52,27,15,94
37408,China,2004.0,52,27,15,94
37409,China,1996.0,19,70,17,106
37410,China,2000.0,39,23,17,79
37411,China-1,1992.0,18,48,19,85
37412,China,2016.0,46,30,37,113
37413,China,2008.0,74,53,57,184
37414,China-2,2000.0,39,23,17,79
37415,China-1,2000.0,39,23,17,79
37416,China-2,2004.0,52,27,15,94
37417,China,2004.0,52,27,15,94
37418,China,1988.0,6,16,30,52
37419,China,1992.0,18,48,19,85
37420,China,1984.0,24,13,37,74
37421,China,2008.0,74,53,57,184
37422,China-2,1996.0,19,70,17,106
37423,China-2,2000.0,39,23,17,79
37424,China,2012.0,56,40,29,125
37425,China,2016.0,46,30,37,113
37426,China,2012.0,56,40,29,125
37427,China,2016.0,46,30,37,113
37428,China,2000.0,39,23,17,79
37429,China,2008.0,74,53,57,184
37430,China-2,1996.0,19,70,17,106
37431,China-2,2000.0,39,23,17,79
37432,China,2016.0,46,30,37,113
37433,China,1992.0,18,48,19,85
37434,China-1,1992.0,18,48,19,85
37435,China,2008.0,74,53,57,184
37436,China,2000.0,39,23,17,79
37437,China,2000.0,39,23,17,79
37438,China,2004.0,52,27,15,94
37439,China,2004.0,52,27,15,94
37440,China,2008.0,74,53,57,184
37441,China,2008.0,74,53,57,184
37442,China,2016.0,46,30,37,113
37443,China,1992.0,18,48,19,85
37444,China,1992.0,18,48,19,85
37445,China,2008.0,74,53,57,184
37446,China,2012.0,56,40,29,125
37447,China,2012.0,56,40,29,125
37448,China,2012.0,56,40,29,125
37449,China,2002.0,2,5,9,16
37450,China,2012.0,56,40,29,125
37451,China,2008.0,74,53,57,184
37452,China,2012.0,56,40,29,125
37453,China,2010.0,9,3,7,19
37454,China-2,2004.0,52,27,15,94
37455,China,2008.0,74,53,57,184
37456,China,2008.0,74,53,57,184
37457,China,2012.0,56,40,29,125
37458,China,2014.0,3,4,5,12
37459,China,2014.0,3,4,5,12
37460,China,2006.0,2,5,6,13
37461,China,1996.0,19,70,17,106
37462,China,1988.0,6,16,30,52
37463,China,2008.0,74,53,57,184
37464,China,2016.0,46,30,37,113
37465,China,2012.0,56,40,29,125
37466,China,2008.0,74,53,57,184
37467,China,2012.0,56,40,29,125
37468,China-1,2008.0,74,53,57,184
37469,China,1984.0,24,13,37,74
37470,China,1992.0,18,48,19,85
37471,China,2008.0,74,53,57,184
37472,China,2008.0,74,53,57,184
37473,China,2012.0,56,40,29,125
37474,China,1996.0,19,70,17,106
37475,China,1996.0,19,70,17,106
37476,China,2008.0,74,53,57,184
37477,China,2012.0,56,40,29,125
37478,China,1988.0,6,16,30,52
37479,China,1996.0,19,70,17,106
37480,China,2004.0,52,27,15,94
37481,China,1988.0,6,16,30,52
37482,China,1992.0,18,48,19,85
37483,China,1988.0,6,16,30,52
37484,China,2012.0,56,40,29,125
37485,China,2012.0,56,40,29,125
37486,China,2016.0,46,30,37,113
37487,China,1984.0,24,13,37,74
37488,China,1988.0,6,16,30,52
37489,China,2012.0,56,40,29,125
37490,China,2008.0,74,53,57,184
37491,China,2000.0,39,23,17,79
37492,China,2000.0,39,23,17,79
37493,China,2004.0,52,27,15,94
37494,China,2016.0,46,30,37,113
37495,China,1988.0,6,16,30,52
37496,China,1988.0,6,16,30,52
37497,China,2008.0,74,53,57,184
37498,China,1992.0,18,48,19,85
37499,China,1996.0,19,70,17,106
37500,China,2008.0,74,53,57,184
37501,China,1996.0,19,70,17,106
37502,China,2000.0,39,23,17,79
37503,China,1984.0,24,13,37,74
37504,China,2004.0,52,27,15,94
37505,China,2012.0,56,40,29,125
37506,China,1984.0,24,13,37,74
37507,China,1988.0,6,16,30,52
37508,China,2004.0,52,27,15,94
37509,China,2012.0,56,40,29,125
37510,China,2016.0,46,30,37,113
37511,China,1988.0,6,16,30,52
37512,China,2000.0,39,23,17,79
37513,China,2008.0,74,53,57,184
37514,China,2008.0,74,53,57,184
37515,China,2012.0,56,40,29,125
37516,China,2012.0,56,40,29,125
37517,China,2016.0,46,30,37,113
37518,China,2016.0,46,30,37,113
37519,China,1992.0,18,48,19,85
37520,China,2016.0,46,30,37,113
37521,China,2008.0,74,53,57,184
37522,China-1,1988.0,6,16,30,52
37523,China,2000.0,39,23,17,79
37524,China,2004.0,52,27,15,94
37525,China,2014.0,3,4,5,12
37526,China,2000.0,39,23,17,79
37527,China,2012.0,56,40,29,125
37528,China,2008.0,74,53,57,184
37529,China,2008.0,74,53,57,184
37530,China,2012.0,56,40,29,125
37531,China,2008.0,74,53,57,184
37532,China,2012.0,56,40,29,125
37533,China,1984.0,24,13,37,74
37534,China,1988.0,6,16,30,52
37535,China,2004.0,52,27,15,94
37536,China,2008.0,74,53,57,184
37537,China,2008.0,74,53,57,184
37538,China,2012.0,56,40,29,125
37539,China,1988.0,6,16,30,52
37540,China,1988.0,6,16,30,52
37541,China,2008.0,74,53,57,184
37542,China,2012.0,56,40,29,125
37543,China-2,1996.0,19,70,17,106
37544,China,2000.0,39,23,17,79
37545,China-1,2000.0,39,23,17,79
37546,China,1984.0,24,13,37,74
37547,China,1996.0,19,70,17,106
37548,China,1984.0,24,13,37,74
37549,China,2004.0,52,27,15,94
37550,China,2004.0,52,27,15,94
37551,China,1992.0,18,48,19,85
37552,China,1996.0,19,70,17,106
37553,China,1996.0,19,70,17,106
37554,China,1996.0,19,70,17,106
37555,China,2004.0,52,27,15,94
37556,China,1996.0,19,70,17,106
37557,China,2012.0,56,40,29,125
37558,China,1992.0,18,48,19,85
37559,China,1992.0,18,48,19,85
37560,China,2016.0,46,30,37,113
37561,China,1992.0,18,48,19,85
37562,China,1988.0,6,16,30,52
37563,China,1992.0,18,48,19,85
37564,China,1992.0,18,48,19,85
37565,China,1996.0,19,70,17,106
37566,China,1992.0,18,48,19,85
37567,China,1988.0,6,16,30,52
37568,China,2008.0,74,53,57,184
37569,China,2008.0,74,53,57,184
37570,China,1988.0,6,16,30,52
37571,China,2004.0,52,27,15,94
37572,China,1998.0,0,9,5,14
37573,China,1998.0,0,9,5,14
37574,China,2002.0,2,5,9,16
37575,China,2002.0,2,5,9,16
37576,China,2006.0,2,5,6,13
37577,China,2014.0,3,4,5,12
37578,China,2004.0,52,27,15,94
37579,China,1992.0,18,48,19,85
37580,China,1992.0,18,48,19,85
37581,China,1992.0,18,48,19,85
37582,China,1988.0,6,16,30,52
37583,China,2012.0,56,40,29,125
37584,China,2000.0,39,23,17,79
37585,China-1,2000.0,39,23,17,79
37586,China,2008.0,74,53,57,184
37587,China,1984.0,24,13,37,74
37588,China,1984.0,24,13,37,74
37589,China,1984.0,24,13,37,74
37590,China,1988.0,6,16,30,52
37591,China,2000.0,39,23,17,79
37592,China,2000.0,39,23,17,79
37593,China,2000.0,39,23,17,79
37594,China,2012.0,56,40,29,125
37595,China,2006.0,2,5,6,13
37596,China,2010.0,9,3,7,19
37597,China,1984.0,24,13,37,74
37598,China,1984.0,24,13,37,74
37599,China,1984.0,24,13,37,74
37600,China,1984.0,24,13,37,74
37601,China,1984.0,24,13,37,74
37602,China,1984.0,24,13,37,74
37603,China,2016.0,46,30,37,113
37604,China,1988.0,6,16,30,52
37605,China,1988.0,6,16,30,52
37606,China,1988.0,6,16,30,52
37607,China,2004.0,52,27,15,94
37608,China,2008.0,74,53,57,184
37609,China,2008.0,74,53,57,184
37610,China,2000.0,39,23,17,79
37611,China-1,2004.0,52,27,15,94
37612,China,2004.0,52,27,15,94
37613,China,2008.0,74,53,57,184
37614,China,2016.0,46,30,37,113
37615,China,2000.0,39,23,17,79
37616,China,2000.0,39,23,17,79
37617,China,2004.0,52,27,15,94
37618,China,2008.0,74,53,57,184
37619,China,2008.0,74,53,57,184
37620,China,1984.0,24,13,37,74
37621,China,1984.0,24,13,37,74
37622,China,1992.0,18,48,19,85
37623,China,1992.0,18,48,19,85
37624,China,1992.0,18,48,19,85
37625,China,1996.0,19,70,17,106
37626,China,1996.0,19,70,17,106
37627,China,1996.0,19,70,17,106
37628,China,2012.0,56,40,29,125
37629,China,2012.0,56,40,29,125
37630,China,2016.0,46,30,37,113
37631,China,2016.0,46,30,37,113
37632,China,1992.0,18,48,19,85
37633,China,2012.0,56,40,29,125
37634,China,2012.0,56,40,29,125
37635,China,2012.0,56,40,29,125
37636,China,1996.0,19,70,17,106
37637,China,1992.0,18,48,19,85
37638,China,2012.0,56,40,29,125
37639,China,1984.0,24,13,37,74
37640,China,2002.0,2,5,9,16
37641,China-2,1992.0,18,48,19,85
37642,China,2016.0,46,30,37,113
37643,China,1984.0,24,13,37,74
37644,China,1988.0,6,16,30,52
37645,China,2012.0,56,40,29,125
37646,China,1984.0,24,13,37,74
37647,China,1992.0,18,48,19,85
37648,China,2004.0,52,27,15,94
37649,China,2000.0,39,23,17,79
37650,China,2016.0,46,30,37,113
37651,China,1984.0,24,13,37,74
37652,China,2008.0,74,53,57,184
37653,China,2016.0,46,30,37,113
37654,China,2008.0,74,53,57,184
37655,China,2012.0,56,40,29,125
37656,China,2016.0,46,30,37,113
37657,China,1992.0,18,48,19,85
37658,China,1992.0,18,48,19,85
37659,China,1992.0,18,48,19,85
37660,China,1996.0,19,70,17,106
37661,China,2012.0,56,40,29,125
37662,China,1992.0,18,48,19,85
37663,China,2004.0,52,27,15,94
37664,China,2000.0,39,23,17,79
37665,China-2,1992.0,18,48,19,85
37666,China,2008.0,74,53,57,184
37667,China,2016.0,46,30,37,113
37668,China,2000.0,39,23,17,79
37669,China,1996.0,19,70,17,106
37670,China,2004.0,52,27,15,94
37671,China,2008.0,74,53,57,184
37672,China,1996.0,19,70,17,106
37673,China-2,1996.0,19,70,17,106
37674,China,2000.0,39,23,17,79
37675,China-1,2000.0,39,23,17,79
37676,China,2016.0,46,30,37,113
37677,China,2016.0,46,30,37,113
37678,China-2,1996.0,19,70,17,106
37679,China,1992.0,18,48,19,85
37680,China,1996.0,19,70,17,106
37681,China,1984.0,24,13,37,74
37682,China,2008.0,74,53,57,184
37683,China,2012.0,56,40,29,125
37684,China,2012.0,56,40,29,125
37685,China,1984.0,24,13,37,74
37686,China,1992.0,18,48,19,85
37687,China,2016.0,46,30,37,113
37688,China,1988.0,6,16,30,52
37689,China,1992.0,18,48,19,85
37690,China-2,1996.0,19,70,17,106
37691,China,2004.0,52,27,15,94
37692,China,2004.0,52,27,15,94
37693,China,2012.0,56,40,29,125
37694,China,2016.0,46,30,37,113
37695,China,2000.0,39,23,17,79
37696,China,2000.0,39,23,17,79
37697,China,1996.0,19,70,17,106
37698,China,1996.0,19,70,17,106
37699,China,2004.0,52,27,15,94
37700,China,2008.0,74,53,57,184
37701,China,2016.0,46,30,37,113
37702,China,2010.0,9,3,7,19
37703,China,1996.0,19,70,17,106
37704,China,1984.0,24,13,37,74
37705,China,2000.0,39,23,17,79
37706,China,2010.0,9,3,7,19
37707,China,2008.0,74,53,57,184
37708,China,2008.0,74,53,57,184
37709,China,2016.0,46,30,37,113
37710,China,1984.0,24,13,37,74
37711,China,1984.0,24,13,37,74
37712,China,1984.0,24,13,37,74
37713,China,1988.0,6,16,30,52
37714,China,1988.0,6,16,30,52
37715,China,1992.0,18,48,19,85
37716,China,2008.0,74,53,57,184
37717,China,2012.0,56,40,29,125
37718,China,2012.0,56,40,29,125
37719,China,1992.0,18,48,19,85
37720,China,1992.0,18,48,19,85
37721,China,1992.0,18,48,19,85
37722,China-1,1992.0,18,48,19,85
37723,China-1,1996.0,19,70,17,106
37724,China,2012.0,56,40,29,125
37725,China,2016.0,46,30,37,113
37726,China,2016.0,46,30,37,113
37727,China,2012.0,56,40,29,125
37728,China,2008.0,74,53,57,184
37729,China,2008.0,74,53,57,184
37730,China,2012.0,56,40,29,125
37731,China,1984.0,24,13,37,74
37732,China,1992.0,18,48,19,85
37733,China,2004.0,52,27,15,94
37734,China,2008.0,74,53,57,184
37735,China,2012.0,56,40,29,125
37736,China,2012.0,56,40,29,125
37737,China,2004.0,52,27,15,94
37738,China,2012.0,56,40,29,125
37739,China-2,2012.0,56,40,29,125
37740,China-1,2004.0,52,27,15,94
37741,China,2008.0,74,53,57,184
37742,China,2008.0,74,53,57,184
37743,China,2012.0,56,40,29,125
37744,China,2016.0,46,30,37,113
37745,China,2016.0,46,30,37,113
37746,China,1992.0,18,48,19,85
37747,China,1992.0,18,48,19,85
37748,China,1984.0,24,13,37,74
37749,China,1984.0,24,13,37,74
37750,China,2008.0,74,53,57,184
37751,China,1996.0,19,70,17,106
37752,China,2008.0,74,53,57,184
37753,China,2016.0,46,30,37,113
37754,China,2004.0,52,27,15,94
37755,China,2008.0,74,53,57,184
37756,China,2016.0,46,30,37,113
37757,China,1996.0,19,70,17,106
37758,China,2008.0,74,53,57,184
37759,China,1996.0,19,70,17,106
37760,China-2,2004.0,52,27,15,94
37761,China,2000.0,39,23,17,79
37762,China-1,1992.0,18,48,19,85
37763,China,1996.0,19,70,17,106
37764,China,2016.0,46,30,37,113
37765,China,2008.0,74,53,57,184
37766,China,2004.0,52,27,15,94
37767,China,2008.0,74,53,57,184
37768,China,2008.0,74,53,57,184
37769,China,2008.0,74,53,57,184
37770,China-2,2010.0,9,3,7,19
37771,China,2008.0,74,53,57,184
37772,China,2016.0,46,30,37,113
37773,China,2004.0,52,27,15,94
37774,China,1992.0,18,48,19,85
37775,China,1988.0,6,16,30,52
37776,China,1992.0,18,48,19,85
37777,China,1992.0,18,48,19,85
37778,China-2,1992.0,18,48,19,85
37779,China,1996.0,19,70,17,106
37780,China-1,1996.0,19,70,17,106
37781,China-2,1996.0,19,70,17,106
37782,China,2012.0,56,40,29,125
37783,China,2004.0,52,27,15,94
37784,China,2008.0,74,53,57,184
37785,China,2008.0,74,53,57,184
37786,China,2012.0,56,40,29,125
37787,China,2012.0,56,40,29,125
37788,China,2016.0,46,30,37,113
37789,China,1996.0,19,70,17,106
37790,China-1,2000.0,39,23,17,79
37791,China,2012.0,56,40,29,125
37792,China,1984.0,24,13,37,74
37793,China,2008.0,74,53,57,184
37794,China,1992.0,18,48,19,85
37795,China,2012.0,56,40,29,125
37796,China,2016.0,46,30,37,113
37797,China,2006.0,2,5,6,13
37798,China,2016.0,46,30,37,113
37799,China,2008.0,74,53,57,184
37800,China,2000.0,39,23,17,79
37801,China,1996.0,19,70,17,106
37802,China,1996.0,19,70,17,106
37803,China,2016.0,46,30,37,113
37804,China,1996.0,19,70,17,106
37805,China-1,2002.0,2,5,9,16
37806,China-3,2006.0,2,5,6,13
37807,China-1,2010.0,9,3,7,19
37808,China,1992.0,18,48,19,85
37809,China,1996.0,19,70,17,106
37810,China,2000.0,39,23,17,79
37811,China,1996.0,19,70,17,106
37812,China,2016.0,46,30,37,113
37813,China,2014.0,3,4,5,12
37814,China,2016.0,46,30,37,113
37815,China,2016.0,46,30,37,113
37816,China,2016.0,46,30,37,113
37817,China,2004.0,52,27,15,94
37818,China,1996.0,19,70,17,106
37819,China,2012.0,56,40,29,125
37820,China,2016.0,46,30,37,113
37821,China,2004.0,52,27,15,94
37822,China,2008.0,74,53,57,184
37823,China,1984.0,24,13,37,74
37824,China,1988.0,6,16,30,52
37825,China,2008.0,74,53,57,184
37826,China,2012.0,56,40,29,125
37827,China,1996.0,19,70,17,106
37828,China,2008.0,74,53,57,184
37829,China,1998.0,0,9,5,14
37830,China,2002.0,2,5,9,16
37831,China,1996.0,19,70,17,106
37832,China,2004.0,52,27,15,94
37833,China-2,2000.0,39,23,17,79
37834,China,2010.0,9,3,7,19
37835,China-2,1996.0,19,70,17,106
37836,China,1996.0,19,70,17,106
37837,China,2008.0,74,53,57,184
37838,China,1992.0,18,48,19,85
37839,China-1,2004.0,52,27,15,94
37840,China,1996.0,19,70,17,106
37841,China,2012.0,56,40,29,125
37842,China,2016.0,46,30,37,113
37843,China,2016.0,46,30,37,113
37844,China,1984.0,24,13,37,74
37845,China,2016.0,46,30,37,113
37846,China,2012.0,56,40,29,125
37847,China,2012.0,56,40,29,125
37848,China,2012.0,56,40,29,125
37849,China,2012.0,56,40,29,125
37850,China,2016.0,46,30,37,113
37851,China,2016.0,46,30,37,113
37852,China,2008.0,74,53,57,184
37853,China,2016.0,46,30,37,113
37854,China,2016.0,46,30,37,113
37855,China,1996.0,19,70,17,106
37856,China,2012.0,56,40,29,125
37857,China,2012.0,56,40,29,125
37858,China,2016.0,46,30,37,113
37859,China,2016.0,46,30,37,113
37860,China,1984.0,24,13,37,74
37861,China,1988.0,6,16,30,52
37862,China,1992.0,18,48,19,85
37863,China,2008.0,74,53,57,184
37864,China,2004.0,52,27,15,94
37865,China,2008.0,74,53,57,184
37866,China,2008.0,74,53,57,184
37867,China,2008.0,74,53,57,184
37868,China,2008.0,74,53,57,184
37869,China,2004.0,52,27,15,94
37870,China,2008.0,74,53,57,184
37871,China,1992.0,18,48,19,85
37872,China,2000.0,39,23,17,79
37873,China,1996.0,19,70,17,106
37874,China,2016.0,46,30,37,113
37875,China,2012.0,56,40,29,125
37876,China,1996.0,19,70,17,106
37877,China,1996.0,19,70,17,106
37878,China,2000.0,39,23,17,79
37879,China,2000.0,39,23,17,79
37880,China,2004.0,52,27,15,94
37881,China-2,1992.0,18,48,19,85
37882,China-1,2008.0,74,53,57,184
37883,China,2000.0,39,23,17,79
37884,China,2000.0,39,23,17,79
37885,China,2004.0,52,27,15,94
37886,China,2004.0,52,27,15,94
37887,China-1,2012.0,56,40,29,125
37888,China,2016.0,46,30,37,113
37889,China,1984.0,24,13,37,74
37890,China,1984.0,24,13,37,74
37891,China-2,2010.0,9,3,7,19
37892,China,2008.0,74,53,57,184
37893,China,2012.0,56,40,29,125
37894,China,2010.0,9,3,7,19
37895,China,2010.0,9,3,7,19
37896,China,2004.0,52,27,15,94
37897,China,1998.0,0,9,5,14
37898,China,2002.0,2,5,9,16
37899,China,2002.0,2,5,9,16
37900,China,1992.0,18,48,19,85
37901,China,2008.0,74,53,57,184
37902,China,2000.0,39,23,17,79
37903,China,2004.0,52,27,15,94
37904,China,2004.0,52,27,15,94
37905,China,2008.0,74,53,57,184
37906,China,2008.0,74,53,57,184
37907,China,2012.0,56,40,29,125
37908,China,2012.0,56,40,29,125
37909,China,2012.0,56,40,29,125
37910,China,1992.0,18,48,19,85
37911,China,1992.0,18,48,19,85
37912,China,2008.0,74,53,57,184
37913,China-1,2008.0,74,53,57,184
37914,China,1984.0,24,13,37,74
37915,China,1996.0,19,70,17,106
37916,China,1996.0,19,70,17,106
37917,China,2004.0,52,27,15,94
37918,China,1996.0,19,70,17,106
37919,China,1996.0,19,70,17,106
37920,China,2004.0,52,27,15,94
37921,China,1984.0,24,13,37,74
37922,China,1996.0,19,70,17,106
37923,China,2000.0,39,23,17,79
37924,China-2,2000.0,39,23,17,79
37925,China,2004.0,52,27,15,94
37926,China,2008.0,74,53,57,184
37927,China,2008.0,74,53,57,184
37928,China,2006.0,2,5,6,13
37929,China,2006.0,2,5,6,13
37930,China,2006.0,2,5,6,13
37931,China,2006.0,2,5,6,13
37932,China,2010.0,9,3,7,19
37933,China,2010.0,9,3,7,19
37934,China,2010.0,9,3,7,19
37935,China,2012.0,56,40,29,125
37936,China,1984.0,24,13,37,74
37937,China,2008.0,74,53,57,184
37938,China,2000.0,39,23,17,79
37939,China-1,2000.0,39,23,17,79
37940,China-1,2004.0,52,27,15,94
37941,China,2008.0,74,53,57,184
37942,China,2008.0,74,53,57,184
37943,China,2016.0,46,30,37,113
37944,China-1,1992.0,18,48,19,85
37945,China,1996.0,19,70,17,106
37946,China-1,1996.0,19,70,17,106
37947,China,1996.0,19,70,17,106
37948,China,1992.0,18,48,19,85
37949,China,1992.0,18,48,19,85
37950,China,2008.0,74,53,57,184
37951,China,2008.0,74,53,57,184
37952,China,2004.0,52,27,15,94
37953,China,1988.0,6,16,30,52
37954,China,2016.0,46,30,37,113
37955,China,1996.0,19,70,17,106
37956,China,1996.0,19,70,17,106
37957,China,1984.0,24,13,37,74
37958,China,1992.0,18,48,19,85
37959,China,1992.0,18,48,19,85
37960,China,1996.0,19,70,17,106
37961,China,2000.0,39,23,17,79
37962,China,2004.0,52,27,15,94
37963,China,2012.0,56,40,29,125
37964,China,2008.0,74,53,57,184
37965,China,1996.0,19,70,17,106
37966,China,2012.0,56,40,29,125
37967,China,2016.0,46,30,37,113
37968,China,2004.0,52,27,15,94
37969,China,2012.0,56,40,29,125
37970,China,1996.0,19,70,17,106
37971,China,1996.0,19,70,17,106
37972,China,2004.0,52,27,15,94
37973,China,2012.0,56,40,29,125
37974,China,1996.0,19,70,17,106
37975,China,2008.0,74,53,57,184
37976,China,2016.0,46,30,37,113
37977,China-2,2008.0,74,53,57,184
37978,China,1996.0,19,70,17,106
37979,China,2014.0,3,4,5,12
37980,China,2014.0,3,4,5,12
37981,China,1988.0,6,16,30,52
37982,China,2004.0,52,27,15,94
37983,China,1984.0,24,13,37,74
37984,China,2012.0,56,40,29,125
37985,China,2008.0,74,53,57,184
37986,China,2012.0,56,40,29,125
37987,China,2004.0,52,27,15,94
37988,China,2004.0,52,27,15,94
37989,China,2004.0,52,27,15,94
37990,China,2008.0,74,53,57,184
37991,China,2008.0,74,53,57,184
37992,China,2012.0,56,40,29,125
37993,China,2012.0,56,40,29,125
37994,China,2016.0,46,30,37,113
37995,China,1984.0,24,13,37,74
37996,China,2000.0,39,23,17,79
37997,China,1984.0,24,13,37,74
37998,China,1984.0,24,13,37,74
37999,China,1984.0,24,13,37,74
38000,China,2012.0,56,40,29,125
38001,China,1996.0,19,70,17,106
38002,China,2008.0,74,53,57,184
38003,China,2008.0,74,53,57,184
38004,China,2000.0,39,23,17,79
38005,China,2004.0,52,27,15,94
38006,China,2008.0,74,53,57,184
38007,China,2016.0,46,30,37,113
38008,China,1996.0,19,70,17,106
38009,China,2000.0,39,23,17,79
38010,China,1996.0,19,70,17,106
38011,China,1996.0,19,70,17,106
38012,China,2000.0,39,23,17,79
38013,China,2008.0,74,53,57,184
38014,China,2008.0,74,53,57,184
38015,China,1996.0,19,70,17,106
38016,China,2008.0,74,53,57,184
38017,China,2000.0,39,23,17,79
38018,China,2004.0,52,27,15,94
38019,China,1988.0,6,16,30,52
38020,China,1992.0,18,48,19,85
38021,China,1996.0,19,70,17,106
38022,China,2000.0,39,23,17,79
38023,China,2000.0,39,23,17,79
38024,China,1984.0,24,13,37,74
38025,China,2012.0,56,40,29,125
38026,China,2016.0,46,30,37,113
38027,China-2,2012.0,56,40,29,125
38028,China,2012.0,56,40,29,125
38029,China,1984.0,24,13,37,74
38030,China,1988.0,6,16,30,52
38031,China,1996.0,19,70,17,106
38032,China,2016.0,46,30,37,113
38033,China,2012.0,56,40,29,125
38034,China,2008.0,74,53,57,184
38035,China,2008.0,74,53,57,184
38036,China,2012.0,56,40,29,125
38037,China,2012.0,56,40,29,125
38038,China,2014.0,3,4,5,12
38039,China,1998.0,0,9,5,14
38040,China,2008.0,74,53,57,184
38041,China,2016.0,46,30,37,113
38042,China,2008.0,74,53,57,184
38043,China,1988.0,6,16,30,52
38044,China,2004.0,52,27,15,94
38045,China,2008.0,74,53,57,184
38046,China,2016.0,46,30,37,113
38047,China,1984.0,24,13,37,74
38048,China-2,2008.0,74,53,57,184
38049,China,2008.0,74,53,57,184
38050,China,2008.0,74,53,57,184
38051,China,1996.0,19,70,17,106
38052,China,2016.0,46,30,37,113
38053,China-2,2000.0,39,23,17,79
38054,China-1,2008.0,74,53,57,184
38055,China,2016.0,46,30,37,113
38056,China,2004.0,52,27,15,94
38057,China,2008.0,74,53,57,184
38058,China,2004.0,52,27,15,94
38059,China,1996.0,19,70,17,106
38060,China,2000.0,39,23,17,79
38061,China,2000.0,39,23,17,79
38062,China,2000.0,39,23,17,79
38063,China-1,2004.0,52,27,15,94
38064,China,2000.0,39,23,17,79
38065,China,2000.0,39,23,17,79
38066,China,2008.0,74,53,57,184
38067,China,2008.0,74,53,57,184
38068,China,2008.0,74,53,57,184
38069,China,2004.0,52,27,15,94
38070,China,2008.0,74,53,57,184
38071,China,1988.0,6,16,30,52
38072,China,1992.0,18,48,19,85
38073,China,1992.0,18,48,19,85
38074,China,2000.0,39,23,17,79
38075,China,1988.0,6,16,30,52
38076,China,1988.0,6,16,30,52
38077,China,1984.0,24,13,37,74
38078,China,1988.0,6,16,30,52
38079,China,1984.0,24,13,37,74
38080,China,1988.0,6,16,30,52
38081,China,2008.0,74,53,57,184
38082,China,1998.0,0,9,5,14
38083,China,2002.0,2,5,9,16
38084,China,2002.0,2,5,9,16
38085,China,2002.0,2,5,9,16
38086,China,2006.0,2,5,6,13
38087,China,1998.0,0,9,5,14
38088,China,1998.0,0,9,5,14
38089,China,1998.0,0,9,5,14
38090,China,2002.0,2,5,9,16
38091,China,2002.0,2,5,9,16
38092,China,2008.0,74,53,57,184
38093,China,2008.0,74,53,57,184
38094,China,2008.0,74,53,57,184
38095,China-2,2000.0,39,23,17,79
38096,China,2004.0,52,27,15,94
38097,China,2008.0,74,53,57,184
38098,China,2000.0,39,23,17,79
38099,China-2,1992.0,18,48,19,85
38100,China,1984.0,24,13,37,74
38101,China,2000.0,39,23,17,79
38102,China,2004.0,52,27,15,94
38103,China,1988.0,6,16,30,52
38104,China,1992.0,18,48,19,85
38105,China,1992.0,18,48,19,85
38106,China,1994.0,0,1,2,3
38107,China,2012.0,56,40,29,125
38108,China,2012.0,56,40,29,125
38109,China,2000.0,39,23,17,79
38110,China,2012.0,56,40,29,125
38111,China,2016.0,46,30,37,113
38112,China,2016.0,46,30,37,113
38113,China,2004.0,52,27,15,94
38114,China,2008.0,74,53,57,184
38115,China,2016.0,46,30,37,113
38116,China,2016.0,46,30,37,113
38117,China,2012.0,56,40,29,125
38118,China,1996.0,19,70,17,106
38119,China,2016.0,46,30,37,113
38120,China-1,2008.0,74,53,57,184
38121,China-1,2008.0,74,53,57,184
38122,China,1996.0,19,70,17,106
38123,China,2000.0,39,23,17,79
38124,China,2016.0,46,30,37,113
38125,China,1998.0,0,9,5,14
38126,China,2010.0,9,3,7,19
38127,China,1984.0,24,13,37,74
38128,China,2016.0,46,30,37,113
38129,China,1992.0,18,48,19,85
38130,China,1996.0,19,70,17,106
38131,China,2000.0,39,23,17,79
38132,China,2016.0,46,30,37,113
38133,China,1996.0,19,70,17,106
38134,China,2016.0,46,30,37,113
38135,China,2012.0,56,40,29,125
38136,China,2016.0,46,30,37,113
38137,China,1996.0,19,70,17,106
38138,China-1,2006.0,2,5,6,13
38139,China,1992.0,18,48,19,85
38140,China,2016.0,46,30,37,113
38141,China,2004.0,52,27,15,94
38142,China-1,2006.0,2,5,6,13
38143,China,2014.0,3,4,5,12
38144,China,1984.0,24,13,37,74
38145,China,2010.0,9,3,7,19
38146,China-1,2004.0,52,27,15,94
38147,China,2012.0,56,40,29,125
38148,China,2012.0,56,40,29,125
38149,China,2016.0,46,30,37,113
38150,China,2016.0,46,30,37,113
38151,China,1996.0,19,70,17,106
38152,China,2004.0,52,27,15,94
38153,China,2008.0,74,53,57,184
38154,China,2008.0,74,53,57,184
38155,China-2,2000.0,39,23,17,79
38156,China-2,2004.0,52,27,15,94
38157,China,2008.0,74,53,57,184
38158,China,2016.0,46,30,37,113
38159,China,2004.0,52,27,15,94
38160,China,2008.0,74,53,57,184
38161,China-1,2012.0,56,40,29,125
38162,China-1,2016.0,46,30,37,113
38163,China-1,2016.0,46,30,37,113
38164,China,2004.0,52,27,15,94
38165,China,2004.0,52,27,15,94
38166,China,2008.0,74,53,57,184
38167,China,1984.0,24,13,37,74
38168,China,2004.0,52,27,15,94
38169,China,1984.0,24,13,37,74
38170,China,1992.0,18,48,19,85
38171,China,2008.0,74,53,57,184
38172,China,1984.0,24,13,37,74
38173,China,2008.0,74,53,57,184
38174,China,2016.0,46,30,37,113
38175,China-2,2008.0,74,53,57,184
38176,China,1988.0,6,16,30,52
38177,China,1988.0,6,16,30,52
38178,China,1996.0,19,70,17,106
38179,China,2000.0,39,23,17,79
38180,China,2008.0,74,53,57,184
38181,China,1992.0,18,48,19,85
38182,China,2008.0,74,53,57,184
38183,China,2008.0,74,53,57,184
38184,China,1996.0,19,70,17,106
38185,China,1988.0,6,16,30,52
38186,China,2008.0,74,53,57,184
38187,China,1994.0,0,1,2,3
38188,China,2012.0,56,40,29,125
38189,China-2,2008.0,74,53,57,184
38190,China,2008.0,74,53,57,184
38191,China,2004.0,52,27,15,94
38192,China-1,2004.0,52,27,15,94
38193,China,2008.0,74,53,57,184
38194,China,2008.0,74,53,57,184
38195,China,2004.0,52,27,15,94
38196,China,1984.0,24,13,37,74
38197,China,2008.0,74,53,57,184
38198,China-1,2002.0,2,5,9,16
38199,China-3,2006.0,2,5,6,13
38200,China-1,2010.0,9,3,7,19
38201,China,2008.0,74,53,57,184
38202,China,1992.0,18,48,19,85
38203,China,1996.0,19,70,17,106
38204,China,2004.0,52,27,15,94
38205,China,2008.0,74,53,57,184
38206,China,2016.0,46,30,37,113
38207,China,2008.0,74,53,57,184
38208,China-1,2012.0,56,40,29,125
38209,China-1,2012.0,56,40,29,125
38210,China-1,2016.0,46,30,37,113
38211,China,1992.0,18,48,19,85
38212,China,1984.0,24,13,37,74
38213,China,1992.0,18,48,19,85
38214,China-1,2008.0,74,53,57,184
38215,China,2000.0,39,23,17,79
38216,China,1984.0,24,13,37,74
38217,China,1988.0,6,16,30,52
38218,China,2016.0,46,30,37,113
38219,China,2008.0,74,53,57,184
38220,China,2016.0,46,30,37,113
38221,China,2008.0,74,53,57,184
38222,China,1984.0,24,13,37,74
38223,China,2012.0,56,40,29,125
38224,China,2008.0,74,53,57,184
38225,China,2004.0,52,27,15,94
38226,China,1984.0,24,13,37,74
38227,China,1984.0,24,13,37,74
38228,China,1984.0,24,13,37,74
38229,China,1988.0,6,16,30,52
38230,China,1988.0,6,16,30,52
38231,China,2004.0,52,27,15,94
38232,China,2008.0,74,53,57,184
38233,China,2008.0,74,53,57,184
38234,China,1988.0,6,16,30,52
38235,China,2008.0,74,53,57,184
38236,China,2010.0,9,3,7,19
38237,China,2010.0,9,3,7,19
38238,China,2010.0,9,3,7,19
38239,China,2014.0,3,4,5,12
38240,China,2008.0,74,53,57,184
38241,China,1984.0,24,13,37,74
38242,China,1984.0,24,13,37,74
38243,China,1984.0,24,13,37,74
38244,China,2008.0,74,53,57,184
38245,China,2004.0,52,27,15,94
38246,China,2008.0,74,53,57,184
38247,China,2016.0,46,30,37,113
38248,China,2004.0,52,27,15,94
38249,China,1992.0,18,48,19,85
38250,China,1988.0,6,16,30,52
38251,China,1992.0,18,48,19,85
38252,China,1992.0,18,48,19,85
38253,China,1992.0,18,48,19,85
38254,China,2008.0,74,53,57,184
38255,China,2008.0,74,53,57,184
38256,China,2008.0,74,53,57,184
38257,China,2012.0,56,40,29,125
38258,China,2012.0,56,40,29,125
38259,China,2012.0,56,40,29,125
38260,China,2004.0,52,27,15,94
38261,China,2008.0,74,53,57,184
38262,China,2012.0,56,40,29,125
38263,Yugoslavia,1980.0,13,27,17,57
38264,Yugoslavia,1984.0,47,6,35,88
38265,Yugoslavia,1984.0,47,6,35,88
38266,Yugoslavia,1988.0,15,32,22,69
38267,Yugoslavia,1960.0,16,1,0,17
38268,Yugoslavia,1956.0,0,23,0,23
38269,Yugoslavia,1928.0,1,1,10,12
38270,Yugoslavia,1988.0,15,32,22,69
38271,Yugoslavia,1988.0,15,32,22,69
38272,Yugoslavia,1984.0,47,6,35,88
38273,Yugoslavia,1972.0,15,1,2,18
38274,Yugoslavia,1948.0,0,16,0,16
38275,Yugoslavia,1988.0,15,32,22,69
38276,Yugoslavia,1952.0,4,20,0,24
38277,Yugoslavia,1984.0,47,6,35,88
38278,Yugoslavia,1984.0,47,6,35,88
38279,Yugoslavia,1988.0,15,32,22,69
38280,Yugoslavia,1984.0,47,6,35,88
38281,Yugoslavia,1952.0,4,20,0,24
38282,Yugoslavia,1980.0,13,27,17,57
38283,Yugoslavia,1984.0,47,6,35,88
38284,Yugoslavia,1980.0,13,27,17,57
38285,Yugoslavia,1988.0,15,32,22,69
38286,Yugoslavia,1956.0,0,23,0,23
38287,Yugoslavia,1980.0,13,27,17,57
38288,Yugoslavia,1968.0,13,14,2,29
38289,Yugoslavia,1968.0,13,14,2,29
38290,Yugoslavia,1948.0,0,16,0,16
38291,Yugoslavia,1952.0,4,20,0,24
38292,Yugoslavia,1952.0,4,20,0,24
38293,Yugoslavia,1964.0,2,11,2,15
38294,Yugoslavia,1968.0,13,14,2,29
38295,Yugoslavia,1952.0,4,20,0,24
38296,Yugoslavia,1952.0,4,20,0,24
38297,Yugoslavia,1948.0,0,16,0,16
38298,Yugoslavia,1984.0,47,6,35,88
38299,Yugoslavia,1988.0,15,32,22,69
38300,Yugoslavia,1948.0,0,16,0,16
38301,Yugoslavia,1948.0,0,16,0,16
38302,Yugoslavia,1952.0,4,20,0,24
38303,Yugoslavia,1984.0,47,6,35,88
38304,Yugoslavia,1980.0,13,27,17,57
38305,Yugoslavia,1964.0,2,11,2,15
38306,Yugoslavia,1964.0,2,11,2,15
38307,Yugoslavia,1968.0,13,14,2,29
38308,Yugoslavia,1968.0,13,14,2,29
38309,Yugoslavia,1948.0,0,16,0,16
38310,Yugoslavia,1928.0,1,1,10,12
38311,Yugoslavia,1956.0,0,23,0,23
38312,Yugoslavia,1972.0,15,1,2,18
38313,Yugoslavia,1968.0,13,14,2,29
38314,Yugoslavia,1976.0,2,14,3,19
38315,Yugoslavia,1980.0,13,27,17,57
38316,Yugoslavia,1952.0,4,20,0,24
38317,Yugoslavia,1984.0,47,6,35,88
38318,Yugoslavia,1988.0,15,32,22,69
38319,Yugoslavia,1984.0,47,6,35,88
38320,Yugoslavia,1968.0,13,14,2,29
38321,Yugoslavia,1988.0,15,32,22,69
38322,Yugoslavia,1968.0,13,14,2,29
38323,Yugoslavia,1976.0,2,14,3,19
38324,Yugoslavia,1980.0,13,27,17,57
38325,Yugoslavia,1984.0,47,6,35,88
38326,Yugoslavia,1968.0,13,14,2,29
38327,Yugoslavia,1980.0,13,27,17,57
38328,Yugoslavia,1984.0,47,6,35,88
38329,Yugoslavia,1988.0,15,32,22,69
38330,Yugoslavia,1988.0,15,32,22,69
38331,Yugoslavia,1976.0,2,14,3,19
38332,Yugoslavia,1980.0,13,27,17,57
38333,Yugoslavia,1928.0,1,1,10,12
38334,Yugoslavia,1928.0,1,1,10,12
38335,Yugoslavia,1980.0,13,27,17,57
38336,Yugoslavia,1984.0,47,6,35,88
38337,Yugoslavia,1988.0,15,32,22,69
38338,Yugoslavia,1984.0,47,6,35,88
38339,Yugoslavia,1988.0,15,32,22,69
38340,Yugoslavia,1980.0,13,27,17,57
38341,Yugoslavia,1960.0,16,1,0,17
38342,Yugoslavia,1984.0,47,6,35,88
38343,Yugoslavia,1988.0,15,32,22,69
38344,Yugoslavia,1980.0,13,27,17,57
38345,Yugoslavia,1984.0,47,6,35,88
38346,Yugoslavia,1980.0,13,27,17,57
38347,Yugoslavia,1984.0,47,6,35,88
38348,Yugoslavia,1980.0,13,27,17,57
38349,Yugoslavia,1984.0,47,6,35,88
38350,Yugoslavia,1984.0,47,6,35,88
38351,Yugoslavia,1984.0,47,6,35,88
38352,Yugoslavia,1972.0,15,1,2,18
38353,Yugoslavia,1988.0,15,32,22,69
38354,Yugoslavia,1956.0,0,23,0,23
38355,Yugoslavia,1984.0,47,6,35,88
38356,Yugoslavia,1976.0,2,14,3,19
38357,Yugoslavia,1960.0,16,1,0,17
38358,Yugoslavia,1976.0,2,14,3,19
38359,Yugoslavia,1988.0,15,32,22,69
38360,Yugoslavia,1988.0,15,32,22,69
38361,Yugoslavia,1980.0,13,27,17,57
38362,Yugoslavia,1984.0,47,6,35,88
38363,Yugoslavia,1928.0,1,1,10,12
38364,Yugoslavia,1948.0,0,16,0,16
38365,Yugoslavia,1984.0,47,6,35,88
38366,Yugoslavia,1984.0,47,6,35,88
38367,Yugoslavia,1968.0,13,14,2,29
38368,Yugoslavia,1988.0,15,32,22,69
38369,Yugoslavia,1972.0,15,1,2,18
38370,Yugoslavia,1952.0,4,20,0,24
38371,Yugoslavia,1968.0,13,14,2,29
38372,Yugoslavia,1980.0,13,27,17,57
38373,Yugoslavia,1984.0,47,6,35,88
38374,Yugoslavia,1984.0,47,6,35,88
38375,Yugoslavia,1952.0,4,20,0,24
38376,Yugoslavia,1956.0,0,23,0,23
38377,Yugoslavia,1984.0,47,6,35,88
38378,Yugoslavia,1984.0,47,6,35,88
38379,Yugoslavia,1964.0,2,11,2,15
38380,Yugoslavia,1968.0,13,14,2,29
38381,Yugoslavia,1988.0,15,32,22,69
38382,Yugoslavia,1976.0,2,14,3,19
38383,Yugoslavia,1980.0,13,27,17,57
38384,Yugoslavia,1976.0,2,14,3,19
38385,Yugoslavia,1980.0,13,27,17,57
38386,Yugoslavia,1952.0,4,20,0,24
38387,Yugoslavia,1956.0,0,23,0,23
38388,Yugoslavia,1984.0,47,6,35,88
38389,Yugoslavia,1948.0,0,16,0,16
38390,Yugoslavia,1984.0,47,6,35,88
38391,Yugoslavia,1960.0,16,1,0,17
38392,Yugoslavia,1980.0,13,27,17,57
38393,Yugoslavia,1976.0,2,14,3,19
38394,Yugoslavia,1956.0,0,23,0,23
38395,Yugoslavia,1984.0,47,6,35,88
38396,Yugoslavia,1972.0,15,1,2,18
38397,Yugoslavia,1984.0,47,6,35,88
38398,Yugoslavia,1976.0,2,14,3,19
38399,Yugoslavia,1980.0,13,27,17,57
38400,Yugoslavia,1976.0,2,14,3,19
38401,Yugoslavia,1980.0,13,27,17,57
38402,Yugoslavia,1984.0,47,6,35,88
38403,Yugoslavia,1960.0,16,1,0,17
38404,Yugoslavia,1980.0,13,27,17,57
38405,Yugoslavia,1984.0,47,6,35,88
38406,Yugoslavia,1980.0,13,27,17,57
38407,Yugoslavia,1968.0,13,14,2,29
38408,Yugoslavia,1956.0,0,23,0,23
38409,Yugoslavia,1960.0,16,1,0,17
38410,Yugoslavia,1980.0,13,27,17,57
38411,Yugoslavia,1952.0,4,20,0,24
38412,Yugoslavia,1956.0,0,23,0,23
38413,Yugoslavia,1960.0,16,1,0,17
38414,Yugoslavia,1980.0,13,27,17,57
38415,Yugoslavia,1984.0,47,6,35,88
38416,Yugoslavia,1956.0,0,23,0,23
38417,Yugoslavia,1980.0,13,27,17,57
38418,Yugoslavia,1988.0,15,32,22,69
38419,Yugoslavia,1952.0,4,20,0,24
38420,Yugoslavia,1984.0,47,6,35,88
38421,Yugoslavia,1988.0,15,32,22,69
38422,Yugoslavia,1988.0,15,32,22,69
38423,Yugoslavia,1988.0,15,32,22,69
38424,Yugoslavia,1972.0,15,1,2,18
38425,Yugoslavia,1972.0,15,1,2,18
38426,Yugoslavia,1988.0,15,32,22,69
38427,Yugoslavia,1956.0,0,23,0,23
38428,Yugoslavia,1984.0,47,6,35,88
38429,Yugoslavia,1976.0,2,14,3,19
38430,Yugoslavia,1976.0,2,14,3,19
38431,Yugoslavia,1984.0,47,6,35,88
38432,Yugoslavia,1984.0,47,6,35,88
38433,Yugoslavia,1968.0,13,14,2,29
38434,Yugoslavia,1948.0,0,16,0,16
38435,Yugoslavia,1980.0,13,27,17,57
38436,Yugoslavia,1988.0,15,32,22,69
38437,Yugoslavia,1984.0,47,6,35,88
38438,Yugoslavia,1988.0,15,32,22,69
38439,Yugoslavia,1980.0,13,27,17,57
38440,Yugoslavia,1988.0,15,32,22,69
38441,Yugoslavia,1928.0,1,1,10,12
38442,Yugoslavia,1980.0,13,27,17,57
38443,Yugoslavia,1960.0,16,1,0,17
38444,Yugoslavia,1968.0,13,14,2,29
38445,Yugoslavia,1968.0,13,14,2,29
38446,Yugoslavia,1960.0,16,1,0,17
38447,Yugoslavia,1964.0,2,11,2,15
38448,Yugoslavia,1960.0,16,1,0,17
38449,Yugoslavia,1988.0,15,32,22,69
38450,Yugoslavia,1984.0,47,6,35,88
38451,Yugoslavia,1948.0,0,16,0,16
38452,Yugoslavia,1956.0,0,23,0,23
38453,Yugoslavia,1984.0,47,6,35,88
38454,Yugoslavia,1988.0,15,32,22,69
38455,Yugoslavia,1972.0,15,1,2,18
38456,Yugoslavia,1984.0,47,6,35,88
38457,Yugoslavia,1988.0,15,32,22,69
38458,Yugoslavia,1980.0,13,27,17,57
38459,Yugoslavia,1972.0,15,1,2,18
38460,Yugoslavia,1948.0,0,16,0,16
38461,Yugoslavia,1952.0,4,20,0,24
38462,Yugoslavia,1980.0,13,27,17,57
38463,Yugoslavia,1984.0,47,6,35,88
38464,Yugoslavia,1980.0,13,27,17,57
38465,Yugoslavia,1984.0,47,6,35,88
38466,Yugoslavia,1984.0,47,6,35,88
38467,Yugoslavia,1984.0,47,6,35,88
38468,Yugoslavia,1988.0,15,32,22,69
38469,Yugoslavia,1956.0,0,23,0,23
38470,Yugoslavia,1988.0,15,32,22,69
38471,Yugoslavia,1964.0,2,11,2,15
38472,Yugoslavia,1980.0,13,27,17,57
38473,Yugoslavia,1984.0,47,6,35,88
38474,Yugoslavia,1988.0,15,32,22,69
38475,Yugoslavia,1988.0,15,32,22,69
38476,Yugoslavia,1980.0,13,27,17,57
38477,Yugoslavia,1984.0,47,6,35,88
38478,Yugoslavia,1964.0,2,11,2,15
38479,Yugoslavia,1972.0,15,1,2,18
38480,Yugoslavia,1984.0,47,6,35,88
38481,Yugoslavia,1984.0,47,6,35,88
38482,Yugoslavia,1984.0,47,6,35,88
38483,Yugoslavia,1964.0,2,11,2,15
38484,Yugoslavia,1976.0,2,14,3,19
38485,Yugoslavia,1988.0,15,32,22,69
38486,Yugoslavia,1952.0,4,20,0,24
38487,Yugoslavia,1980.0,13,27,17,57
38488,Yugoslavia,1984.0,47,6,35,88
38489,Yugoslavia,1980.0,13,27,17,57
38490,Yugoslavia,1980.0,13,27,17,57
38491,Yugoslavia,1984.0,47,6,35,88
38492,Yugoslavia,1956.0,0,23,0,23
38493,Yugoslavia,1972.0,15,1,2,18
38494,Yugoslavia,1984.0,47,6,35,88
38495,Yugoslavia,1988.0,15,32,22,69
38496,Yugoslavia,1988.0,15,32,22,69
38497,Yugoslavia,1984.0,47,6,35,88
38498,Yugoslavia,1980.0,13,27,17,57
38499,Yugoslavia,1980.0,13,27,17,57
38500,Yugoslavia,1968.0,13,14,2,29
38501,Yugoslavia,1988.0,15,32,22,69
38502,Yugoslavia,1988.0,15,32,22,69
38503,Yugoslavia,1960.0,16,1,0,17
38504,Yugoslavia,1976.0,2,14,3,19
38505,Yugoslavia,1984.0,47,6,35,88
38506,Yugoslavia,1984.0,47,6,35,88
38507,Yugoslavia,1988.0,15,32,22,69
38508,Yugoslavia,1984.0,47,6,35,88
38509,Yugoslavia,1968.0,13,14,2,29
38510,Yugoslavia,1972.0,15,1,2,18
38511,Yugoslavia,1980.0,13,27,17,57
38512,Yugoslavia,1968.0,13,14,2,29
38513,Yugoslavia,1984.0,47,6,35,88
38514,Yugoslavia,1972.0,15,1,2,18
38515,Yugoslavia,1928.0,1,1,10,12
38516,Yugoslavia,1988.0,15,32,22,69
38517,Yugoslavia,1988.0,15,32,22,69
38518,Yugoslavia,1988.0,15,32,22,69
38519,Yugoslavia,1972.0,15,1,2,18
38520,Yugoslavia,1988.0,15,32,22,69
38521,Yugoslavia,1928.0,1,1,10,12
38522,Yugoslavia,1928.0,1,1,10,12
38523,Yugoslavia,1984.0,47,6,35,88
38524,Yugoslavia,1988.0,15,32,22,69
38525,Yugoslavia,1984.0,47,6,35,88
38526,Yugoslavia,1988.0,15,32,22,69
38527,Yugoslavia,1984.0,47,6,35,88
38528,Yugoslavia,1984.0,47,6,35,88
38529,Yugoslavia,1956.0,0,23,0,23
38530,Yugoslavia,1952.0,4,20,0,24
38531,Yugoslavia,1956.0,0,23,0,23
38532,Yugoslavia,1980.0,13,27,17,57
38533,Yugoslavia,1984.0,47,6,35,88
38534,Yugoslavia,1956.0,0,23,0,23
38535,Yugoslavia,1980.0,13,27,17,57
38536,Yugoslavia,1988.0,15,32,22,69
38537,Yugoslavia,1968.0,13,14,2,29
38538,Yugoslavia,1968.0,13,14,2,29
38539,Yugoslavia,1988.0,15,32,22,69
38540,Yugoslavia,1988.0,15,32,22,69
38541,Yugoslavia,1984.0,47,6,35,88
38542,Yugoslavia,1984.0,47,6,35,88
38543,Yugoslavia,1980.0,13,27,17,57
38544,Yugoslavia,1984.0,47,6,35,88
38545,Yugoslavia,1988.0,15,32,22,69
38546,Yugoslavia,1960.0,16,1,0,17
38547,Yugoslavia,1980.0,13,27,17,57
38548,Yugoslavia,1984.0,47,6,35,88
38549,Yugoslavia,1964.0,2,11,2,15
38550,Yugoslavia,1980.0,13,27,17,57
38551,Yugoslavia,1976.0,2,14,3,19
38552,Yugoslavia,1984.0,47,6,35,88
38553,Yugoslavia,1964.0,2,11,2,15
38554,Yugoslavia,1968.0,13,14,2,29
38555,Yugoslavia,1956.0,0,23,0,23
38556,Yugoslavia,1988.0,15,32,22,69
38557,Yugoslavia,1980.0,13,27,17,57
38558,Yugoslavia,1952.0,4,20,0,24
38559,Yugoslavia,1980.0,13,27,17,57
38560,Yugoslavia,1984.0,47,6,35,88
38561,Yugoslavia,1988.0,15,32,22,69
38562,Yugoslavia,1988.0,15,32,22,69
38563,Yugoslavia,1956.0,0,23,0,23
38564,Yugoslavia,1988.0,15,32,22,69
38565,Yugoslavia,1964.0,2,11,2,15
38566,Yugoslavia,1964.0,2,11,2,15
38567,Yugoslavia,1968.0,13,14,2,29
38568,Yugoslavia,1968.0,13,14,2,29
38569,Yugoslavia,1988.0,15,32,22,69
38570,Yugoslavia,1980.0,13,27,17,57
38571,Yugoslavia,1976.0,2,14,3,19
38572,Yugoslavia,1980.0,13,27,17,57
38573,Yugoslavia,1984.0,47,6,35,88
38574,Yugoslavia,1988.0,15,32,22,69
38575,Yugoslavia,1968.0,13,14,2,29
38576,Yugoslavia,1976.0,2,14,3,19
38577,Yugoslavia,1960.0,16,1,0,17
38578,Yugoslavia,1960.0,16,1,0,17
38579,Yugoslavia,1988.0,15,32,22,69
38580,Yugoslavia,1948.0,0,16,0,16
38581,Yugoslavia,1956.0,0,23,0,23
38582,Yugoslavia,1952.0,4,20,0,24
38583,Yugoslavia,1964.0,2,11,2,15
38584,Yugoslavia,1948.0,0,16,0,16
38585,Yugoslavia,1952.0,4,20,0,24
38586,Yugoslavia,1980.0,13,27,17,57
38587,Yugoslavia,1984.0,47,6,35,88
38588,Yugoslavia,1964.0,2,11,2,15
38589,Yugoslavia,1968.0,13,14,2,29
38590,Yugoslavia,1984.0,47,6,35,88
38591,Yugoslavia,1984.0,47,6,35,88
38592,Yugoslavia,1924.0,2,0,0,2
38593,Yugoslavia,1924.0,2,0,0,2
38594,Yugoslavia,1928.0,1,1,10,12
38595,Yugoslavia,1928.0,1,1,10,12
38596,Yugoslavia,1928.0,1,1,10,12
38597,Yugoslavia,1936.0,0,1,0,1
38598,Yugoslavia,1984.0,47,6,35,88
38599,Yugoslavia,1984.0,47,6,35,88
38600,Yugoslavia,1988.0,15,32,22,69
38601,Yugoslavia,1960.0,16,1,0,17
38602,Yugoslavia,1988.0,15,32,22,69
38603,Yugoslavia,1984.0,47,6,35,88
38604,Yugoslavia,1980.0,13,27,17,57
38605,Yugoslavia,1948.0,0,16,0,16
38606,Yugoslavia,1980.0,13,27,17,57
38607,Yugoslavia,1980.0,13,27,17,57
38608,Yugoslavia,1952.0,4,20,0,24
38609,Yugoslavia,1984.0,47,6,35,88
38610,Yugoslavia,1988.0,15,32,22,69
38611,Yugoslavia,1964.0,2,11,2,15
38612,Yugoslavia,1968.0,13,14,2,29
38613,Yugoslavia,1988.0,15,32,22,69
38614,Yugoslavia,1952.0,4,20,0,24
38615,Yugoslavia,1988.0,15,32,22,69
38616,Yugoslavia,1976.0,2,14,3,19
38617,Yugoslavia,1948.0,0,16,0,16
38618,Yugoslavia,1988.0,15,32,22,69
38619,Yugoslavia,1956.0,0,23,0,23
38620,Yugoslavia,1980.0,13,27,17,57
38621,Yugoslavia,1988.0,15,32,22,69
38622,Yugoslavia,1956.0,0,23,0,23
38623,Yugoslavia,1960.0,16,1,0,17
38624,Yugoslavia,1972.0,15,1,2,18
38625,Yugoslavia,1988.0,15,32,22,69
38626,Yugoslavia,1980.0,13,27,17,57
38627,Yugoslavia,1984.0,47,6,35,88
38628,Yugoslavia,1980.0,13,27,17,57
38629,Yugoslavia,1988.0,15,32,22,69
38630,Yugoslavia,1968.0,13,14,2,29
38631,Yugoslavia,1972.0,15,1,2,18
38632,Yugoslavia,1984.0,47,6,35,88
38633,Yugoslavia,1988.0,15,32,22,69
38634,Yugoslavia,1948.0,0,16,0,16
38635,Yugoslavia,1952.0,4,20,0,24
38636,Yugoslavia,1984.0,47,6,35,88
38637,Yugoslavia,1984.0,47,6,35,88
38638,Yugoslavia,1952.0,4,20,0,24
38639,Yugoslavia,1984.0,47,6,35,88
38640,Yugoslavia,1960.0,16,1,0,17
38641,Yugoslavia,1988.0,15,32,22,69
38642,Yugoslavia,1952.0,4,20,0,24
38643,Yugoslavia,1972.0,15,1,2,18
38644,Yugoslavia,1976.0,2,14,3,19
38645,Yugoslavia,1980.0,13,27,17,57
38646,Yugoslavia,1984.0,47,6,35,88
38647,Yugoslavia,1968.0,13,14,2,29
38648,Yugoslavia,1984.0,47,6,35,88
38649,Yugoslavia,1972.0,15,1,2,18
38650,Yugoslavia,1984.0,47,6,35,88
38651,Yugoslavia,1988.0,15,32,22,69
38652,Yugoslavia,1956.0,0,23,0,23
38653,Guyana,1980.0,0,0,1,1
38654,Israel,1992.0,0,1,1,2
38655,Israel,1996.0,0,0,1,1
38656,Israel,2004.0,1,0,1,2
38657,Israel,2016.0,0,0,2,2
38658,Israel,2000.0,0,0,1,1
38659,Israel,2016.0,0,0,2,2
38660,Israel,1992.0,0,1,1,2
38661,Israel,2004.0,1,0,1,2
38662,Israel,2008.0,0,0,1,1
38663,Kazakhstan,2004.0,1,4,3,8
38664,Kazakhstan,2016.0,3,5,10,18
38665,Kazakhstan,2000.0,3,4,0,7
38666,Kazakhstan,1996.0,3,4,4,11
38667,Kazakhstan,1996.0,3,4,4,11
38668,Kazakhstan,2008.0,2,4,7,13
38669,Kazakhstan,2012.0,7,1,5,13
38670,Kazakhstan,2000.0,3,4,0,7
38671,Kazakhstan,2012.0,7,1,5,13
38672,Kazakhstan,2016.0,3,5,10,18
38673,Kazakhstan,2004.0,1,4,3,8
38674,Kazakhstan,2012.0,7,1,5,13
38675,Kazakhstan,2016.0,3,5,10,18
38676,Kazakhstan,2004.0,1,4,3,8
38677,Kazakhstan,2016.0,3,5,10,18
38678,Kazakhstan,2008.0,2,4,7,13
38679,Kazakhstan,1996.0,3,4,4,11
38680,Kazakhstan,2000.0,3,4,0,7
38681,Kazakhstan,2008.0,2,4,7,13
38682,Kazakhstan,2012.0,7,1,5,13
38683,Kazakhstan,2004.0,1,4,3,8
38684,Kazakhstan,2016.0,3,5,10,18
38685,Kazakhstan,1996.0,3,4,4,11
38686,Kazakhstan,2010.0,0,1,0,1
38687,Kazakhstan,2004.0,1,4,3,8
38688,Kazakhstan,2016.0,3,5,10,18
38689,Kazakhstan,2016.0,3,5,10,18
38690,Kazakhstan,2008.0,2,4,7,13
38691,Kazakhstan,1996.0,3,4,4,11
38692,Kazakhstan,2012.0,7,1,5,13
38693,Kazakhstan,2004.0,1,4,3,8
38694,Kazakhstan,2012.0,7,1,5,13
38695,Kazakhstan,2016.0,3,5,10,18
38696,Kazakhstan,1996.0,3,4,4,11
38697,Kazakhstan,2008.0,2,4,7,13
38698,Kazakhstan,2008.0,2,4,7,13
38699,Kazakhstan,2012.0,7,1,5,13
38700,Kazakhstan,2016.0,3,5,10,18
38701,Kazakhstan,1996.0,3,4,4,11
38702,Kazakhstan,1996.0,3,4,4,11
38703,Kazakhstan,2012.0,7,1,5,13
38704,Kazakhstan,1998.0,0,0,2,2
38705,Kazakhstan,2016.0,3,5,10,18
38706,Kazakhstan,2012.0,7,1,5,13
38707,Kazakhstan,2016.0,3,5,10,18
38708,Kazakhstan,2012.0,7,1,5,13
38709,Kazakhstan,2008.0,2,4,7,13
38710,Kazakhstan,2000.0,3,4,0,7
38711,Kazakhstan,2016.0,3,5,10,18
38712,Kazakhstan,2008.0,2,4,7,13
38713,Kazakhstan,2000.0,3,4,0,7
38714,Kazakhstan,2008.0,2,4,7,13
38715,Kazakhstan,2016.0,3,5,10,18
38716,Kazakhstan,1994.0,1,2,0,3
38717,Kazakhstan,1994.0,1,2,0,3
38718,Kazakhstan,1994.0,1,2,0,3
38719,Kazakhstan,1998.0,0,0,2,2
38720,Kazakhstan,2016.0,3,5,10,18
38721,Kazakhstan,2012.0,7,1,5,13
38722,Kazakhstan,2014.0,0,0,1,1
38723,Kazakhstan,2008.0,2,4,7,13
38724,Kazakhstan,2008.0,2,4,7,13
38725,Kazakhstan,2004.0,1,4,3,8
38726,Kazakhstan,2016.0,3,5,10,18
38727,Kazakhstan,2008.0,2,4,7,13
38728,Kazakhstan,2000.0,3,4,0,7
38729,Kazakhstan,2012.0,7,1,5,13
38730,Kazakhstan,1996.0,3,4,4,11
38731,Kazakhstan,2012.0,7,1,5,13
38732,Kazakhstan,2004.0,1,4,3,8
38733,Kazakhstan,2016.0,3,5,10,18
38734,Kazakhstan,2016.0,3,5,10,18
38735,Kazakhstan,2016.0,3,5,10,18
38736,Kazakhstan,1996.0,3,4,4,11
38737,Kazakhstan,2008.0,2,4,7,13
38738,Kazakhstan,1996.0,3,4,4,11
38739,Kazakhstan,2000.0,3,4,0,7
38740,Georgia,2000.0,0,0,6,6
38741,Georgia,2004.0,2,2,0,4
38742,Georgia,2016.0,2,1,4,7
38743,Georgia,2000.0,0,0,6,6
38744,Georgia,2000.0,0,0,6,6
38745,Georgia,2008.0,3,0,3,6
38746,Georgia,2012.0,1,3,3,7
38747,Georgia,2004.0,2,2,0,4
38748,Georgia,2012.0,1,3,3,7
38749,Georgia,2016.0,2,1,4,7
38750,Georgia,1996.0,0,0,2,2
38751,Georgia,2000.0,0,0,6,6
38752,Georgia,2008.0,3,0,3,6
38753,Georgia,2012.0,1,3,3,7
38754,Georgia,1996.0,0,0,2,2
38755,Georgia,2016.0,2,1,4,7
38756,Georgia,2012.0,1,3,3,7
38757,Georgia,2008.0,3,0,3,6
38758,Georgia,2012.0,1,3,3,7
38759,Georgia,2004.0,2,2,0,4
38760,Georgia,2016.0,2,1,4,7
38761,Georgia,2008.0,3,0,3,6
38762,Georgia,2012.0,1,3,3,7
38763,Georgia,2016.0,2,1,4,7
38764,Georgia,2016.0,2,1,4,7
38765,Georgia,2008.0,3,0,3,6
38766,Georgia,2012.0,1,3,3,7
38767,Georgia,2016.0,2,1,4,7
38768,Georgia,2008.0,3,0,3,6
38769,Georgia,2000.0,0,0,6,6
38770,Georgia,2000.0,0,0,6,6
38771,Georgia,2004.0,2,2,0,4
38772,Kenya,1968.0,3,7,2,12
38773,Kenya,1972.0,5,3,4,12
38774,Kenya,1984.0,1,0,2,3
38775,Kenya,1992.0,2,4,2,8
38776,Kenya,1992.0,2,4,2,8
38777,Kenya,1996.0,1,4,3,8
38778,Kenya,1968.0,3,7,2,12
38779,Kenya,1972.0,5,3,4,12
38780,Kenya,2000.0,2,3,2,7
38781,Kenya,1968.0,3,7,2,12
38782,Kenya,2008.0,6,4,5,15
38783,Kenya,1992.0,2,4,2,8
38784,Kenya,2000.0,2,3,2,7
38785,Kenya,2012.0,2,4,5,11
38786,Kenya,2012.0,2,4,5,11
38787,Kenya,2016.0,6,6,1,13
38788,Kenya,2016.0,6,6,1,13
38789,Kenya,1988.0,5,2,2,9
38790,Kenya,2008.0,6,4,5,15
38791,Kenya,2008.0,6,4,5,15
38792,Kenya,2008.0,6,4,5,15
38793,Kenya,2012.0,2,4,5,11
38794,Kenya,1972.0,5,3,4,12
38795,Kenya,1988.0,5,2,2,9
38796,Kenya,1968.0,3,7,2,12
38797,Kenya,1968.0,3,7,2,12
38798,Kenya,1972.0,5,3,4,12
38799,Kenya,1972.0,5,3,4,12
38800,Kenya,2004.0,1,4,2,7
38801,Kenya,2012.0,2,4,5,11
38802,Kenya,1996.0,1,4,3,8
38803,Kenya,2016.0,6,6,1,13
38804,Kenya,1988.0,5,2,2,9
38805,Kenya,2004.0,1,4,2,7
38806,Kenya,2008.0,6,4,5,15
38807,Kenya,2016.0,6,6,1,13
38808,Kenya,1996.0,1,4,3,8
38809,Kenya,2008.0,6,4,5,15
38810,Kenya,1992.0,2,4,2,8
38811,Kenya,2012.0,2,4,5,11
38812,Kenya,1964.0,0,0,1,1
38813,Kenya,1968.0,3,7,2,12
38814,Kenya,2004.0,1,4,2,7
38815,Kenya,2008.0,6,4,5,15
38816,Kenya,2016.0,6,6,1,13
38817,Kenya,1996.0,1,4,3,8
38818,Kenya,2012.0,2,4,5,11
38819,Kenya,2012.0,2,4,5,11
38820,Kenya,2012.0,2,4,5,11
38821,Kenya,1992.0,2,4,2,8
38822,Kenya,2016.0,6,6,1,13
38823,Kenya,2004.0,1,4,2,7
38824,Kenya,1988.0,5,2,2,9
38825,Kenya,1968.0,3,7,2,12
38826,Kenya,2008.0,6,4,5,15
38827,Kenya,1996.0,1,4,3,8
38828,Kenya,1984.0,1,0,2,3
38829,Kenya,2000.0,2,3,2,7
38830,Kenya,2000.0,2,3,2,7
38831,Kenya,2004.0,1,4,2,7
38832,Kenya,2008.0,6,4,5,15
38833,Kenya,2012.0,2,4,5,11
38834,Kenya,2008.0,6,4,5,15
38835,Kenya,2008.0,6,4,5,15
38836,Kenya,1972.0,5,3,4,12
38837,Kenya,1972.0,5,3,4,12
38838,Kenya,1984.0,1,0,2,3
38839,Kenya,2012.0,2,4,5,11
38840,Kenya,1992.0,2,4,2,8
38841,Kenya,2004.0,1,4,2,7
38842,Kenya,2008.0,6,4,5,15
38843,Kenya,2000.0,2,3,2,7
38844,Kenya,1988.0,5,2,2,9
38845,Kenya,1968.0,3,7,2,12
38846,Kenya,1972.0,5,3,4,12
38847,Kenya,2016.0,6,6,1,13
38848,Kenya,2004.0,1,4,2,7
38849,Kenya,1996.0,1,4,3,8
38850,Kenya,1972.0,5,3,4,12
38851,Kenya,1988.0,5,2,2,9
38852,Kenya,1968.0,3,7,2,12
38853,Kenya,2012.0,2,4,5,11
38854,Kenya,2016.0,6,6,1,13
38855,Kenya,1988.0,5,2,2,9
38856,Kenya,1972.0,5,3,4,12
38857,Kenya,1972.0,5,3,4,12
38858,Kenya,1992.0,2,4,2,8
38859,Kenya,2008.0,6,4,5,15
38860,Kenya,2016.0,6,6,1,13
38861,Kenya,2016.0,6,6,1,13
38862,Kenya,1992.0,2,4,2,8
38863,Kenya,1968.0,3,7,2,12
38864,Kenya,1968.0,3,7,2,12
38865,Kenya,1996.0,1,4,3,8
38866,Kenya,2000.0,2,3,2,7
38867,Kenya,2016.0,6,6,1,13
38868,Kenya,1996.0,1,4,3,8
38869,Kenya,2000.0,2,3,2,7
38870,Kenya,1988.0,5,2,2,9
38871,Kenya,2016.0,6,6,1,13
38872,Kenya,1988.0,5,2,2,9
38873,Kenya,2008.0,6,4,5,15
38874,Kenya,1968.0,3,7,2,12
38875,Kenya,1972.0,5,3,4,12
38876,Kenya,2008.0,6,4,5,15
38877,Kenya,2016.0,6,6,1,13
38878,Iceland,2008.0,0,14,0,14
38879,Iceland,2008.0,0,14,0,14
38880,Iceland,1956.0,0,1,0,1
38881,Iceland,2000.0,0,0,1,1
38882,Iceland,1984.0,0,0,1,1
38883,Iceland,2008.0,0,14,0,14
38884,Iceland,2008.0,0,14,0,14
38885,Iceland,2008.0,0,14,0,14
38886,Iceland,2008.0,0,14,0,14
38887,Iceland,2008.0,0,14,0,14
38888,Iceland,2008.0,0,14,0,14
38889,Iceland,2008.0,0,14,0,14
38890,Iceland,2008.0,0,14,0,14
38891,Iceland,2008.0,0,14,0,14
38892,Iceland,2008.0,0,14,0,14
38893,Iceland,2008.0,0,14,0,14
38894,Iceland,2008.0,0,14,0,14
38895,Haiti,1924.0,0,0,5,5
38896,Haiti,1928.0,0,1,0,1
38897,Haiti,1924.0,0,0,5,5
38898,Union des Socits Franais de Sports Athletiques,1900.0,1,0,0,1
38899,Haiti,1924.0,0,0,5,5
38900,Haiti,1924.0,0,0,5,5
38901,Haiti,1924.0,0,0,5,5
38902,Malaysia,2016.0,0,7,1,8
38903,Malaysia,2016.0,0,7,1,8
38904,Malaysia-1,1996.0,0,2,1,3
38905,Malaysia,2016.0,0,7,1,8
38906,Malaysia,2016.0,0,7,1,8
38907,Malaysia,2016.0,0,7,1,8
38908,Malaysia,2008.0,0,1,0,1
38909,Malaysia,2012.0,0,1,1,2
38910,Malaysia,2016.0,0,7,1,8
38911,Malaysia,2012.0,0,1,1,2
38912,Malaysia,2016.0,0,7,1,8
38913,Malaysia,1996.0,0,2,1,3
38914,Malaysia-2,1992.0,0,0,2,2
38915,Malaysia-2,1992.0,0,0,2,2
38916,Malaysia,2016.0,0,7,1,8
38917,Malaysia-1,1996.0,0,2,1,3
38918,Iraq,1960.0,0,0,1,1
38919,Czech Republic,2004.0,1,6,6,13
38920,Czech Republic,2006.0,1,2,24,27
38921,Czech Republic,2010.0,2,0,7,9
38922,Czech Republic,2010.0,2,0,7,9
38923,Czech Republic,1998.0,21,1,1,23
38924,Czech Republic,2006.0,1,2,24,27
38925,Czech Republic,2006.0,1,2,24,27
38926,Czech Republic,1998.0,21,1,1,23
38927,Czech Republic,2004.0,1,6,6,13
38928,Czech Republic,1996.0,4,5,4,13
38929,Czech Republic,1996.0,4,5,4,13
38930,Czech Republic,1998.0,21,1,1,23
38931,Czech Republic,2012.0,4,4,6,14
38932,Czech Republic,2016.0,1,2,12,15
38933,Czech Republic,2016.0,1,2,12,15
38934,Czech Republic,1996.0,4,5,4,13
38935,Czech Republic,2006.0,1,2,24,27
38936,Czech Republic,2006.0,1,2,24,27
38937,Czech Republic,1998.0,21,1,1,23
38938,Czech Republic,2004.0,1,6,6,13
38939,Czech Republic,1998.0,21,1,1,23
38940,Czech Republic,2006.0,1,2,24,27
38941,Czech Republic,2012.0,4,4,6,14
38942,Czech Republic,2016.0,1,2,12,15
38943,Czech Republic,1998.0,21,1,1,23
38944,Czech Republic,2006.0,1,2,24,27
38945,Czech Republic,2012.0,4,4,6,14
38946,Czech Republic,2006.0,1,2,24,27
38947,Czech Republic,1996.0,4,5,4,13
38948,Czech Republic,2000.0,2,3,4,9
38949,Czech Republic-1,2012.0,4,4,6,14
38950,Czech Republic,2006.0,1,2,24,27
38951,Czech Republic-1,2012.0,4,4,6,14
38952,Czech Republic,2016.0,1,2,12,15
38953,Czech Republic,2012.0,4,4,6,14
38954,Czech Republic,2004.0,1,6,6,13
38955,Czech Republic,1998.0,21,1,1,23
38956,Czech Republic,2006.0,1,2,24,27
38957,Czech Republic,2010.0,2,0,7,9
38958,Czech Republic,1996.0,4,5,4,13
38959,Czech Republic-1,2000.0,2,3,4,9
38960,Czech Republic,2004.0,1,6,6,13
38961,Czech Republic,2006.0,1,2,24,27
38962,Czech Republic,2006.0,1,2,24,27
38963,Czech Republic,2004.0,1,6,6,13
38964,Czech Republic,1996.0,4,5,4,13
38965,Czech Republic,2004.0,1,6,6,13
38966,Czech Republic,2008.0,3,4,0,7
38967,Czech Republic,2006.0,1,2,24,27
38968,Czech Republic,2010.0,2,0,7,9
38969,Czech Republic,2000.0,2,3,4,9
38970,Czech Republic,2016.0,1,2,12,15
38971,Czech Republic,2006.0,1,2,24,27
38972,Czech Republic,2006.0,1,2,24,27
38973,Czech Republic,1998.0,21,1,1,23
38974,Czech Republic,2012.0,4,4,6,14
38975,Czech Republic,2016.0,1,2,12,15
38976,Czech Republic,2004.0,1,6,6,13
38977,Czech Republic,2008.0,3,4,0,7
38978,Czech Republic,2008.0,3,4,0,7
38979,Czech Republic,2016.0,1,2,12,15
38980,Czech Republic,1998.0,21,1,1,23
38981,Czech Republic,2006.0,1,2,24,27
38982,Czech Republic-1,2000.0,2,3,4,9
38983,Czech Republic,2010.0,2,0,7,9
38984,Czech Republic,2000.0,2,3,4,9
38985,Czech Republic,2006.0,1,2,24,27
38986,Czech Republic,1998.0,21,1,1,23
38987,Czech Republic,2014.0,2,7,2,11
38988,Czech Republic,2014.0,2,7,2,11
38989,Czech Republic,2014.0,2,7,2,11
38990,Czech Republic,1998.0,21,1,1,23
38991,Czech Republic,1998.0,21,1,1,23
38992,Czech Republic,2002.0,1,2,0,3
38993,Czech Republic,2002.0,1,2,0,3
38994,Czech Republic,2006.0,1,2,24,27
38995,Czech Republic,2006.0,1,2,24,27
38996,Czech Republic,1996.0,4,5,4,13
38997,Czech Republic,1996.0,4,5,4,13
38998,Czech Republic,2006.0,1,2,24,27
38999,Czech Republic,1998.0,21,1,1,23
39000,Czech Republic,1996.0,4,5,4,13
39001,Czech Republic,2004.0,1,6,6,13
39002,Czech Republic,1998.0,21,1,1,23
39003,Czech Republic,1998.0,21,1,1,23
39004,Czech Republic,2006.0,1,2,24,27
39005,Czech Republic,2016.0,1,2,12,15
39006,Czech Republic,2000.0,2,3,4,9
39007,Czech Republic,1998.0,21,1,1,23
39008,Czech Republic-1,1996.0,4,5,4,13
39009,Czech Republic,1998.0,21,1,1,23
39010,Czech Republic,2006.0,1,2,24,27
39011,Czech Republic,1998.0,21,1,1,23
39012,Czech Republic,2010.0,2,0,7,9
39013,Czech Republic,2010.0,2,0,7,9
39014,Czech Republic,2010.0,2,0,7,9
39015,Czech Republic,2014.0,2,7,2,11
39016,Czech Republic,2014.0,2,7,2,11
39017,Czech Republic-1,2016.0,1,2,12,15
39018,Czech Republic,2014.0,2,7,2,11
39019,Czech Republic,2000.0,2,3,4,9
39020,Czech Republic,2004.0,1,6,6,13
39021,Czech Republic-1,1996.0,4,5,4,13
39022,Czech Republic,1998.0,21,1,1,23
39023,Czech Republic,1998.0,21,1,1,23
39024,Czech Republic,2004.0,1,6,6,13
39025,Czech Republic,2014.0,2,7,2,11
39026,Czech Republic,2014.0,2,7,2,11
39027,Czech Republic,2014.0,2,7,2,11
39028,Czech Republic,2014.0,2,7,2,11
39029,Czech Republic,1998.0,21,1,1,23
39030,Czech Republic,2006.0,1,2,24,27
39031,Czech Republic,2008.0,3,4,0,7
39032,Czech Republic,2012.0,4,4,6,14
39033,Czech Republic,2016.0,1,2,12,15
39034,Czech Republic-1,2004.0,1,6,6,13
39035,Czech Republic,2008.0,3,4,0,7
39036,Czech Republic,2016.0,1,2,12,15
39037,Czech Republic,2012.0,4,4,6,14
39038,Czech Republic,2016.0,1,2,12,15
39039,Czech Republic,1998.0,21,1,1,23
39040,Czech Republic,2006.0,1,2,24,27
39041,Czech Republic-1,2016.0,1,2,12,15
39042,Czech Republic,1996.0,4,5,4,13
39043,Czech Republic,2012.0,4,4,6,14
39044,Czech Republic,1998.0,21,1,1,23
39045,Czech Republic,2012.0,4,4,6,14
39046,Czech Republic,2008.0,3,4,0,7
39047,Czech Republic,2012.0,4,4,6,14
39048,Czech Republic,2016.0,1,2,12,15
39049,Czech Republic,2000.0,2,3,4,9
39050,Czech Republic,2012.0,4,4,6,14
39051,Czech Republic,2012.0,4,4,6,14
39052,Czech Republic,2016.0,1,2,12,15
39053,Czech Republic,2002.0,1,2,0,3
39054,Czech Republic,2014.0,2,7,2,11
39055,Czech Republic,2006.0,1,2,24,27
39056,Czech Republic-1,2004.0,1,6,6,13
39057,Czech Republic,2008.0,3,4,0,7
39058,Czech Republic,2006.0,1,2,24,27
39059,Czech Republic,2010.0,2,0,7,9
39060,Czech Republic,1996.0,4,5,4,13
39061,Czech Republic,2000.0,2,3,4,9
39062,Czech Republic,2006.0,1,2,24,27
39063,Slovakia,2004.0,3,2,5,10
39064,Slovakia,2012.0,0,1,4,5
39065,Slovakia,2016.0,3,5,0,8
39066,Slovakia,1996.0,1,1,1,3
39067,Slovakia,2004.0,3,2,5,10
39068,Slovakia,2000.0,2,3,1,6
39069,Slovakia,2004.0,3,2,5,10
39070,Slovakia,2008.0,4,5,1,10
39071,Slovakia,2012.0,0,1,4,5
39072,Slovakia,2000.0,2,3,1,6
39073,Slovakia,2004.0,3,2,5,10
39074,Slovakia,2008.0,4,5,1,10
39075,Slovakia,2012.0,0,1,4,5
39076,Slovakia,2010.0,1,1,1,3
39077,Slovakia,2004.0,3,2,5,10
39078,Slovakia,2008.0,4,5,1,10
39079,Slovakia,1996.0,1,1,1,3
39080,Slovakia,2004.0,3,2,5,10
39081,Slovakia,2010.0,1,1,1,3
39082,Slovakia,2010.0,1,1,1,3
39083,Slovakia,2014.0,1,0,0,1
39084,Slovakia,2016.0,3,5,0,8
39085,Slovakia,1996.0,1,1,1,3
39086,Slovakia,2000.0,2,3,1,6
39087,Slovakia,2004.0,3,2,5,10
39088,Slovakia,2008.0,4,5,1,10
39089,Slovakia,2012.0,0,1,4,5
39090,Slovakia,2000.0,2,3,1,6
39091,Slovakia,2000.0,2,3,1,6
39092,Slovakia,2000.0,2,3,1,6
39093,Slovakia,2008.0,4,5,1,10
39094,Slovakia,2016.0,3,5,0,8
39095,Slovakia,2004.0,3,2,5,10
39096,Slovakia,2008.0,4,5,1,10
39097,Slovakia,2004.0,3,2,5,10
39098,Slovakia,2008.0,4,5,1,10
39099,Slovakia,2016.0,3,5,0,8
39100,Slovakia,2016.0,3,5,0,8
39101,Slovakia,2008.0,4,5,1,10
39102,Slovakia,2012.0,0,1,4,5
39103,Slovakia,2008.0,4,5,1,10
39104,Slovakia,2016.0,3,5,0,8
39105,Slovakia,2016.0,3,5,0,8
39106,Slovakia,2004.0,3,2,5,10
39107,Slovakia,2008.0,4,5,1,10
39108,Slovakia,2016.0,3,5,0,8
39109,Slovakia,2006.0,0,1,0,1
39110,Bahamas,2008.0,0,6,1,7
39111,Bahamas,2000.0,6,0,5,11
39112,Bahamas,2008.0,0,6,1,7
39113,Bahamas,2012.0,4,0,0,4
39114,Bahamas,2016.0,1,0,5,6
39115,Bahamas,1996.0,0,5,0,5
39116,Bahamas,2000.0,6,0,5,11
39117,Gem,1964.0,2,0,0,2
39118,Bahamas,1996.0,0,5,0,5
39119,Bahamas,2000.0,6,0,5,11
39120,Bahamas,2000.0,6,0,5,11
39121,Gem IV,1956.0,0,0,2,2
39122,Bahamas,1996.0,0,5,0,5
39123,Bahamas,2000.0,6,0,5,11
39124,Bahamas,2004.0,1,0,1,2
39125,Bahamas,1996.0,0,5,0,5
39126,Bahamas,2000.0,6,0,5,11
39127,Bahamas,2016.0,1,0,5,6
39128,Gem IV,1956.0,0,0,2,2
39129,Gem,1964.0,2,0,0,2
39130,Bahamas,2008.0,0,6,1,7
39131,Bahamas,2012.0,4,0,0,4
39132,Bahamas,2016.0,1,0,5,6
39133,Bahamas,2000.0,6,0,5,11
39134,Bahamas,2008.0,0,6,1,7
39135,Bahamas,2012.0,4,0,0,4
39136,Bahamas,2016.0,1,0,5,6
39137,Bahamas,2000.0,6,0,5,11
39138,Bahamas,2008.0,0,6,1,7
39139,Bahamas,2000.0,6,0,5,11
39140,Bahamas,2016.0,1,0,5,6
39141,Bahamas,2000.0,6,0,5,11
39142,Bahamas,2012.0,4,0,0,4
39143,Bahamas,2016.0,1,0,5,6
39144,Bahamas,1992.0,0,0,1,1
39145,Bahamas,2008.0,0,6,1,7
39146,Bahamas,1996.0,0,5,0,5
39147,Bahamas,2000.0,6,0,5,11
39148,Bahamas,2008.0,0,6,1,7
39149,Bahamas,2004.0,1,0,1,2
39150,Australasia,1908.0,15,2,2,19
39151,Australasia,1908.0,15,2,2,19
39152,Australasia,1908.0,15,2,2,19
39153,Australasia,1908.0,15,2,2,19
39154,Australasia,1912.0,5,2,3,10
39155,Australasia,1908.0,15,2,2,19
39156,Australasia,1908.0,15,2,2,19
39157,Australasia,1912.0,5,2,3,10
39158,Australasia,1908.0,15,2,2,19
39159,Australasia,1912.0,5,2,3,10
39160,Australasia,1908.0,15,2,2,19
39161,Australasia,1912.0,5,2,3,10
39162,Australasia,1912.0,5,2,3,10
39163,Australasia,1912.0,5,2,3,10
39164,Australasia,1912.0,5,2,3,10
39165,Australasia,1912.0,5,2,3,10
39166,Australasia,1908.0,15,2,2,19
39167,Australasia,1908.0,15,2,2,19
39168,Australasia,1908.0,15,2,2,19
39169,Australasia,1908.0,15,2,2,19
39170,Australasia,1908.0,15,2,2,19
39171,Australasia,1908.0,15,2,2,19
39172,Australasia,1908.0,15,2,2,19
39173,Australasia,1908.0,15,2,2,19
39174,Australasia,1908.0,15,2,2,19
39175,Australasia,1908.0,15,2,2,19
39176,Australasia,1908.0,15,2,2,19
39177,Australasia,1912.0,5,2,3,10
39178,Australasia,1912.0,5,2,3,10
39179,Paraguay,2004.0,0,17,0,17
39180,Paraguay,2004.0,0,17,0,17
39181,Paraguay,2004.0,0,17,0,17
39182,Paraguay,2004.0,0,17,0,17
39183,Paraguay,2004.0,0,17,0,17
39184,Paraguay,2004.0,0,17,0,17
39185,Paraguay,2004.0,0,17,0,17
39186,Paraguay,2004.0,0,17,0,17
39187,Paraguay,2004.0,0,17,0,17
39188,Paraguay,2004.0,0,17,0,17
39189,Paraguay,2004.0,0,17,0,17
39190,Paraguay,2004.0,0,17,0,17
39191,Paraguay,2004.0,0,17,0,17
39192,Paraguay,2004.0,0,17,0,17
39193,Paraguay,2004.0,0,17,0,17
39194,Paraguay,2004.0,0,17,0,17
39195,Paraguay,2004.0,0,17,0,17
39196,Montenegro,2012.0,0,14,0,14
39197,Montenegro,2012.0,0,14,0,14
39198,Montenegro,2012.0,0,14,0,14
39199,Montenegro,2012.0,0,14,0,14
39200,Montenegro,2012.0,0,14,0,14
39201,Montenegro,2012.0,0,14,0,14
39202,Montenegro,2012.0,0,14,0,14
39203,Montenegro,2012.0,0,14,0,14
39204,Montenegro,2012.0,0,14,0,14
39205,Montenegro,2012.0,0,14,0,14
39206,Montenegro,2012.0,0,14,0,14
39207,Montenegro,2012.0,0,14,0,14
39208,Montenegro,2012.0,0,14,0,14
39209,Montenegro,2012.0,0,14,0,14
39210,Ireland,2008.0,0,1,2,3
39211,Ireland,2012.0,1,1,3,5
39212,Ireland,1956.0,1,1,3,5
39213,Ireland,1956.0,1,1,3,5
39214,Ireland,1992.0,1,1,0,2
39215,Ireland,2012.0,1,1,3,5
39216,Ireland,1956.0,1,1,3,5
39217,Ireland,2008.0,0,1,2,3
39218,Ireland,1956.0,1,1,3,5
39219,Ireland,1924.0,0,1,1,2
39220,Ireland,1948.0,0,0,1,1
39221,Ireland,1964.0,0,0,1,1
39222,Ireland,1992.0,1,1,0,2
39223,Ireland,1952.0,0,1,0,1
39224,Ireland,2016.0,0,3,0,3
39225,Ireland,2012.0,1,1,3,5
39226,Ireland,1928.0,1,0,0,1
39227,Ireland,1932.0,2,0,0,2
39228,Ireland,2012.0,1,1,3,5
39229,Ireland,2016.0,0,3,0,3
39230,Ireland,2016.0,0,3,0,3
39231,Ireland,2000.0,0,1,0,1
39232,Ireland,1980.0,0,2,1,3
39233,Ireland,1996.0,3,0,1,4
39234,Ireland,1996.0,3,0,1,4
39235,Ireland,1996.0,3,0,1,4
39236,Ireland,1996.0,3,0,1,4
39237,Ireland,2008.0,0,1,2,3
39238,Ireland,2012.0,1,1,3,5
39239,Ireland,1956.0,1,1,3,5
39240,Ireland,1932.0,2,0,0,2
39241,Ireland,1984.0,0,1,0,1
39242,Ireland,1980.0,0,2,1,3
39243,Ireland,1980.0,0,2,1,3
39244,Ireland,1924.0,0,1,1,2
39245,Portugal,1996.0,1,0,2,3
39246,Symphony,1948.0,0,2,3,5
39247,Symphony,1948.0,0,2,3,5
39248,Portugal,1936.0,0,0,3,3
39249,Portugal,1928.0,0,0,6,6
39250,Portugal,1924.0,0,0,4,4
39251,Espadarte,1952.0,0,0,2,2
39252,Portugal,1924.0,0,0,4,4
39253,Portugal,1928.0,0,0,6,6
39254,Portugal,1928.0,0,0,6,6
39255,Portugal,2000.0,0,0,2,2
39256,Portugal,1936.0,0,0,3,3
39257,Portugal,2008.0,1,1,0,2
39258,Portugal,2008.0,1,1,0,2
39259,Espadarte,1952.0,0,0,2,2
39260,Portugal,1928.0,0,0,6,6
39261,Portugal,1984.0,1,0,2,3
39262,Portugal,1976.0,0,2,0,2
39263,Portugal,1984.0,1,0,2,3
39264,Portugal,1976.0,0,2,0,2
39265,Portugal,1924.0,0,0,4,4
39266,Portugal,2016.0,0,0,1,1
39267,Portugal,1984.0,1,0,2,3
39268,Portugal,1988.0,1,0,0,1
39269,Portugal,1924.0,0,0,4,4
39270,Portugal,2004.0,0,2,1,3
39271,Portugal,1948.0,0,2,3,5
39272,Portugal,1928.0,0,0,6,6
39273,Portugal,2004.0,0,2,1,3
39274,Portugal,2012.0,0,2,0,2
39275,Ma'Lindo,1960.0,0,2,0,2
39276,Ma'Lindo,1960.0,0,2,0,2
39277,Portugal,1996.0,1,0,2,3
39278,Portugal,2000.0,0,0,2,2
39279,Portugal,1996.0,1,0,2,3
39280,Portugal,1928.0,0,0,6,6
39281,Portugal,2012.0,0,2,0,2
39282,Portugal,1936.0,0,0,3,3
39283,Portugal,1948.0,0,2,3,5
39284,Portugal,2004.0,0,2,1,3
39285,Portugal,1948.0,0,2,3,5
39286,Guatemala,2012.0,0,1,0,1
39287,Serbia and Montenegro,1996.0,1,12,13,26
39288,Serbia and Montenegro,2000.0,11,1,13,25
39289,Serbia and Montenegro,1996.0,1,12,13,26
39290,Serbia and Montenegro,1996.0,1,12,13,26
39291,Serbia and Montenegro,2000.0,11,1,13,25
39292,Serbia and Montenegro,1996.0,1,12,13,26
39293,Serbia and Montenegro,2000.0,11,1,13,25
39294,Serbia and Montenegro,2004.0,0,13,0,13
39295,Serbia and Montenegro,1996.0,1,12,13,26
39296,Serbia and Montenegro,1996.0,1,12,13,26
39297,Serbia and Montenegro,1996.0,1,12,13,26
39298,Serbia and Montenegro,1996.0,1,12,13,26
39299,Serbia and Montenegro,1996.0,1,12,13,26
39300,Serbia and Montenegro,2000.0,11,1,13,25
39301,Serbia and Montenegro,2004.0,0,13,0,13
39302,Serbia and Montenegro,1996.0,1,12,13,26
39303,Serbia and Montenegro,2000.0,11,1,13,25
39304,Serbia and Montenegro,1996.0,1,12,13,26
39305,Serbia and Montenegro,2000.0,11,1,13,25
39306,Serbia and Montenegro,2000.0,11,1,13,25
39307,Serbia and Montenegro,2004.0,0,13,0,13
39308,Serbia and Montenegro,1996.0,1,12,13,26
39309,Serbia and Montenegro,1996.0,1,12,13,26
39310,Serbia and Montenegro,2000.0,11,1,13,25
39311,Serbia and Montenegro,2004.0,0,13,0,13
39312,Serbia and Montenegro,1996.0,1,12,13,26
39313,Serbia and Montenegro,2004.0,0,13,0,13
39314,Serbia and Montenegro,1996.0,1,12,13,26
39315,Serbia and Montenegro,2000.0,11,1,13,25
39316,Serbia and Montenegro,2000.0,11,1,13,25
39317,Serbia and Montenegro,1996.0,1,12,13,26
39318,Serbia and Montenegro,1996.0,1,12,13,26
39319,Serbia and Montenegro,2000.0,11,1,13,25
39320,Serbia and Montenegro,2000.0,11,1,13,25
39321,Serbia and Montenegro,2000.0,11,1,13,25
39322,Serbia and Montenegro,2004.0,0,13,0,13
39323,Serbia and Montenegro,1996.0,1,12,13,26
39324,Serbia and Montenegro,1996.0,1,12,13,26
39325,Serbia and Montenegro,1996.0,1,12,13,26
39326,Serbia and Montenegro,1996.0,1,12,13,26
39327,Serbia and Montenegro,2000.0,11,1,13,25
39328,Serbia and Montenegro,2004.0,0,13,0,13
39329,Serbia and Montenegro,2000.0,11,1,13,25
39330,Serbia and Montenegro,2004.0,0,13,0,13
39331,Serbia and Montenegro,1996.0,1,12,13,26
39332,Serbia and Montenegro,2004.0,0,13,0,13
39333,Serbia and Montenegro,2000.0,11,1,13,25
39334,Serbia and Montenegro,2004.0,0,13,0,13
39335,Serbia and Montenegro,2000.0,11,1,13,25
39336,Serbia and Montenegro,1996.0,1,12,13,26
39337,Serbia and Montenegro,1996.0,1,12,13,26
39338,Serbia and Montenegro,1996.0,1,12,13,26
39339,Serbia and Montenegro,2000.0,11,1,13,25
39340,Serbia and Montenegro,2004.0,0,13,0,13
39341,Serbia and Montenegro,2004.0,0,13,0,13
39342,Serbia and Montenegro,2000.0,11,1,13,25
39343,Serbia and Montenegro,2000.0,11,1,13,25
39344,Serbia and Montenegro,2000.0,11,1,13,25
39345,Serbia and Montenegro,2004.0,0,13,0,13
39346,Serbia and Montenegro,1996.0,1,12,13,26
39347,Serbia and Montenegro,2000.0,11,1,13,25
39348,Serbia and Montenegro,2000.0,11,1,13,25
39349,Serbia and Montenegro,2000.0,11,1,13,25
39350,Serbia and Montenegro,2000.0,11,1,13,25
39351,Tanzania,1980.0,0,2,0,2
39352,Tanzania,1980.0,0,2,0,2
39353,Lebanon,1980.0,0,0,1,1
39354,Lebanon,1952.0,0,1,1,2
39355,Lebanon,1952.0,0,1,1,2
39356,Lebanon,1972.0,0,1,0,1
39357,Kyrgyzstan,2008.0,0,1,1,2
39358,Kyrgyzstan,2000.0,0,0,1,1
39359,Kyrgyzstan,2008.0,0,1,1,2
39360,Latvia,1936.0,0,1,1,2
39361,Latvia,1936.0,0,1,1,2
39362,Latvia,1932.0,0,1,0,1
39363,Latvia-1,2014.0,0,5,6,11
39364,Latvia,2010.0,0,3,0,3
39365,Latvia,2014.0,0,5,6,11
39366,Latvia,2000.0,1,1,1,3
39367,Latvia,1992.0,0,2,1,3
39368,Latvia,1996.0,0,1,0,1
39369,Latvia,2008.0,1,1,1,3
39370,Latvia,1992.0,0,2,1,3
39371,Latvia-1,2014.0,0,5,6,11
39372,Latvia,1992.0,0,2,1,3
39373,Latvia-1,2012.0,1,0,2,3
39374,Latvia,2006.0,0,0,1,1
39375,Latvia,2014.0,0,5,6,11
39376,Latvia,2004.0,0,4,0,4
39377,Latvia,2004.0,0,4,0,4
39378,Latvia,2004.0,0,4,0,4
39379,Latvia,2008.0,1,1,1,3
39380,Latvia-1,2010.0,0,3,0,3
39381,Latvia-1,2014.0,0,5,6,11
39382,Latvia,2014.0,0,5,6,11
39383,Latvia-1,2010.0,0,3,0,3
39384,Latvia-1,2014.0,0,5,6,11
39385,Latvia,2014.0,0,5,6,11
39386,Latvia-1,2012.0,1,0,2,3
39387,Latvia-1,2014.0,0,5,6,11
39388,Latvia,2008.0,1,1,1,3
39389,Latvia,2012.0,1,0,2,3
39390,Latvia,2014.0,0,5,6,11
39391,Latvia,2004.0,0,4,0,4
39392,Latvia,2000.0,1,1,1,3
39393,Latvia-1,2014.0,0,5,6,11
39394,Latvia,2000.0,1,1,1,3
39395,Netherlands Antilles,1988.0,0,1,0,1
39396,Venezuela,1984.0,0,0,3,3
39397,Venezuela,2004.0,0,0,2,2
39398,Venezuela,1984.0,0,0,3,3
39399,Venezuela,2008.0,0,0,1,1
39400,Venezuela,1952.0,0,0,1,1
39401,Venezuela,2016.0,0,1,2,3
39402,Venezuela,1960.0,0,0,1,1
39403,Venezuela,1976.0,0,1,0,1
39404,Venezuela,2016.0,0,1,2,3
39405,Venezuela,2012.0,1,0,0,1
39406,Venezuela,1980.0,0,1,0,1
39407,Venezuela,1968.0,1,0,0,1
39408,Venezuela,2016.0,0,1,2,3
39409,Venezuela,2004.0,0,0,2,2
39410,Venezuela,1984.0,0,0,3,3
39411,Thailand,2004.0,3,1,4,8
39412,Thailand,2008.0,2,2,0,4
39413,Thailand,2004.0,3,1,4,8
39414,Thailand,1992.0,0,0,1,1
39415,Thailand,2016.0,2,2,2,6
39416,Thailand,2008.0,2,2,0,4
39417,Thailand,2008.0,2,2,0,4
39418,Thailand,2004.0,3,1,4,8
39419,Thailand,1996.0,1,0,1,2
39420,Thailand,1996.0,1,0,1,2
39421,Thailand,2016.0,2,2,2,6
39422,Thailand,1988.0,0,0,1,1
39423,Thailand,2004.0,3,1,4,8
39424,Thailand,2004.0,3,1,4,8
39425,Thailand,2012.0,0,2,1,3
39426,Thailand,2000.0,1,0,2,3
39427,Thailand,1976.0,0,0,1,1
39428,Thailand,2004.0,3,1,4,8
39429,Thailand,2008.0,2,2,0,4
39430,Thailand,2012.0,0,2,1,3
39431,Thailand,2016.0,2,2,2,6
39432,Thailand,2012.0,0,2,1,3
39433,Thailand,2016.0,2,2,2,6
39434,Thailand,2000.0,1,0,2,3
39435,Thailand,2016.0,2,2,2,6
39436,Thailand,2000.0,1,0,2,3
39437,Thailand,2004.0,3,1,4,8
39438,Thailand,1984.0,0,1,0,1
39439,Thailand,2004.0,3,1,4,8
39440,Thailand,2016.0,2,2,2,6
39441,Togo,2008.0,0,0,1,1
39442,Peru,1984.0,0,1,0,1
39443,Peru,1988.0,0,12,0,12
39444,Peru,1988.0,0,12,0,12
39445,Peru,1988.0,0,12,0,12
39446,Peru,1988.0,0,12,0,12
39447,Peru,1988.0,0,12,0,12
39448,Peru,1992.0,0,1,0,1
39449,Peru,1988.0,0,12,0,12
39450,Peru,1988.0,0,12,0,12
39451,Peru,1988.0,0,12,0,12
39452,Peru,1988.0,0,12,0,12
39453,Peru,1988.0,0,12,0,12
39454,Peru,1988.0,0,12,0,12
39455,Peru,1988.0,0,12,0,12
39456,Peru,1948.0,1,0,0,1
39457,Estonia,2000.0,1,0,2,3
39458,Estonia,2008.0,1,2,0,3
39459,Estonia,2016.0,0,0,4,4
39460,Tutti V,1928.0,2,1,6,9
39461,Tutti V,1928.0,2,1,6,9
39462,Estonia,2004.0,0,1,2,3
39463,Estonia,2008.0,1,2,0,3
39464,Estonia,2016.0,0,0,4,4
39465,Estonia,2008.0,1,2,0,3
39466,Estonia,2012.0,0,1,1,2
39467,Estonia,1928.0,2,1,6,9
39468,Estonia,1924.0,1,1,4,6
39469,Estonia,1924.0,1,1,4,6
39470,Estonia,1928.0,2,1,6,9
39471,Estonia,1920.0,1,2,0,3
39472,Estonia,1928.0,2,1,6,9
39473,Estonia,1936.0,2,2,3,7
39474,Estonia,2002.0,1,1,1,3
39475,Estonia,2012.0,0,1,1,2
39476,Estonia,1936.0,2,2,3,7
39477,Estonia,1936.0,2,2,3,7
39478,Estonia,1920.0,1,2,0,3
39479,Estonia,1924.0,1,1,4,6
39480,Estonia,2000.0,1,0,2,3
39481,Estonia,1936.0,2,2,3,7
39482,Estonia,1936.0,2,2,3,7
39483,Estonia,2000.0,1,0,2,3
39484,Estonia,2004.0,0,1,2,3
39485,Estonia,1924.0,1,1,4,6
39486,Estonia,2016.0,0,0,4,4
39487,Estonia,1992.0,1,0,2,3
39488,Estonia,1920.0,1,2,0,3
39489,Estonia,2006.0,3,0,0,3
39490,Estonia,2006.0,3,0,0,3
39491,Estonia,2010.0,0,1,0,1
39492,Estonia,1924.0,1,1,4,6
39493,Estonia,1936.0,2,2,3,7
39494,Estonia,2016.0,0,0,4,4
39495,Estonia,1924.0,1,1,4,6
39496,Estonia,2004.0,0,1,2,3
39497,Estonia,1992.0,1,0,2,3
39498,Estonia,1992.0,1,0,2,3
39499,Estonia,1928.0,2,1,6,9
39500,Estonia,1936.0,2,2,3,7
39501,Estonia,2002.0,1,1,1,3
39502,Estonia,2002.0,1,1,1,3
39503,Estonia,2006.0,3,0,0,3
39504,Tutti V,1928.0,2,1,6,9
39505,Tutti V,1928.0,2,1,6,9
39506,Tutti V,1928.0,2,1,6,9
39507,Slovenia,1996.0,0,2,0,2
39508,Slovenia,2004.0,0,2,3,5
39509,Slovenia,1992.0,0,0,6,6
39510,Slovenia,2000.0,3,0,0,3
39511,Slovenia,2004.0,0,2,3,5
39512,Slovenia,2012.0,1,1,3,5
39513,Slovenia,2000.0,3,0,0,3
39514,Slovenia,2008.0,1,2,2,5
39515,Slovenia,2012.0,1,1,3,5
39516,Slovenia,1994.0,0,0,3,3
39517,Slovenia,2014.0,2,2,4,8
39518,Slovenia,2002.0,0,0,4,4
39519,Slovenia,2014.0,2,2,4,8
39520,Slovenia,2008.0,1,2,2,5
39521,Slovenia,1992.0,0,0,6,6
39522,Slovenia,2016.0,1,2,1,4
39523,Slovenia,1992.0,0,0,6,6
39524,Slovenia,1994.0,0,0,3,3
39525,Slovenia,1994.0,0,0,3,3
39526,Slovenia,2014.0,2,2,4,8
39527,Slovenia,2014.0,2,2,4,8
39528,Slovenia,2008.0,1,2,2,5
39529,Slovenia,2012.0,1,1,3,5
39530,Slovenia,2002.0,0,0,4,4
39531,Slovenia,2010.0,0,2,1,3
39532,Slovenia,2010.0,0,2,1,3
39533,Slovenia,2010.0,0,2,1,3
39534,Slovenia,2014.0,2,2,4,8
39535,Slovenia,2014.0,2,2,4,8
39536,Slovenia,1992.0,0,0,6,6
39537,Slovenia,1992.0,0,0,6,6
39538,Slovenia,2002.0,0,0,4,4
39539,Slovenia,2008.0,1,2,2,5
39540,Slovenia,2014.0,2,2,4,8
39541,Slovenia,2014.0,2,2,4,8
39542,Slovenia,2000.0,3,0,0,3
39543,Slovenia,2004.0,0,2,3,5
39544,Slovenia,2012.0,1,1,3,5
39545,Slovenia,2016.0,1,2,1,4
39546,Slovenia,1996.0,0,2,0,2
39547,Slovenia,2016.0,1,2,1,4
39548,Slovenia,2004.0,0,2,3,5
39549,Slovenia,2008.0,1,2,2,5
39550,Slovenia,2016.0,1,2,1,4
39551,Slovenia,2004.0,0,2,3,5
39552,Slovenia,2012.0,1,1,3,5
39553,Slovenia,2002.0,0,0,4,4
39554,Slovenia,1992.0,0,0,6,6
39555,Nepal,1924.0,1,0,0,1
39556,Chinese Taipei,1992.0,0,20,0,20
39557,Chinese Taipei,1992.0,0,20,0,20
39558,Chinese Taipei,1992.0,0,20,0,20
39559,Chinese Taipei,1992.0,0,20,0,20
39560,Chinese Taipei,1996.0,0,1,0,1
39561,Chinese Taipei,2000.0,0,1,4,5
39562,Chinese Taipei,2004.0,2,4,3,9
39563,Chinese Taipei,2004.0,2,4,3,9
39564,Chinese Taipei,2004.0,2,4,3,9
39565,Chinese Taipei,1992.0,0,20,0,20
39566,Chinese Taipei,2008.0,0,0,4,4
39567,Chinese Taipei,1968.0,0,0,1,1
39568,Chinese Taipei,2000.0,0,1,4,5
39569,Chinese Taipei,1992.0,0,20,0,20
39570,Chinese Taipei,2004.0,2,4,3,9
39571,Chinese Taipei,2008.0,0,0,4,4
39572,Chinese Taipei,2012.0,0,1,1,2
39573,Chinese Taipei,2016.0,1,0,4,5
39574,Chinese Taipei,2000.0,0,1,4,5
39575,Chinese Taipei,2004.0,2,4,3,9
39576,Chinese Taipei,1992.0,0,20,0,20
39577,Chinese Taipei,1992.0,0,20,0,20
39578,Chinese Taipei,1992.0,0,20,0,20
39579,Chinese Taipei,1992.0,0,20,0,20
39580,Chinese Taipei,2016.0,1,0,4,5
39581,Chinese Taipei,2000.0,0,1,4,5
39582,Chinese Taipei,1992.0,0,20,0,20
39583,Chinese Taipei,2016.0,1,0,4,5
39584,Chinese Taipei,2000.0,0,1,4,5
39585,Chinese Taipei,1992.0,0,20,0,20
39586,Chinese Taipei,1992.0,0,20,0,20
39587,Chinese Taipei,1992.0,0,20,0,20
39588,Chinese Taipei,2016.0,1,0,4,5
39589,Chinese Taipei,2004.0,2,4,3,9
39590,Chinese Taipei,1992.0,0,20,0,20
39591,Chinese Taipei,1992.0,0,20,0,20
39592,Chinese Taipei,2008.0,0,0,4,4
39593,Chinese Taipei,1992.0,0,20,0,20
39594,Chinese Taipei,2008.0,0,0,4,4
39595,Chinese Taipei,2016.0,1,0,4,5
39596,Chinese Taipei,1992.0,0,20,0,20
39597,Chinese Taipei,1984.0,0,0,1,1
39598,Chinese Taipei,2012.0,0,1,1,2
39599,Chinese Taipei,2004.0,2,4,3,9
39600,Chinese Taipei,1992.0,0,20,0,20
39601,Chinese Taipei,2004.0,2,4,3,9
39602,Chinese Taipei,1992.0,0,20,0,20
39603,Chinese Taipei,1960.0,0,1,0,1
39604,Chinese Taipei,2004.0,2,4,3,9
39605,Zimbabwe,1980.0,15,0,0,15
39606,Zimbabwe,1980.0,15,0,0,15
39607,Zimbabwe,2004.0,1,1,1,3
39608,Zimbabwe,2004.0,1,1,1,3
39609,Zimbabwe,2004.0,1,1,1,3
39610,Zimbabwe,2008.0,1,3,0,4
39611,Zimbabwe,2008.0,1,3,0,4
39612,Zimbabwe,2008.0,1,3,0,4
39613,Zimbabwe,2008.0,1,3,0,4
39614,Zimbabwe,1980.0,15,0,0,15
39615,Zimbabwe,1980.0,15,0,0,15
39616,Zimbabwe,1980.0,15,0,0,15
39617,Zimbabwe,1980.0,15,0,0,15
39618,Zimbabwe,1980.0,15,0,0,15
39619,Zimbabwe,1980.0,15,0,0,15
39620,Zimbabwe,1980.0,15,0,0,15
39621,Zimbabwe,1980.0,15,0,0,15
39622,Zimbabwe,1980.0,15,0,0,15
39623,Zimbabwe,1980.0,15,0,0,15
39624,Zimbabwe,1980.0,15,0,0,15
39625,Zimbabwe,1980.0,15,0,0,15
39626,Zimbabwe,1980.0,15,0,0,15
39627,Mongolia,1968.0,0,1,3,4
39628,Mongolia,1968.0,0,1,3,4
39629,Mongolia,2016.0,0,1,1,2
39630,Mongolia,1996.0,0,0,1,1
39631,Mongolia,1992.0,0,0,2,2
39632,Mongolia,2016.0,0,1,1,2
39633,Mongolia,1980.0,0,2,2,4
39634,Mongolia,2008.0,2,2,0,4
39635,Mongolia,1980.0,0,2,2,4
39636,Mongolia,1968.0,0,1,3,4
39637,Mongolia,2004.0,0,0,1,1
39638,Mongolia,1972.0,0,1,0,1
39639,Mongolia,2008.0,2,2,0,4
39640,Mongolia,2012.0,0,2,3,5
39641,Mongolia,1992.0,0,0,2,2
39642,Mongolia,1988.0,0,0,1,1
39643,Mongolia,2012.0,0,2,3,5
39644,Mongolia,2008.0,2,2,0,4
39645,Mongolia,2008.0,2,2,0,4
39646,Mongolia,1980.0,0,2,2,4
39647,Mongolia,2012.0,0,2,3,5
39648,Mongolia,2012.0,0,2,3,5
39649,Mongolia,1968.0,0,1,3,4
39650,Mongolia,1980.0,0,2,2,4
39651,Mongolia,2012.0,0,2,3,5
39652,Mongolia,1976.0,0,1,0,1
39653,Moldova,2012.0,0,0,2,2
39654,Moldova,2008.0,0,0,1,1
39655,Moldova,2000.0,0,1,1,2
39656,Moldova,2012.0,0,0,2,2
39657,Moldova,1996.0,0,2,1,3
39658,Moldova,2000.0,0,1,1,2
39659,Moldova,1996.0,0,2,1,3
39660,Moldova,1996.0,0,2,1,3
39661,Cote d'Ivoire,2016.0,1,0,1,2
39662,Cote d'Ivoire,2016.0,1,0,1,2
39663,Cote d'Ivoire,1984.0,0,1,0,1
39664,Fiji,2016.0,13,0,0,13
39665,Fiji,2016.0,13,0,0,13
39666,Fiji,2016.0,13,0,0,13
39667,Fiji,2016.0,13,0,0,13
39668,Fiji,2016.0,13,0,0,13
39669,Fiji,2016.0,13,0,0,13
39670,Fiji,2016.0,13,0,0,13
39671,Fiji,2016.0,13,0,0,13
39672,Fiji,2016.0,13,0,0,13
39673,Fiji,2016.0,13,0,0,13
39674,Fiji,2016.0,13,0,0,13
39675,Fiji,2016.0,13,0,0,13
39676,Fiji,2016.0,13,0,0,13
39677,Senegal,1988.0,0,1,0,1
39678,Dominican Republic,2008.0,1,1,0,2
39679,Dominican Republic,2008.0,1,1,0,2
39680,Dominican Republic,1984.0,0,0,1,1
39681,Dominican Republic,2016.0,0,0,1,1
39682,Dominican Republic,2004.0,1,0,0,1
39683,Dominican Republic,2012.0,1,1,0,2
39684,Dominican Republic,2012.0,1,1,0,2
39685,Philippines,2016.0,0,1,0,1
39686,Philippines,1988.0,0,0,1,1
39687,Philippines,1932.0,0,0,3,3
39688,Philippines,1996.0,0,1,0,1
39689,Philippines,1992.0,0,0,1,1
39690,Philippines,1964.0,0,1,0,1
39691,Philippines,1932.0,0,0,3,3
39692,Philippines,1936.0,0,0,1,1
39693,Philippines,1928.0,0,0,1,1
39694,Philippines,1932.0,0,0,3,3
39695,United Arab Republic,1960.0,0,1,1,2
39696,United Arab Republic,1960.0,0,1,1,2
39697,Namibia,1992.0,0,2,0,2
39698,Namibia,1992.0,0,2,0,2
39699,Namibia,1996.0,0,2,0,2
39700,Namibia,1996.0,0,2,0,2
39701,Liechtenstein,1988.0,0,0,1,1
39702,Liechtenstein,1976.0,0,0,2,2
39703,Liechtenstein,1984.0,0,0,2,2
39704,Liechtenstein,1980.0,2,2,0,4
39705,Liechtenstein,1984.0,0,0,2,2
39706,Liechtenstein,1976.0,0,0,2,2
39707,Liechtenstein,1980.0,2,2,0,4
39708,Liechtenstein,1980.0,2,2,0,4
39709,Liechtenstein,1980.0,2,2,0,4
39710,West Indies Federation,1960.0,0,0,5,5
39711,West Indies Federation,1960.0,0,0,5,5
39712,West Indies Federation,1960.0,0,0,5,5
39713,West Indies Federation,1960.0,0,0,5,5
39714,West Indies Federation,1960.0,0,0,5,5
39715,Bohemia,1908.0,0,0,6,6
39716,Bohemia,1908.0,0,0,6,6
39717,Bohemia,1900.0,0,1,2,3
39718,Bohemia,1908.0,0,0,6,6
39719,Bohemia,1908.0,0,0,6,6
39720,Bohemia,1900.0,0,1,2,3
39721,Bohemia/Great Britain,1900.0,0,1,2,3
39722,Bohemia,1908.0,0,0,6,6
39723,Bohemia,1908.0,0,0,6,6
39724,Bohemia,1906.0,0,0,3,3
39725,Bohemia,1906.0,0,0,3,3
39726,Bohemia,1906.0,0,0,3,3
39727,Bermuda,1976.0,0,0,1,1
39728,Vietnam,2008.0,0,1,0,1
39729,Vietnam,2016.0,1,1,0,2
39730,Vietnam,2016.0,1,1,0,2
39731,Vietnam,2000.0,0,1,0,1
39732,United States Virgin Islands,1988.0,0,1,0,1
39733,Macedonia,2000.0,0,0,1,1
39734,Sudan,2008.0,0,1,0,1
39735,Bahrain,2012.0,0,0,1,1
39736,Bahrain,2016.0,1,1,0,2
39737,Bahrain,2016.0,1,1,0,2
39738,Grenada,2012.0,1,0,0,1
39739,Grenada,2016.0,0,1,0,1
39740,Sri Lanka,2000.0,0,1,0,1
39741,Sri Lanka,1948.0,0,1,0,1
39742,Mauritius,2008.0,0,0,1,1
39743,Kosovo,2016.0,1,0,0,1
39744,Hong Kong-2,2004.0,0,2,0,2
39745,Hong Kong,1996.0,1,0,0,1
39746,Hong Kong,2012.0,0,0,1,1
39747,Hong Kong-2,2004.0,0,2,0,2
39748,Cyprus,2012.0,0,1,0,1
39749,Panama,1948.0,0,0,2,2
39750,Panama,1948.0,0,0,2,2
39751,Panama,2008.0,1,0,0,1
39752,Zambia,1996.0,0,1,0,1
39753,Zambia,1984.0,0,0,1,1
39754,Monaco,1924.0,0,0,1,1
39755,Mozambique,1996.0,0,0,1,1
39756,Mozambique,2000.0,1,0,0,1
39757,Suriname,1988.0,1,0,0,1
39758,Suriname,1992.0,0,0,1,1
39759,Afghanistan,2008.0,0,0,1,1
39760,Afghanistan,2012.0,0,0,1,1
39761,Burundi,1996.0,1,0,0,1
39762,Burundi,2016.0,0,1,0,1
39763,Gabon,2012.0,0,1,0,1
39764,Ecuador,1996.0,1,0,0,1
39765,Ecuador,2008.0,0,1,0,1
39766,Costa Rica,1996.0,1,0,0,1
39767,Costa Rica,2000.0,0,0,2,2
39768,Costa Rica,2000.0,0,0,2,2
39769,Costa Rica,1988.0,0,1,0,1
39770,Djibouti,1988.0,0,0,1,1
39771,Eritrea,2004.0,0,0,1,1
39772,Barbados,2000.0,0,0,1,1
39773,Tonga,1996.0,0,1,0,1
